entidad_federativa,CVE_MUN,municipio,sexo,EcAc_total,EcAc_ocupada,EcAc_desocupada,No_EcAc
30 Veracruz de Ignacio de la Llave,1,001 Acajete,Total,3154,3087,67,2883
30 Veracruz de Ignacio de la Llave,1,001 Acajete,Total,50,49,1,508
30 Veracruz de Ignacio de la Llave,1,001 Acajete,Total,354,334,20,563
30 Veracruz de Ignacio de la Llave,1,001 Acajete,Total,437,420,17,279
30 Veracruz de Ignacio de la Llave,1,001 Acajete,Total,359,349,10,222
30 Veracruz de Ignacio de la Llave,1,001 Acajete,Total,379,375,4,232
30 Veracruz de Ignacio de la Llave,1,001 Acajete,Total,403,401,2,199
30 Veracruz de Ignacio de la Llave,1,001 Acajete,Total,319,316,3,159
30 Veracruz de Ignacio de la Llave,1,001 Acajete,Total,234,230,4,116
30 Veracruz de Ignacio de la Llave,1,001 Acajete,Total,181,179,2,89
30 Veracruz de Ignacio de la Llave,1,001 Acajete,Total,141,138,3,117
30 Veracruz de Ignacio de la Llave,1,001 Acajete,Total,111,111,0,99
30 Veracruz de Ignacio de la Llave,1,001 Acajete,Total,74,74,0,76
30 Veracruz de Ignacio de la Llave,1,001 Acajete,Total,68,68,0,81
30 Veracruz de Ignacio de la Llave,1,001 Acajete,Total,26,26,0,60
30 Veracruz de Ignacio de la Llave,1,001 Acajete,Total,11,10,1,43
30 Veracruz de Ignacio de la Llave,1,001 Acajete,Total,7,7,0,40
30 Veracruz de Ignacio de la Llave,1,001 Acajete,Hombres,2457,2397,60,563
30 Veracruz de Ignacio de la Llave,1,001 Acajete,Hombres,43,42,1,241
30 Veracruz de Ignacio de la Llave,1,001 Acajete,Hombres,295,278,17,159
30 Veracruz de Ignacio de la Llave,1,001 Acajete,Hombres,346,331,15,34
30 Veracruz de Ignacio de la Llave,1,001 Acajete,Hombres,275,267,8,7
30 Veracruz de Ignacio de la Llave,1,001 Acajete,Hombres,283,279,4,5
30 Veracruz de Ignacio de la Llave,1,001 Acajete,Hombres,314,312,2,4
30 Veracruz de Ignacio de la Llave,1,001 Acajete,Hombres,232,229,3,6
30 Veracruz de Ignacio de la Llave,1,001 Acajete,Hombres,170,166,4,5
30 Veracruz de Ignacio de la Llave,1,001 Acajete,Hombres,138,136,2,4
30 Veracruz de Ignacio de la Llave,1,001 Acajete,Hombres,114,111,3,9
30 Veracruz de Ignacio de la Llave,1,001 Acajete,Hombres,85,85,0,9
30 Veracruz de Ignacio de la Llave,1,001 Acajete,Hombres,65,65,0,13
30 Veracruz de Ignacio de la Llave,1,001 Acajete,Hombres,55,55,0,20
30 Veracruz de Ignacio de la Llave,1,001 Acajete,Hombres,24,24,0,13
30 Veracruz de Ignacio de la Llave,1,001 Acajete,Hombres,11,10,1,15
30 Veracruz de Ignacio de la Llave,1,001 Acajete,Hombres,7,7,0,19
30 Veracruz de Ignacio de la Llave,1,001 Acajete,Mujeres,697,690,7,2320
30 Veracruz de Ignacio de la Llave,1,001 Acajete,Mujeres,7,7,0,267
30 Veracruz de Ignacio de la Llave,1,001 Acajete,Mujeres,59,56,3,404
30 Veracruz de Ignacio de la Llave,1,001 Acajete,Mujeres,91,89,2,245
30 Veracruz de Ignacio de la Llave,1,001 Acajete,Mujeres,84,82,2,215
30 Veracruz de Ignacio de la Llave,1,001 Acajete,Mujeres,96,96,0,227
30 Veracruz de Ignacio de la Llave,1,001 Acajete,Mujeres,89,89,0,195
30 Veracruz de Ignacio de la Llave,1,001 Acajete,Mujeres,87,87,0,153
30 Veracruz de Ignacio de la Llave,1,001 Acajete,Mujeres,64,64,0,111
30 Veracruz de Ignacio de la Llave,1,001 Acajete,Mujeres,43,43,0,85
30 Veracruz de Ignacio de la Llave,1,001 Acajete,Mujeres,27,27,0,108
30 Veracruz de Ignacio de la Llave,1,001 Acajete,Mujeres,26,26,0,90
30 Veracruz de Ignacio de la Llave,1,001 Acajete,Mujeres,9,9,0,63
30 Veracruz de Ignacio de la Llave,1,001 Acajete,Mujeres,13,13,0,61
30 Veracruz de Ignacio de la Llave,1,001 Acajete,Mujeres,2,2,0,47
30 Veracruz de Ignacio de la Llave,1,001 Acajete,Mujeres,0,0,0,28
30 Veracruz de Ignacio de la Llave,1,001 Acajete,Mujeres,0,0,0,21
30 Veracruz de Ignacio de la Llave,2,002 Acatlán,Total,972,910,62,1369
30 Veracruz de Ignacio de la Llave,2,002 Acatlán,Total,12,10,2,211
30 Veracruz de Ignacio de la Llave,2,002 Acatlán,Total,99,94,5,261
30 Veracruz de Ignacio de la Llave,2,002 Acatlán,Total,145,132,13,135
30 Veracruz de Ignacio de la Llave,2,002 Acatlán,Total,109,102,7,94
30 Veracruz de Ignacio de la Llave,2,002 Acatlán,Total,105,99,6,88
30 Veracruz de Ignacio de la Llave,2,002 Acatlán,Total,113,108,5,93
30 Veracruz de Ignacio de la Llave,2,002 Acatlán,Total,98,91,7,91
30 Veracruz de Ignacio de la Llave,2,002 Acatlán,Total,93,89,4,87
30 Veracruz de Ignacio de la Llave,2,002 Acatlán,Total,59,57,2,60
30 Veracruz de Ignacio de la Llave,2,002 Acatlán,Total,46,41,5,49
30 Veracruz de Ignacio de la Llave,2,002 Acatlán,Total,29,27,2,43
30 Veracruz de Ignacio de la Llave,2,002 Acatlán,Total,31,28,3,47
30 Veracruz de Ignacio de la Llave,2,002 Acatlán,Total,18,17,1,44
30 Veracruz de Ignacio de la Llave,2,002 Acatlán,Total,8,8,0,27
30 Veracruz de Ignacio de la Llave,2,002 Acatlán,Total,5,5,0,23
30 Veracruz de Ignacio de la Llave,2,002 Acatlán,Total,2,2,0,16
30 Veracruz de Ignacio de la Llave,2,002 Acatlán,Hombres,745,692,53,385
30 Veracruz de Ignacio de la Llave,2,002 Acatlán,Hombres,12,10,2,110
30 Veracruz de Ignacio de la Llave,2,002 Acatlán,Hombres,74,70,4,106
30 Veracruz de Ignacio de la Llave,2,002 Acatlán,Hombres,98,89,9,42
30 Veracruz de Ignacio de la Llave,2,002 Acatlán,Hombres,76,70,6,12
30 Veracruz de Ignacio de la Llave,2,002 Acatlán,Hombres,75,70,5,8
30 Veracruz de Ignacio de la Llave,2,002 Acatlán,Hombres,81,78,3,9
30 Veracruz de Ignacio de la Llave,2,002 Acatlán,Hombres,83,76,7,6
30 Veracruz de Ignacio de la Llave,2,002 Acatlán,Hombres,75,71,4,9
30 Veracruz de Ignacio de la Llave,2,002 Acatlán,Hombres,55,53,2,12
30 Veracruz de Ignacio de la Llave,2,002 Acatlán,Hombres,39,34,5,10
30 Veracruz de Ignacio de la Llave,2,002 Acatlán,Hombres,25,23,2,8
30 Veracruz de Ignacio de la Llave,2,002 Acatlán,Hombres,24,21,3,16
30 Veracruz de Ignacio de la Llave,2,002 Acatlán,Hombres,15,14,1,14
30 Veracruz de Ignacio de la Llave,2,002 Acatlán,Hombres,7,7,0,10
30 Veracruz de Ignacio de la Llave,2,002 Acatlán,Hombres,4,4,0,7
30 Veracruz de Ignacio de la Llave,2,002 Acatlán,Hombres,2,2,0,6
30 Veracruz de Ignacio de la Llave,2,002 Acatlán,Mujeres,227,218,9,984
30 Veracruz de Ignacio de la Llave,2,002 Acatlán,Mujeres,0,0,0,101
30 Veracruz de Ignacio de la Llave,2,002 Acatlán,Mujeres,25,24,1,155
30 Veracruz de Ignacio de la Llave,2,002 Acatlán,Mujeres,47,43,4,93
30 Veracruz de Ignacio de la Llave,2,002 Acatlán,Mujeres,33,32,1,82
30 Veracruz de Ignacio de la Llave,2,002 Acatlán,Mujeres,30,29,1,80
30 Veracruz de Ignacio de la Llave,2,002 Acatlán,Mujeres,32,30,2,84
30 Veracruz de Ignacio de la Llave,2,002 Acatlán,Mujeres,15,15,0,85
30 Veracruz de Ignacio de la Llave,2,002 Acatlán,Mujeres,18,18,0,78
30 Veracruz de Ignacio de la Llave,2,002 Acatlán,Mujeres,4,4,0,48
30 Veracruz de Ignacio de la Llave,2,002 Acatlán,Mujeres,7,7,0,39
30 Veracruz de Ignacio de la Llave,2,002 Acatlán,Mujeres,4,4,0,35
30 Veracruz de Ignacio de la Llave,2,002 Acatlán,Mujeres,7,7,0,31
30 Veracruz de Ignacio de la Llave,2,002 Acatlán,Mujeres,3,3,0,30
30 Veracruz de Ignacio de la Llave,2,002 Acatlán,Mujeres,1,1,0,17
30 Veracruz de Ignacio de la Llave,2,002 Acatlán,Mujeres,1,1,0,16
30 Veracruz de Ignacio de la Llave,2,002 Acatlán,Mujeres,0,0,0,10
30 Veracruz de Ignacio de la Llave,3,003 Acayucan,Total,31655,30429,1226,32547
30 Veracruz de Ignacio de la Llave,3,003 Acayucan,Total,211,198,13,4786
30 Veracruz de Ignacio de la Llave,3,003 Acayucan,Total,2033,1882,151,6710
30 Veracruz de Ignacio de la Llave,3,003 Acayucan,Total,3979,3762,217,3285
30 Veracruz de Ignacio de la Llave,3,003 Acayucan,Total,4023,3847,176,2292
30 Veracruz de Ignacio de la Llave,3,003 Acayucan,Total,3876,3749,127,2220
30 Veracruz de Ignacio de la Llave,3,003 Acayucan,Total,3800,3701,99,2115
30 Veracruz de Ignacio de la Llave,3,003 Acayucan,Total,3601,3511,90,1814
30 Veracruz de Ignacio de la Llave,3,003 Acayucan,Total,2983,2909,74,1634
30 Veracruz de Ignacio de la Llave,3,003 Acayucan,Total,2388,2322,66,1502
30 Veracruz de Ignacio de la Llave,3,003 Acayucan,Total,1826,1761,65,1437
30 Veracruz de Ignacio de la Llave,3,003 Acayucan,Total,1142,1081,61,1211
30 Veracruz de Ignacio de la Llave,3,003 Acayucan,Total,784,751,33,1026
30 Veracruz de Ignacio de la Llave,3,003 Acayucan,Total,521,493,28,942
30 Veracruz de Ignacio de la Llave,3,003 Acayucan,Total,289,272,17,701
30 Veracruz de Ignacio de la Llave,3,003 Acayucan,Total,118,113,5,425
30 Veracruz de Ignacio de la Llave,3,003 Acayucan,Total,81,77,4,447
30 Veracruz de Ignacio de la Llave,3,003 Acayucan,Hombres,22443,21431,1012,7801
30 Veracruz de Ignacio de la Llave,3,003 Acayucan,Hombres,171,161,10,2377
30 Veracruz de Ignacio de la Llave,3,003 Acayucan,Hombres,1532,1411,121,2803
30 Veracruz de Ignacio de la Llave,3,003 Acayucan,Hombres,2740,2585,155,680
30 Veracruz de Ignacio de la Llave,3,003 Acayucan,Hombres,2699,2561,138,148
30 Veracruz de Ignacio de la Llave,3,003 Acayucan,Hombres,2632,2537,95,104
30 Veracruz de Ignacio de la Llave,3,003 Acayucan,Hombres,2526,2443,83,82
30 Veracruz de Ignacio de la Llave,3,003 Acayucan,Hombres,2489,2403,86,66
30 Veracruz de Ignacio de la Llave,3,003 Acayucan,Hombres,2067,2003,64,78
30 Veracruz de Ignacio de la Llave,3,003 Acayucan,Hombres,1744,1683,61,107
30 Veracruz de Ignacio de la Llave,3,003 Acayucan,Hombres,1398,1340,58,170
30 Veracruz de Ignacio de la Llave,3,003 Acayucan,Hombres,915,858,57,217
30 Veracruz de Ignacio de la Llave,3,003 Acayucan,Hombres,645,614,31,212
30 Veracruz de Ignacio de la Llave,3,003 Acayucan,Hombres,455,428,27,248
30 Veracruz de Ignacio de la Llave,3,003 Acayucan,Hombres,252,235,17,212
30 Veracruz de Ignacio de la Llave,3,003 Acayucan,Hombres,104,99,5,136
30 Veracruz de Ignacio de la Llave,3,003 Acayucan,Hombres,74,70,4,161
30 Veracruz de Ignacio de la Llave,3,003 Acayucan,Mujeres,9212,8998,214,24746
30 Veracruz de Ignacio de la Llave,3,003 Acayucan,Mujeres,40,37,3,2409
30 Veracruz de Ignacio de la Llave,3,003 Acayucan,Mujeres,501,471,30,3907
30 Veracruz de Ignacio de la Llave,3,003 Acayucan,Mujeres,1239,1177,62,2605
30 Veracruz de Ignacio de la Llave,3,003 Acayucan,Mujeres,1324,1286,38,2144
30 Veracruz de Ignacio de la Llave,3,003 Acayucan,Mujeres,1244,1212,32,2116
30 Veracruz de Ignacio de la Llave,3,003 Acayucan,Mujeres,1274,1258,16,2033
30 Veracruz de Ignacio de la Llave,3,003 Acayucan,Mujeres,1112,1108,4,1748
30 Veracruz de Ignacio de la Llave,3,003 Acayucan,Mujeres,916,906,10,1556
30 Veracruz de Ignacio de la Llave,3,003 Acayucan,Mujeres,644,639,5,1395
30 Veracruz de Ignacio de la Llave,3,003 Acayucan,Mujeres,428,421,7,1267
30 Veracruz de Ignacio de la Llave,3,003 Acayucan,Mujeres,227,223,4,994
30 Veracruz de Ignacio de la Llave,3,003 Acayucan,Mujeres,139,137,2,814
30 Veracruz de Ignacio de la Llave,3,003 Acayucan,Mujeres,66,65,1,694
30 Veracruz de Ignacio de la Llave,3,003 Acayucan,Mujeres,37,37,0,489
30 Veracruz de Ignacio de la Llave,3,003 Acayucan,Mujeres,14,14,0,289
30 Veracruz de Ignacio de la Llave,3,003 Acayucan,Mujeres,7,7,0,286
30 Veracruz de Ignacio de la Llave,4,004 Actopan,Total,14997,14617,380,18083
30 Veracruz de Ignacio de la Llave,4,004 Actopan,Total,116,109,7,2053
30 Veracruz de Ignacio de la Llave,4,004 Actopan,Total,1112,1069,43,2630
30 Veracruz de Ignacio de la Llave,4,004 Actopan,Total,1564,1506,58,1356
30 Veracruz de Ignacio de la Llave,4,004 Actopan,Total,1368,1332,36,1115
30 Veracruz de Ignacio de la Llave,4,004 Actopan,Total,1494,1455,39,1305
30 Veracruz de Ignacio de la Llave,4,004 Actopan,Total,1762,1727,35,1352
30 Veracruz de Ignacio de la Llave,4,004 Actopan,Total,1793,1756,37,1249
30 Veracruz de Ignacio de la Llave,4,004 Actopan,Total,1502,1467,35,1218
30 Veracruz de Ignacio de la Llave,4,004 Actopan,Total,1303,1266,37,1032
30 Veracruz de Ignacio de la Llave,4,004 Actopan,Total,1054,1028,26,910
30 Veracruz de Ignacio de la Llave,4,004 Actopan,Total,766,755,11,910
30 Veracruz de Ignacio de la Llave,4,004 Actopan,Total,495,486,9,834
30 Veracruz de Ignacio de la Llave,4,004 Actopan,Total,386,383,3,793
30 Veracruz de Ignacio de la Llave,4,004 Actopan,Total,164,162,2,554
30 Veracruz de Ignacio de la Llave,4,004 Actopan,Total,68,67,1,370
30 Veracruz de Ignacio de la Llave,4,004 Actopan,Total,50,49,1,402
30 Veracruz de Ignacio de la Llave,4,004 Actopan,Hombres,12157,11823,334,3950
30 Veracruz de Ignacio de la Llave,4,004 Actopan,Hombres,95,89,6,1001
30 Veracruz de Ignacio de la Llave,4,004 Actopan,Hombres,889,848,41,1028
30 Veracruz de Ignacio de la Llave,4,004 Actopan,Hombres,1158,1114,44,243
30 Veracruz de Ignacio de la Llave,4,004 Actopan,Hombres,1024,997,27,93
30 Veracruz de Ignacio de la Llave,4,004 Actopan,Hombres,1172,1139,33,70
30 Veracruz de Ignacio de la Llave,4,004 Actopan,Hombres,1399,1371,28,78
30 Veracruz de Ignacio de la Llave,4,004 Actopan,Hombres,1453,1419,34,77
30 Veracruz de Ignacio de la Llave,4,004 Actopan,Hombres,1262,1229,33,89
30 Veracruz de Ignacio de la Llave,4,004 Actopan,Hombres,1092,1057,35,82
30 Veracruz de Ignacio de la Llave,4,004 Actopan,Hombres,907,881,26,84
30 Veracruz de Ignacio de la Llave,4,004 Actopan,Hombres,664,653,11,182
30 Veracruz de Ignacio de la Llave,4,004 Actopan,Hombres,439,430,9,197
30 Veracruz de Ignacio de la Llave,4,004 Actopan,Hombres,341,338,3,245
30 Veracruz de Ignacio de la Llave,4,004 Actopan,Hombres,152,150,2,204
30 Veracruz de Ignacio de la Llave,4,004 Actopan,Hombres,63,62,1,130
30 Veracruz de Ignacio de la Llave,4,004 Actopan,Hombres,47,46,1,147
30 Veracruz de Ignacio de la Llave,4,004 Actopan,Mujeres,2840,2794,46,14133
30 Veracruz de Ignacio de la Llave,4,004 Actopan,Mujeres,21,20,1,1052
30 Veracruz de Ignacio de la Llave,4,004 Actopan,Mujeres,223,221,2,1602
30 Veracruz de Ignacio de la Llave,4,004 Actopan,Mujeres,406,392,14,1113
30 Veracruz de Ignacio de la Llave,4,004 Actopan,Mujeres,344,335,9,1022
30 Veracruz de Ignacio de la Llave,4,004 Actopan,Mujeres,322,316,6,1235
30 Veracruz de Ignacio de la Llave,4,004 Actopan,Mujeres,363,356,7,1274
30 Veracruz de Ignacio de la Llave,4,004 Actopan,Mujeres,340,337,3,1172
30 Veracruz de Ignacio de la Llave,4,004 Actopan,Mujeres,240,238,2,1129
30 Veracruz de Ignacio de la Llave,4,004 Actopan,Mujeres,211,209,2,950
30 Veracruz de Ignacio de la Llave,4,004 Actopan,Mujeres,147,147,0,826
30 Veracruz de Ignacio de la Llave,4,004 Actopan,Mujeres,102,102,0,728
30 Veracruz de Ignacio de la Llave,4,004 Actopan,Mujeres,56,56,0,637
30 Veracruz de Ignacio de la Llave,4,004 Actopan,Mujeres,45,45,0,548
30 Veracruz de Ignacio de la Llave,4,004 Actopan,Mujeres,12,12,0,350
30 Veracruz de Ignacio de la Llave,4,004 Actopan,Mujeres,5,5,0,240
30 Veracruz de Ignacio de la Llave,4,004 Actopan,Mujeres,3,3,0,255
30 Veracruz de Ignacio de la Llave,5,005 Acula,Total,1735,1603,132,2281
30 Veracruz de Ignacio de la Llave,5,005 Acula,Total,19,10,9,248
30 Veracruz de Ignacio de la Llave,5,005 Acula,Total,121,101,20,352
30 Veracruz de Ignacio de la Llave,5,005 Acula,Total,176,156,20,177
30 Veracruz de Ignacio de la Llave,5,005 Acula,Total,176,166,10,150
30 Veracruz de Ignacio de la Llave,5,005 Acula,Total,181,170,11,164
30 Veracruz de Ignacio de la Llave,5,005 Acula,Total,199,185,14,174
30 Veracruz de Ignacio de la Llave,5,005 Acula,Total,210,199,11,146
30 Veracruz de Ignacio de la Llave,5,005 Acula,Total,160,152,8,127
30 Veracruz de Ignacio de la Llave,5,005 Acula,Total,147,136,11,137
30 Veracruz de Ignacio de la Llave,5,005 Acula,Total,129,117,12,118
30 Veracruz de Ignacio de la Llave,5,005 Acula,Total,81,78,3,99
30 Veracruz de Ignacio de la Llave,5,005 Acula,Total,69,67,2,110
30 Veracruz de Ignacio de la Llave,5,005 Acula,Total,42,41,1,111
30 Veracruz de Ignacio de la Llave,5,005 Acula,Total,11,11,0,69
30 Veracruz de Ignacio de la Llave,5,005 Acula,Total,10,10,0,53
30 Veracruz de Ignacio de la Llave,5,005 Acula,Total,4,4,0,46
30 Veracruz de Ignacio de la Llave,5,005 Acula,Hombres,1432,1313,119,538
30 Veracruz de Ignacio de la Llave,5,005 Acula,Hombres,16,9,7,122
30 Veracruz de Ignacio de la Llave,5,005 Acula,Hombres,105,88,17,144
30 Veracruz de Ignacio de la Llave,5,005 Acula,Hombres,146,129,17,29
30 Veracruz de Ignacio de la Llave,5,005 Acula,Hombres,134,126,8,5
30 Veracruz de Ignacio de la Llave,5,005 Acula,Hombres,146,136,10,9
30 Veracruz de Ignacio de la Llave,5,005 Acula,Hombres,165,152,13,13
30 Veracruz de Ignacio de la Llave,5,005 Acula,Hombres,168,157,11,13
30 Veracruz de Ignacio de la Llave,5,005 Acula,Hombres,135,127,8,12
30 Veracruz de Ignacio de la Llave,5,005 Acula,Hombres,114,104,10,16
30 Veracruz de Ignacio de la Llave,5,005 Acula,Hombres,111,99,12,15
30 Veracruz de Ignacio de la Llave,5,005 Acula,Hombres,67,64,3,24
30 Veracruz de Ignacio de la Llave,5,005 Acula,Hombres,64,62,2,30
30 Veracruz de Ignacio de la Llave,5,005 Acula,Hombres,38,37,1,39
30 Veracruz de Ignacio de la Llave,5,005 Acula,Hombres,10,10,0,31
30 Veracruz de Ignacio de la Llave,5,005 Acula,Hombres,9,9,0,20
30 Veracruz de Ignacio de la Llave,5,005 Acula,Hombres,4,4,0,16
30 Veracruz de Ignacio de la Llave,5,005 Acula,Mujeres,303,290,13,1743
30 Veracruz de Ignacio de la Llave,5,005 Acula,Mujeres,3,1,2,126
30 Veracruz de Ignacio de la Llave,5,005 Acula,Mujeres,16,13,3,208
30 Veracruz de Ignacio de la Llave,5,005 Acula,Mujeres,30,27,3,148
30 Veracruz de Ignacio de la Llave,5,005 Acula,Mujeres,42,40,2,145
30 Veracruz de Ignacio de la Llave,5,005 Acula,Mujeres,35,34,1,155
30 Veracruz de Ignacio de la Llave,5,005 Acula,Mujeres,34,33,1,161
30 Veracruz de Ignacio de la Llave,5,005 Acula,Mujeres,42,42,0,133
30 Veracruz de Ignacio de la Llave,5,005 Acula,Mujeres,25,25,0,115
30 Veracruz de Ignacio de la Llave,5,005 Acula,Mujeres,33,32,1,121
30 Veracruz de Ignacio de la Llave,5,005 Acula,Mujeres,18,18,0,103
30 Veracruz de Ignacio de la Llave,5,005 Acula,Mujeres,14,14,0,75
30 Veracruz de Ignacio de la Llave,5,005 Acula,Mujeres,5,5,0,80
30 Veracruz de Ignacio de la Llave,5,005 Acula,Mujeres,4,4,0,72
30 Veracruz de Ignacio de la Llave,5,005 Acula,Mujeres,1,1,0,38
30 Veracruz de Ignacio de la Llave,5,005 Acula,Mujeres,1,1,0,33
30 Veracruz de Ignacio de la Llave,5,005 Acula,Mujeres,0,0,0,30
30 Veracruz de Ignacio de la Llave,6,006 Acultzingo,Total,6924,6563,361,8008
30 Veracruz de Ignacio de la Llave,6,006 Acultzingo,Total,109,101,8,1286
30 Veracruz de Ignacio de la Llave,6,006 Acultzingo,Total,732,687,45,1595
30 Veracruz de Ignacio de la Llave,6,006 Acultzingo,Total,990,919,71,889
30 Veracruz de Ignacio de la Llave,6,006 Acultzingo,Total,949,899,50,681
30 Veracruz de Ignacio de la Llave,6,006 Acultzingo,Total,850,809,41,575
30 Veracruz de Ignacio de la Llave,6,006 Acultzingo,Total,814,777,37,522
30 Veracruz de Ignacio de la Llave,6,006 Acultzingo,Total,616,582,34,463
30 Veracruz de Ignacio de la Llave,6,006 Acultzingo,Total,536,519,17,331
30 Veracruz de Ignacio de la Llave,6,006 Acultzingo,Total,366,346,20,336
30 Veracruz de Ignacio de la Llave,6,006 Acultzingo,Total,305,291,14,268
30 Veracruz de Ignacio de la Llave,6,006 Acultzingo,Total,215,205,10,247
30 Veracruz de Ignacio de la Llave,6,006 Acultzingo,Total,178,169,9,218
30 Veracruz de Ignacio de la Llave,6,006 Acultzingo,Total,125,124,1,211
30 Veracruz de Ignacio de la Llave,6,006 Acultzingo,Total,85,81,4,145
30 Veracruz de Ignacio de la Llave,6,006 Acultzingo,Total,33,33,0,128
30 Veracruz de Ignacio de la Llave,6,006 Acultzingo,Total,21,21,0,113
30 Veracruz de Ignacio de la Llave,6,006 Acultzingo,Hombres,5417,5079,338,1783
30 Veracruz de Ignacio de la Llave,6,006 Acultzingo,Hombres,90,82,8,608
30 Veracruz de Ignacio de la Llave,6,006 Acultzingo,Hombres,590,551,39,554
30 Veracruz de Ignacio de la Llave,6,006 Acultzingo,Hombres,781,717,64,113
30 Veracruz de Ignacio de la Llave,6,006 Acultzingo,Hombres,733,689,44,38
30 Veracruz de Ignacio de la Llave,6,006 Acultzingo,Hombres,662,622,40,35
30 Veracruz de Ignacio de la Llave,6,006 Acultzingo,Hombres,647,610,37,31
30 Veracruz de Ignacio de la Llave,6,006 Acultzingo,Hombres,460,428,32,27
30 Veracruz de Ignacio de la Llave,6,006 Acultzingo,Hombres,396,380,16,25
30 Veracruz de Ignacio de la Llave,6,006 Acultzingo,Hombres,280,260,20,28
30 Veracruz de Ignacio de la Llave,6,006 Acultzingo,Hombres,232,218,14,44
30 Veracruz de Ignacio de la Llave,6,006 Acultzingo,Hombres,172,162,10,48
30 Veracruz de Ignacio de la Llave,6,006 Acultzingo,Hombres,147,138,9,38
30 Veracruz de Ignacio de la Llave,6,006 Acultzingo,Hombres,107,106,1,56
30 Veracruz de Ignacio de la Llave,6,006 Acultzingo,Hombres,75,71,4,44
30 Veracruz de Ignacio de la Llave,6,006 Acultzingo,Hombres,27,27,0,51
30 Veracruz de Ignacio de la Llave,6,006 Acultzingo,Hombres,18,18,0,43
30 Veracruz de Ignacio de la Llave,6,006 Acultzingo,Mujeres,1507,1484,23,6225
30 Veracruz de Ignacio de la Llave,6,006 Acultzingo,Mujeres,19,19,0,678
30 Veracruz de Ignacio de la Llave,6,006 Acultzingo,Mujeres,142,136,6,1041
30 Veracruz de Ignacio de la Llave,6,006 Acultzingo,Mujeres,209,202,7,776
30 Veracruz de Ignacio de la Llave,6,006 Acultzingo,Mujeres,216,210,6,643
30 Veracruz de Ignacio de la Llave,6,006 Acultzingo,Mujeres,188,187,1,540
30 Veracruz de Ignacio de la Llave,6,006 Acultzingo,Mujeres,167,167,0,491
30 Veracruz de Ignacio de la Llave,6,006 Acultzingo,Mujeres,156,154,2,436
30 Veracruz de Ignacio de la Llave,6,006 Acultzingo,Mujeres,140,139,1,306
30 Veracruz de Ignacio de la Llave,6,006 Acultzingo,Mujeres,86,86,0,308
30 Veracruz de Ignacio de la Llave,6,006 Acultzingo,Mujeres,73,73,0,224
30 Veracruz de Ignacio de la Llave,6,006 Acultzingo,Mujeres,43,43,0,199
30 Veracruz de Ignacio de la Llave,6,006 Acultzingo,Mujeres,31,31,0,180
30 Veracruz de Ignacio de la Llave,6,006 Acultzingo,Mujeres,18,18,0,155
30 Veracruz de Ignacio de la Llave,6,006 Acultzingo,Mujeres,10,10,0,101
30 Veracruz de Ignacio de la Llave,6,006 Acultzingo,Mujeres,6,6,0,77
30 Veracruz de Ignacio de la Llave,6,006 Acultzingo,Mujeres,3,3,0,70
30 Veracruz de Ignacio de la Llave,204,204 Agua Dulce,Total,16086,15145,941,18930
30 Veracruz de Ignacio de la Llave,204,204 Agua Dulce,Total,60,52,8,2731
30 Veracruz de Ignacio de la Llave,204,204 Agua Dulce,Total,863,756,107,3398
30 Veracruz de Ignacio de la Llave,204,204 Agua Dulce,Total,1826,1642,184,1893
30 Veracruz de Ignacio de la Llave,204,204 Agua Dulce,Total,2150,1995,155,1213
30 Veracruz de Ignacio de la Llave,204,204 Agua Dulce,Total,2056,1960,96,1133
30 Veracruz de Ignacio de la Llave,204,204 Agua Dulce,Total,2064,1983,81,1143
30 Veracruz de Ignacio de la Llave,204,204 Agua Dulce,Total,2108,2031,77,1019
30 Veracruz de Ignacio de la Llave,204,204 Agua Dulce,Total,1629,1581,48,970
30 Veracruz de Ignacio de la Llave,204,204 Agua Dulce,Total,1344,1283,61,931
30 Veracruz de Ignacio de la Llave,204,204 Agua Dulce,Total,800,767,33,999
30 Veracruz de Ignacio de la Llave,204,204 Agua Dulce,Total,471,436,35,969
30 Veracruz de Ignacio de la Llave,204,204 Agua Dulce,Total,302,280,22,848
30 Veracruz de Ignacio de la Llave,204,204 Agua Dulce,Total,231,212,19,698
30 Veracruz de Ignacio de la Llave,204,204 Agua Dulce,Total,102,94,8,468
30 Veracruz de Ignacio de la Llave,204,204 Agua Dulce,Total,56,51,5,270
30 Veracruz de Ignacio de la Llave,204,204 Agua Dulce,Total,24,22,2,247
30 Veracruz de Ignacio de la Llave,204,204 Agua Dulce,Hombres,11329,10542,787,5311
30 Veracruz de Ignacio de la Llave,204,204 Agua Dulce,Hombres,44,37,7,1314
30 Veracruz de Ignacio de la Llave,204,204 Agua Dulce,Hombres,642,549,93,1507
30 Veracruz de Ignacio de la Llave,204,204 Agua Dulce,Hombres,1259,1120,139,478
30 Veracruz de Ignacio de la Llave,204,204 Agua Dulce,Hombres,1470,1352,118,96
30 Veracruz de Ignacio de la Llave,204,204 Agua Dulce,Hombres,1357,1280,77,49
30 Veracruz de Ignacio de la Llave,204,204 Agua Dulce,Hombres,1362,1294,68,49
30 Veracruz de Ignacio de la Llave,204,204 Agua Dulce,Hombres,1495,1427,68,40
30 Veracruz de Ignacio de la Llave,204,204 Agua Dulce,Hombres,1175,1133,42,53
30 Veracruz de Ignacio de la Llave,204,204 Agua Dulce,Hombres,982,926,56,118
30 Veracruz de Ignacio de la Llave,204,204 Agua Dulce,Hombres,605,572,33,295
30 Veracruz de Ignacio de la Llave,204,204 Agua Dulce,Hombres,358,325,33,324
30 Veracruz de Ignacio de la Llave,204,204 Agua Dulce,Hombres,237,218,19,312
30 Veracruz de Ignacio de la Llave,204,204 Agua Dulce,Hombres,183,164,19,266
30 Veracruz de Ignacio de la Llave,204,204 Agua Dulce,Hombres,85,77,8,185
30 Veracruz de Ignacio de la Llave,204,204 Agua Dulce,Hombres,51,46,5,118
30 Veracruz de Ignacio de la Llave,204,204 Agua Dulce,Hombres,24,22,2,107
30 Veracruz de Ignacio de la Llave,204,204 Agua Dulce,Mujeres,4757,4603,154,13619
30 Veracruz de Ignacio de la Llave,204,204 Agua Dulce,Mujeres,16,15,1,1417
30 Veracruz de Ignacio de la Llave,204,204 Agua Dulce,Mujeres,221,207,14,1891
30 Veracruz de Ignacio de la Llave,204,204 Agua Dulce,Mujeres,567,522,45,1415
30 Veracruz de Ignacio de la Llave,204,204 Agua Dulce,Mujeres,680,643,37,1117
30 Veracruz de Ignacio de la Llave,204,204 Agua Dulce,Mujeres,699,680,19,1084
30 Veracruz de Ignacio de la Llave,204,204 Agua Dulce,Mujeres,702,689,13,1094
30 Veracruz de Ignacio de la Llave,204,204 Agua Dulce,Mujeres,613,604,9,979
30 Veracruz de Ignacio de la Llave,204,204 Agua Dulce,Mujeres,454,448,6,917
30 Veracruz de Ignacio de la Llave,204,204 Agua Dulce,Mujeres,362,357,5,813
30 Veracruz de Ignacio de la Llave,204,204 Agua Dulce,Mujeres,195,195,0,704
30 Veracruz de Ignacio de la Llave,204,204 Agua Dulce,Mujeres,113,111,2,645
30 Veracruz de Ignacio de la Llave,204,204 Agua Dulce,Mujeres,65,62,3,536
30 Veracruz de Ignacio de la Llave,204,204 Agua Dulce,Mujeres,48,48,0,432
30 Veracruz de Ignacio de la Llave,204,204 Agua Dulce,Mujeres,17,17,0,283
30 Veracruz de Ignacio de la Llave,204,204 Agua Dulce,Mujeres,5,5,0,152
30 Veracruz de Ignacio de la Llave,204,204 Agua Dulce,Mujeres,0,0,0,140
30 Veracruz de Ignacio de la Llave,160,160 Álamo Temapache,Total,37562,36046,1516,42829
30 Veracruz de Ignacio de la Llave,160,160 Álamo Temapache,Total,359,345,14,6134
30 Veracruz de Ignacio de la Llave,160,160 Álamo Temapache,Total,2975,2767,208,8527
30 Veracruz de Ignacio de la Llave,160,160 Álamo Temapache,Total,4366,4104,262,3702
30 Veracruz de Ignacio de la Llave,160,160 Álamo Temapache,Total,3919,3749,170,2640
30 Veracruz de Ignacio de la Llave,160,160 Álamo Temapache,Total,3905,3780,125,2565
30 Veracruz de Ignacio de la Llave,160,160 Álamo Temapache,Total,4211,4059,152,2925
30 Veracruz de Ignacio de la Llave,160,160 Álamo Temapache,Total,4111,3961,150,2768
30 Veracruz de Ignacio de la Llave,160,160 Álamo Temapache,Total,3560,3427,133,2362
30 Veracruz de Ignacio de la Llave,160,160 Álamo Temapache,Total,2961,2879,82,2217
30 Veracruz de Ignacio de la Llave,160,160 Álamo Temapache,Total,2255,2178,77,1939
30 Veracruz de Ignacio de la Llave,160,160 Álamo Temapache,Total,1791,1733,58,1787
30 Veracruz de Ignacio de la Llave,160,160 Álamo Temapache,Total,1325,1283,42,1567
30 Veracruz de Ignacio de la Llave,160,160 Álamo Temapache,Total,961,932,29,1491
30 Veracruz de Ignacio de la Llave,160,160 Álamo Temapache,Total,488,479,9,950
30 Veracruz de Ignacio de la Llave,160,160 Álamo Temapache,Total,226,224,2,600
30 Veracruz de Ignacio de la Llave,160,160 Álamo Temapache,Total,149,146,3,655
30 Veracruz de Ignacio de la Llave,160,160 Álamo Temapache,Hombres,29772,28436,1336,9617
30 Veracruz de Ignacio de la Llave,160,160 Álamo Temapache,Hombres,273,261,12,3007
30 Veracruz de Ignacio de la Llave,160,160 Álamo Temapache,Hombres,2331,2154,177,3475
30 Veracruz de Ignacio de la Llave,160,160 Álamo Temapache,Hombres,3320,3119,201,743
30 Veracruz de Ignacio de la Llave,160,160 Álamo Temapache,Hombres,2945,2804,141,141
30 Veracruz de Ignacio de la Llave,160,160 Álamo Temapache,Hombres,2972,2866,106,90
30 Veracruz de Ignacio de la Llave,160,160 Álamo Temapache,Hombres,3273,3138,135,102
30 Veracruz de Ignacio de la Llave,160,160 Álamo Temapache,Hombres,3156,3013,143,120
30 Veracruz de Ignacio de la Llave,160,160 Álamo Temapache,Hombres,2808,2682,126,97
30 Veracruz de Ignacio de la Llave,160,160 Álamo Temapache,Hombres,2374,2292,82,157
30 Veracruz de Ignacio de la Llave,160,160 Álamo Temapache,Hombres,1871,1796,75,183
30 Veracruz de Ignacio de la Llave,160,160 Álamo Temapache,Hombres,1552,1496,56,220
30 Veracruz de Ignacio de la Llave,160,160 Álamo Temapache,Hombres,1203,1163,40,267
30 Veracruz de Ignacio de la Llave,160,160 Álamo Temapache,Hombres,879,850,29,329
30 Veracruz de Ignacio de la Llave,160,160 Álamo Temapache,Hombres,463,455,8,259
30 Veracruz de Ignacio de la Llave,160,160 Álamo Temapache,Hombres,210,208,2,188
30 Veracruz de Ignacio de la Llave,160,160 Álamo Temapache,Hombres,142,139,3,239
30 Veracruz de Ignacio de la Llave,160,160 Álamo Temapache,Mujeres,7790,7610,180,33212
30 Veracruz de Ignacio de la Llave,160,160 Álamo Temapache,Mujeres,86,84,2,3127
30 Veracruz de Ignacio de la Llave,160,160 Álamo Temapache,Mujeres,644,613,31,5052
30 Veracruz de Ignacio de la Llave,160,160 Álamo Temapache,Mujeres,1046,985,61,2959
30 Veracruz de Ignacio de la Llave,160,160 Álamo Temapache,Mujeres,974,945,29,2499
30 Veracruz de Ignacio de la Llave,160,160 Álamo Temapache,Mujeres,933,914,19,2475
30 Veracruz de Ignacio de la Llave,160,160 Álamo Temapache,Mujeres,938,921,17,2823
30 Veracruz de Ignacio de la Llave,160,160 Álamo Temapache,Mujeres,955,948,7,2648
30 Veracruz de Ignacio de la Llave,160,160 Álamo Temapache,Mujeres,752,745,7,2265
30 Veracruz de Ignacio de la Llave,160,160 Álamo Temapache,Mujeres,587,587,0,2060
30 Veracruz de Ignacio de la Llave,160,160 Álamo Temapache,Mujeres,384,382,2,1756
30 Veracruz de Ignacio de la Llave,160,160 Álamo Temapache,Mujeres,239,237,2,1567
30 Veracruz de Ignacio de la Llave,160,160 Álamo Temapache,Mujeres,122,120,2,1300
30 Veracruz de Ignacio de la Llave,160,160 Álamo Temapache,Mujeres,82,82,0,1162
30 Veracruz de Ignacio de la Llave,160,160 Álamo Temapache,Mujeres,25,24,1,691
30 Veracruz de Ignacio de la Llave,160,160 Álamo Temapache,Mujeres,16,16,0,412
30 Veracruz de Ignacio de la Llave,160,160 Álamo Temapache,Mujeres,7,7,0,416
30 Veracruz de Ignacio de la Llave,8,008 Alpatláhuac,Total,2891,2826,65,3798
30 Veracruz de Ignacio de la Llave,8,008 Alpatláhuac,Total,46,46,0,721
30 Veracruz de Ignacio de la Llave,8,008 Alpatláhuac,Total,369,360,9,784
30 Veracruz de Ignacio de la Llave,8,008 Alpatláhuac,Total,384,375,9,355
30 Veracruz de Ignacio de la Llave,8,008 Alpatláhuac,Total,356,345,11,289
30 Veracruz de Ignacio de la Llave,8,008 Alpatláhuac,Total,317,311,6,266
30 Veracruz de Ignacio de la Llave,8,008 Alpatláhuac,Total,283,278,5,225
30 Veracruz de Ignacio de la Llave,8,008 Alpatláhuac,Total,230,222,8,221
30 Veracruz de Ignacio de la Llave,8,008 Alpatláhuac,Total,207,203,4,179
30 Veracruz de Ignacio de la Llave,8,008 Alpatláhuac,Total,172,167,5,128
30 Veracruz de Ignacio de la Llave,8,008 Alpatláhuac,Total,156,155,1,117
30 Veracruz de Ignacio de la Llave,8,008 Alpatláhuac,Total,128,124,4,139
30 Veracruz de Ignacio de la Llave,8,008 Alpatláhuac,Total,89,88,1,98
30 Veracruz de Ignacio de la Llave,8,008 Alpatláhuac,Total,78,76,2,99
30 Veracruz de Ignacio de la Llave,8,008 Alpatláhuac,Total,46,46,0,73
30 Veracruz de Ignacio de la Llave,8,008 Alpatláhuac,Total,20,20,0,48
30 Veracruz de Ignacio de la Llave,8,008 Alpatláhuac,Total,10,10,0,56
30 Veracruz de Ignacio de la Llave,8,008 Alpatláhuac,Hombres,2394,2329,65,878
30 Veracruz de Ignacio de la Llave,8,008 Alpatláhuac,Hombres,38,38,0,335
30 Veracruz de Ignacio de la Llave,8,008 Alpatláhuac,Hombres,304,295,9,276
30 Veracruz de Ignacio de la Llave,8,008 Alpatláhuac,Hombres,313,304,9,43
30 Veracruz de Ignacio de la Llave,8,008 Alpatláhuac,Hombres,291,280,11,21
30 Veracruz de Ignacio de la Llave,8,008 Alpatláhuac,Hombres,253,247,6,17
30 Veracruz de Ignacio de la Llave,8,008 Alpatláhuac,Hombres,242,237,5,17
30 Veracruz de Ignacio de la Llave,8,008 Alpatláhuac,Hombres,187,179,8,14
30 Veracruz de Ignacio de la Llave,8,008 Alpatláhuac,Hombres,176,172,4,13
30 Veracruz de Ignacio de la Llave,8,008 Alpatláhuac,Hombres,142,137,5,15
30 Veracruz de Ignacio de la Llave,8,008 Alpatláhuac,Hombres,129,128,1,11
30 Veracruz de Ignacio de la Llave,8,008 Alpatláhuac,Hombres,111,107,4,9
30 Veracruz de Ignacio de la Llave,8,008 Alpatláhuac,Hombres,73,72,1,14
30 Veracruz de Ignacio de la Llave,8,008 Alpatláhuac,Hombres,63,61,2,30
30 Veracruz de Ignacio de la Llave,8,008 Alpatláhuac,Hombres,44,44,0,19
30 Veracruz de Ignacio de la Llave,8,008 Alpatláhuac,Hombres,19,19,0,22
30 Veracruz de Ignacio de la Llave,8,008 Alpatláhuac,Hombres,9,9,0,22
30 Veracruz de Ignacio de la Llave,8,008 Alpatláhuac,Mujeres,497,497,0,2920
30 Veracruz de Ignacio de la Llave,8,008 Alpatláhuac,Mujeres,8,8,0,386
30 Veracruz de Ignacio de la Llave,8,008 Alpatláhuac,Mujeres,65,65,0,508
30 Veracruz de Ignacio de la Llave,8,008 Alpatláhuac,Mujeres,71,71,0,312
30 Veracruz de Ignacio de la Llave,8,008 Alpatláhuac,Mujeres,65,65,0,268
30 Veracruz de Ignacio de la Llave,8,008 Alpatláhuac,Mujeres,64,64,0,249
30 Veracruz de Ignacio de la Llave,8,008 Alpatláhuac,Mujeres,41,41,0,208
30 Veracruz de Ignacio de la Llave,8,008 Alpatláhuac,Mujeres,43,43,0,207
30 Veracruz de Ignacio de la Llave,8,008 Alpatláhuac,Mujeres,31,31,0,166
30 Veracruz de Ignacio de la Llave,8,008 Alpatláhuac,Mujeres,30,30,0,113
30 Veracruz de Ignacio de la Llave,8,008 Alpatláhuac,Mujeres,27,27,0,106
30 Veracruz de Ignacio de la Llave,8,008 Alpatláhuac,Mujeres,17,17,0,130
30 Veracruz de Ignacio de la Llave,8,008 Alpatláhuac,Mujeres,16,16,0,84
30 Veracruz de Ignacio de la Llave,8,008 Alpatláhuac,Mujeres,15,15,0,69
30 Veracruz de Ignacio de la Llave,8,008 Alpatláhuac,Mujeres,2,2,0,54
30 Veracruz de Ignacio de la Llave,8,008 Alpatláhuac,Mujeres,1,1,0,26
30 Veracruz de Ignacio de la Llave,8,008 Alpatláhuac,Mujeres,1,1,0,34
30 Veracruz de Ignacio de la Llave,9,009 Alto Lucero de Gutiérrez Barrios,Total,10345,9978,367,11929
30 Veracruz de Ignacio de la Llave,9,009 Alto Lucero de Gutiérrez Barrios,Total,102,100,2,1478
30 Veracruz de Ignacio de la Llave,9,009 Alto Lucero de Gutiérrez Barrios,Total,791,761,30,1713
30 Veracruz de Ignacio de la Llave,9,009 Alto Lucero de Gutiérrez Barrios,Total,1181,1131,50,873
30 Veracruz de Ignacio de la Llave,9,009 Alto Lucero de Gutiérrez Barrios,Total,988,956,32,821
30 Veracruz de Ignacio de la Llave,9,009 Alto Lucero de Gutiérrez Barrios,Total,1089,1053,36,852
30 Veracruz de Ignacio de la Llave,9,009 Alto Lucero de Gutiérrez Barrios,Total,1174,1132,42,967
30 Veracruz de Ignacio de la Llave,9,009 Alto Lucero de Gutiérrez Barrios,Total,1022,982,40,793
30 Veracruz de Ignacio de la Llave,9,009 Alto Lucero de Gutiérrez Barrios,Total,959,930,29,761
30 Veracruz de Ignacio de la Llave,9,009 Alto Lucero de Gutiérrez Barrios,Total,829,798,31,723
30 Veracruz de Ignacio de la Llave,9,009 Alto Lucero de Gutiérrez Barrios,Total,668,650,18,605
30 Veracruz de Ignacio de la Llave,9,009 Alto Lucero de Gutiérrez Barrios,Total,504,482,22,537
30 Veracruz de Ignacio de la Llave,9,009 Alto Lucero de Gutiérrez Barrios,Total,424,413,11,439
30 Veracruz de Ignacio de la Llave,9,009 Alto Lucero de Gutiérrez Barrios,Total,309,299,10,542
30 Veracruz de Ignacio de la Llave,9,009 Alto Lucero de Gutiérrez Barrios,Total,162,158,4,327
30 Veracruz de Ignacio de la Llave,9,009 Alto Lucero de Gutiérrez Barrios,Total,84,79,5,238
30 Veracruz de Ignacio de la Llave,9,009 Alto Lucero de Gutiérrez Barrios,Total,59,54,5,260
30 Veracruz de Ignacio de la Llave,9,009 Alto Lucero de Gutiérrez Barrios,Hombres,8796,8453,343,2332
30 Veracruz de Ignacio de la Llave,9,009 Alto Lucero de Gutiérrez Barrios,Hombres,80,78,2,722
30 Veracruz de Ignacio de la Llave,9,009 Alto Lucero de Gutiérrez Barrios,Hombres,631,605,26,646
30 Veracruz de Ignacio de la Llave,9,009 Alto Lucero de Gutiérrez Barrios,Hombres,885,843,42,123
30 Veracruz de Ignacio de la Llave,9,009 Alto Lucero de Gutiérrez Barrios,Hombres,796,769,27,51
30 Veracruz de Ignacio de la Llave,9,009 Alto Lucero de Gutiérrez Barrios,Hombres,923,888,35,33
30 Veracruz de Ignacio de la Llave,9,009 Alto Lucero de Gutiérrez Barrios,Hombres,980,940,40,38
30 Veracruz de Ignacio de la Llave,9,009 Alto Lucero de Gutiérrez Barrios,Hombres,889,851,38,46
30 Veracruz de Ignacio de la Llave,9,009 Alto Lucero de Gutiérrez Barrios,Hombres,813,785,28,34
30 Veracruz de Ignacio de la Llave,9,009 Alto Lucero de Gutiérrez Barrios,Hombres,751,721,30,44
30 Veracruz de Ignacio de la Llave,9,009 Alto Lucero de Gutiérrez Barrios,Hombres,601,583,18,65
30 Veracruz de Ignacio de la Llave,9,009 Alto Lucero de Gutiérrez Barrios,Hombres,467,445,22,50
30 Veracruz de Ignacio de la Llave,9,009 Alto Lucero de Gutiérrez Barrios,Hombres,393,382,11,69
30 Veracruz de Ignacio de la Llave,9,009 Alto Lucero de Gutiérrez Barrios,Hombres,297,287,10,143
30 Veracruz de Ignacio de la Llave,9,009 Alto Lucero de Gutiérrez Barrios,Hombres,156,152,4,83
30 Veracruz de Ignacio de la Llave,9,009 Alto Lucero de Gutiérrez Barrios,Hombres,78,73,5,78
30 Veracruz de Ignacio de la Llave,9,009 Alto Lucero de Gutiérrez Barrios,Hombres,56,51,5,107
30 Veracruz de Ignacio de la Llave,9,009 Alto Lucero de Gutiérrez Barrios,Mujeres,1549,1525,24,9597
30 Veracruz de Ignacio de la Llave,9,009 Alto Lucero de Gutiérrez Barrios,Mujeres,22,22,0,756
30 Veracruz de Ignacio de la Llave,9,009 Alto Lucero de Gutiérrez Barrios,Mujeres,160,156,4,1067
30 Veracruz de Ignacio de la Llave,9,009 Alto Lucero de Gutiérrez Barrios,Mujeres,296,288,8,750
30 Veracruz de Ignacio de la Llave,9,009 Alto Lucero de Gutiérrez Barrios,Mujeres,192,187,5,770
30 Veracruz de Ignacio de la Llave,9,009 Alto Lucero de Gutiérrez Barrios,Mujeres,166,165,1,819
30 Veracruz de Ignacio de la Llave,9,009 Alto Lucero de Gutiérrez Barrios,Mujeres,194,192,2,929
30 Veracruz de Ignacio de la Llave,9,009 Alto Lucero de Gutiérrez Barrios,Mujeres,133,131,2,747
30 Veracruz de Ignacio de la Llave,9,009 Alto Lucero de Gutiérrez Barrios,Mujeres,146,145,1,727
30 Veracruz de Ignacio de la Llave,9,009 Alto Lucero de Gutiérrez Barrios,Mujeres,78,77,1,679
30 Veracruz de Ignacio de la Llave,9,009 Alto Lucero de Gutiérrez Barrios,Mujeres,67,67,0,540
30 Veracruz de Ignacio de la Llave,9,009 Alto Lucero de Gutiérrez Barrios,Mujeres,37,37,0,487
30 Veracruz de Ignacio de la Llave,9,009 Alto Lucero de Gutiérrez Barrios,Mujeres,31,31,0,370
30 Veracruz de Ignacio de la Llave,9,009 Alto Lucero de Gutiérrez Barrios,Mujeres,12,12,0,399
30 Veracruz de Ignacio de la Llave,9,009 Alto Lucero de Gutiérrez Barrios,Mujeres,6,6,0,244
30 Veracruz de Ignacio de la Llave,9,009 Alto Lucero de Gutiérrez Barrios,Mujeres,6,6,0,160
30 Veracruz de Ignacio de la Llave,9,009 Alto Lucero de Gutiérrez Barrios,Mujeres,3,3,0,153
30 Veracruz de Ignacio de la Llave,10,010 Altotonga,Total,20872,20594,278,21299
30 Veracruz de Ignacio de la Llave,10,010 Altotonga,Total,389,375,14,4003
30 Veracruz de Ignacio de la Llave,10,010 Altotonga,Total,2628,2594,34,4077
30 Veracruz de Ignacio de la Llave,10,010 Altotonga,Total,2827,2770,57,2085
30 Veracruz de Ignacio de la Llave,10,010 Altotonga,Total,2683,2648,35,1682
30 Veracruz de Ignacio de la Llave,10,010 Altotonga,Total,2624,2592,32,1639
30 Veracruz de Ignacio de la Llave,10,010 Altotonga,Total,2127,2105,22,1351
30 Veracruz de Ignacio de la Llave,10,010 Altotonga,Total,1895,1878,17,1113
30 Veracruz de Ignacio de la Llave,10,010 Altotonga,Total,1484,1468,16,915
30 Veracruz de Ignacio de la Llave,10,010 Altotonga,Total,1221,1203,18,859
30 Veracruz de Ignacio de la Llave,10,010 Altotonga,Total,950,942,8,775
30 Veracruz de Ignacio de la Llave,10,010 Altotonga,Total,691,680,11,704
30 Veracruz de Ignacio de la Llave,10,010 Altotonga,Total,506,496,10,596
30 Veracruz de Ignacio de la Llave,10,010 Altotonga,Total,372,370,2,561
30 Veracruz de Ignacio de la Llave,10,010 Altotonga,Total,253,251,2,372
30 Veracruz de Ignacio de la Llave,10,010 Altotonga,Total,134,134,0,267
30 Veracruz de Ignacio de la Llave,10,010 Altotonga,Total,88,88,0,300
30 Veracruz de Ignacio de la Llave,10,010 Altotonga,Hombres,15750,15507,243,4167
30 Veracruz de Ignacio de la Llave,10,010 Altotonga,Hombres,324,312,12,1875
30 Veracruz de Ignacio de la Llave,10,010 Altotonga,Hombres,1968,1939,29,1416
30 Veracruz de Ignacio de la Llave,10,010 Altotonga,Hombres,2045,1999,46,233
30 Veracruz de Ignacio de la Llave,10,010 Altotonga,Hombres,1962,1934,28,47
30 Veracruz de Ignacio de la Llave,10,010 Altotonga,Hombres,1910,1882,28,48
30 Veracruz de Ignacio de la Llave,10,010 Altotonga,Hombres,1568,1548,20,28
30 Veracruz de Ignacio de la Llave,10,010 Altotonga,Hombres,1385,1370,15,35
30 Veracruz de Ignacio de la Llave,10,010 Altotonga,Hombres,1102,1086,16,23
30 Veracruz de Ignacio de la Llave,10,010 Altotonga,Hombres,950,933,17,34
30 Veracruz de Ignacio de la Llave,10,010 Altotonga,Hombres,763,755,8,34
30 Veracruz de Ignacio de la Llave,10,010 Altotonga,Hombres,575,565,10,69
30 Veracruz de Ignacio de la Llave,10,010 Altotonga,Hombres,436,426,10,61
30 Veracruz de Ignacio de la Llave,10,010 Altotonga,Hombres,331,329,2,71
30 Veracruz de Ignacio de la Llave,10,010 Altotonga,Hombres,225,223,2,65
30 Veracruz de Ignacio de la Llave,10,010 Altotonga,Hombres,125,125,0,51
30 Veracruz de Ignacio de la Llave,10,010 Altotonga,Hombres,81,81,0,77
30 Veracruz de Ignacio de la Llave,10,010 Altotonga,Mujeres,5122,5087,35,17132
30 Veracruz de Ignacio de la Llave,10,010 Altotonga,Mujeres,65,63,2,2128
30 Veracruz de Ignacio de la Llave,10,010 Altotonga,Mujeres,660,655,5,2661
30 Veracruz de Ignacio de la Llave,10,010 Altotonga,Mujeres,782,771,11,1852
30 Veracruz de Ignacio de la Llave,10,010 Altotonga,Mujeres,721,714,7,1635
30 Veracruz de Ignacio de la Llave,10,010 Altotonga,Mujeres,714,710,4,1591
30 Veracruz de Ignacio de la Llave,10,010 Altotonga,Mujeres,559,557,2,1323
30 Veracruz de Ignacio de la Llave,10,010 Altotonga,Mujeres,510,508,2,1078
30 Veracruz de Ignacio de la Llave,10,010 Altotonga,Mujeres,382,382,0,892
30 Veracruz de Ignacio de la Llave,10,010 Altotonga,Mujeres,271,270,1,825
30 Veracruz de Ignacio de la Llave,10,010 Altotonga,Mujeres,187,187,0,741
30 Veracruz de Ignacio de la Llave,10,010 Altotonga,Mujeres,116,115,1,635
30 Veracruz de Ignacio de la Llave,10,010 Altotonga,Mujeres,70,70,0,535
30 Veracruz de Ignacio de la Llave,10,010 Altotonga,Mujeres,41,41,0,490
30 Veracruz de Ignacio de la Llave,10,010 Altotonga,Mujeres,28,28,0,307
30 Veracruz de Ignacio de la Llave,10,010 Altotonga,Mujeres,9,9,0,216
30 Veracruz de Ignacio de la Llave,10,010 Altotonga,Mujeres,7,7,0,223
30 Veracruz de Ignacio de la Llave,11,011 Alvarado,Total,20631,20140,491,20415
30 Veracruz de Ignacio de la Llave,11,011 Alvarado,Total,79,68,11,2553
30 Veracruz de Ignacio de la Llave,11,011 Alvarado,Total,1034,968,66,3860
30 Veracruz de Ignacio de la Llave,11,011 Alvarado,Total,2010,1899,111,2061
30 Veracruz de Ignacio de la Llave,11,011 Alvarado,Total,2257,2170,87,1181
30 Veracruz de Ignacio de la Llave,11,011 Alvarado,Total,2357,2302,55,1151
30 Veracruz de Ignacio de la Llave,11,011 Alvarado,Total,2588,2553,35,1172
30 Veracruz de Ignacio de la Llave,11,011 Alvarado,Total,2601,2564,37,1230
30 Veracruz de Ignacio de la Llave,11,011 Alvarado,Total,2160,2140,20,969
30 Veracruz de Ignacio de la Llave,11,011 Alvarado,Total,1830,1804,26,989
30 Veracruz de Ignacio de la Llave,11,011 Alvarado,Total,1422,1402,20,935
30 Veracruz de Ignacio de la Llave,11,011 Alvarado,Total,957,949,8,1099
30 Veracruz de Ignacio de la Llave,11,011 Alvarado,Total,568,559,9,893
30 Veracruz de Ignacio de la Llave,11,011 Alvarado,Total,407,404,3,864
30 Veracruz de Ignacio de la Llave,11,011 Alvarado,Total,219,217,2,604
30 Veracruz de Ignacio de la Llave,11,011 Alvarado,Total,100,99,1,449
30 Veracruz de Ignacio de la Llave,11,011 Alvarado,Total,42,42,0,405
30 Veracruz de Ignacio de la Llave,11,011 Alvarado,Hombres,14628,14248,380,5394
30 Veracruz de Ignacio de la Llave,11,011 Alvarado,Hombres,69,60,9,1283
30 Veracruz de Ignacio de la Llave,11,011 Alvarado,Hombres,814,756,58,1812
30 Veracruz de Ignacio de la Llave,11,011 Alvarado,Hombres,1427,1348,79,539
30 Veracruz de Ignacio de la Llave,11,011 Alvarado,Hombres,1541,1484,57,115
30 Veracruz de Ignacio de la Llave,11,011 Alvarado,Hombres,1533,1498,35,54
30 Veracruz de Ignacio de la Llave,11,011 Alvarado,Hombres,1716,1690,26,40
30 Veracruz de Ignacio de la Llave,11,011 Alvarado,Hombres,1804,1772,32,56
30 Veracruz de Ignacio de la Llave,11,011 Alvarado,Hombres,1467,1447,20,76
30 Veracruz de Ignacio de la Llave,11,011 Alvarado,Hombres,1324,1301,23,93
30 Veracruz de Ignacio de la Llave,11,011 Alvarado,Hombres,1063,1044,19,115
30 Veracruz de Ignacio de la Llave,11,011 Alvarado,Hombres,731,724,7,255
30 Veracruz de Ignacio de la Llave,11,011 Alvarado,Hombres,460,451,9,246
30 Veracruz de Ignacio de la Llave,11,011 Alvarado,Hombres,344,341,3,236
30 Veracruz de Ignacio de la Llave,11,011 Alvarado,Hombres,201,199,2,183
30 Veracruz de Ignacio de la Llave,11,011 Alvarado,Hombres,94,93,1,142
30 Veracruz de Ignacio de la Llave,11,011 Alvarado,Hombres,40,40,0,149
30 Veracruz de Ignacio de la Llave,11,011 Alvarado,Mujeres,6003,5892,111,15021
30 Veracruz de Ignacio de la Llave,11,011 Alvarado,Mujeres,10,8,2,1270
30 Veracruz de Ignacio de la Llave,11,011 Alvarado,Mujeres,220,212,8,2048
30 Veracruz de Ignacio de la Llave,11,011 Alvarado,Mujeres,583,551,32,1522
30 Veracruz de Ignacio de la Llave,11,011 Alvarado,Mujeres,716,686,30,1066
30 Veracruz de Ignacio de la Llave,11,011 Alvarado,Mujeres,824,804,20,1097
30 Veracruz de Ignacio de la Llave,11,011 Alvarado,Mujeres,872,863,9,1132
30 Veracruz de Ignacio de la Llave,11,011 Alvarado,Mujeres,797,792,5,1174
30 Veracruz de Ignacio de la Llave,11,011 Alvarado,Mujeres,693,693,0,893
30 Veracruz de Ignacio de la Llave,11,011 Alvarado,Mujeres,506,503,3,896
30 Veracruz de Ignacio de la Llave,11,011 Alvarado,Mujeres,359,358,1,820
30 Veracruz de Ignacio de la Llave,11,011 Alvarado,Mujeres,226,225,1,844
30 Veracruz de Ignacio de la Llave,11,011 Alvarado,Mujeres,108,108,0,647
30 Veracruz de Ignacio de la Llave,11,011 Alvarado,Mujeres,63,63,0,628
30 Veracruz de Ignacio de la Llave,11,011 Alvarado,Mujeres,18,18,0,421
30 Veracruz de Ignacio de la Llave,11,011 Alvarado,Mujeres,6,6,0,307
30 Veracruz de Ignacio de la Llave,11,011 Alvarado,Mujeres,2,2,0,256
30 Veracruz de Ignacio de la Llave,12,012 Amatitlán,Total,2634,2460,174,3379
30 Veracruz de Ignacio de la Llave,12,012 Amatitlán,Total,12,11,1,326
30 Veracruz de Ignacio de la Llave,12,012 Amatitlán,Total,131,120,11,473
30 Veracruz de Ignacio de la Llave,12,012 Amatitlán,Total,275,245,30,269
30 Veracruz de Ignacio de la Llave,12,012 Amatitlán,Total,273,250,23,224
30 Veracruz de Ignacio de la Llave,12,012 Amatitlán,Total,334,314,20,214
30 Veracruz de Ignacio de la Llave,12,012 Amatitlán,Total,304,287,17,232
30 Veracruz de Ignacio de la Llave,12,012 Amatitlán,Total,296,284,12,229
30 Veracruz de Ignacio de la Llave,12,012 Amatitlán,Total,290,271,19,213
30 Veracruz de Ignacio de la Llave,12,012 Amatitlán,Total,234,219,15,198
30 Veracruz de Ignacio de la Llave,12,012 Amatitlán,Total,200,187,13,207
30 Veracruz de Ignacio de la Llave,12,012 Amatitlán,Total,125,120,5,174
30 Veracruz de Ignacio de la Llave,12,012 Amatitlán,Total,70,65,5,179
30 Veracruz de Ignacio de la Llave,12,012 Amatitlán,Total,49,47,2,166
30 Veracruz de Ignacio de la Llave,12,012 Amatitlán,Total,28,28,0,106
30 Veracruz de Ignacio de la Llave,12,012 Amatitlán,Total,8,7,1,84
30 Veracruz de Ignacio de la Llave,12,012 Amatitlán,Total,5,5,0,85
30 Veracruz de Ignacio de la Llave,12,012 Amatitlán,Hombres,2106,1946,160,789
30 Veracruz de Ignacio de la Llave,12,012 Amatitlán,Hombres,9,8,1,155
30 Veracruz de Ignacio de la Llave,12,012 Amatitlán,Hombres,111,101,10,195
30 Veracruz de Ignacio de la Llave,12,012 Amatitlán,Hombres,214,193,21,43
30 Veracruz de Ignacio de la Llave,12,012 Amatitlán,Hombres,207,187,20,13
30 Veracruz de Ignacio de la Llave,12,012 Amatitlán,Hombres,253,233,20,13
30 Veracruz de Ignacio de la Llave,12,012 Amatitlán,Hombres,231,214,17,15
30 Veracruz de Ignacio de la Llave,12,012 Amatitlán,Hombres,237,225,12,13
30 Veracruz de Ignacio de la Llave,12,012 Amatitlán,Hombres,240,221,19,11
30 Veracruz de Ignacio de la Llave,12,012 Amatitlán,Hombres,186,172,14,21
30 Veracruz de Ignacio de la Llave,12,012 Amatitlán,Hombres,168,155,13,26
30 Veracruz de Ignacio de la Llave,12,012 Amatitlán,Hombres,109,104,5,47
30 Veracruz de Ignacio de la Llave,12,012 Amatitlán,Hombres,58,53,5,64
30 Veracruz de Ignacio de la Llave,12,012 Amatitlán,Hombres,46,44,2,58
30 Veracruz de Ignacio de la Llave,12,012 Amatitlán,Hombres,27,27,0,40
30 Veracruz de Ignacio de la Llave,12,012 Amatitlán,Hombres,6,5,1,35
30 Veracruz de Ignacio de la Llave,12,012 Amatitlán,Hombres,4,4,0,40
30 Veracruz de Ignacio de la Llave,12,012 Amatitlán,Mujeres,528,514,14,2590
30 Veracruz de Ignacio de la Llave,12,012 Amatitlán,Mujeres,3,3,0,171
30 Veracruz de Ignacio de la Llave,12,012 Amatitlán,Mujeres,20,19,1,278
30 Veracruz de Ignacio de la Llave,12,012 Amatitlán,Mujeres,61,52,9,226
30 Veracruz de Ignacio de la Llave,12,012 Amatitlán,Mujeres,66,63,3,211
30 Veracruz de Ignacio de la Llave,12,012 Amatitlán,Mujeres,81,81,0,201
30 Veracruz de Ignacio de la Llave,12,012 Amatitlán,Mujeres,73,73,0,217
30 Veracruz de Ignacio de la Llave,12,012 Amatitlán,Mujeres,59,59,0,216
30 Veracruz de Ignacio de la Llave,12,012 Amatitlán,Mujeres,50,50,0,202
30 Veracruz de Ignacio de la Llave,12,012 Amatitlán,Mujeres,48,47,1,177
30 Veracruz de Ignacio de la Llave,12,012 Amatitlán,Mujeres,32,32,0,181
30 Veracruz de Ignacio de la Llave,12,012 Amatitlán,Mujeres,16,16,0,127
30 Veracruz de Ignacio de la Llave,12,012 Amatitlán,Mujeres,12,12,0,115
30 Veracruz de Ignacio de la Llave,12,012 Amatitlán,Mujeres,3,3,0,108
30 Veracruz de Ignacio de la Llave,12,012 Amatitlán,Mujeres,1,1,0,66
30 Veracruz de Ignacio de la Llave,12,012 Amatitlán,Mujeres,2,2,0,49
30 Veracruz de Ignacio de la Llave,12,012 Amatitlán,Mujeres,1,1,0,45
30 Veracruz de Ignacio de la Llave,14,014 Amatlán de los Reyes,Total,16574,15946,628,16325
30 Veracruz de Ignacio de la Llave,14,014 Amatlán de los Reyes,Total,92,76,16,2225
30 Veracruz de Ignacio de la Llave,14,014 Amatlán de los Reyes,Total,1179,1079,100,2748
30 Veracruz de Ignacio de la Llave,14,014 Amatlán de los Reyes,Total,2180,2053,127,1603
30 Veracruz de Ignacio de la Llave,14,014 Amatlán de los Reyes,Total,2195,2099,96,1142
30 Veracruz de Ignacio de la Llave,14,014 Amatlán de los Reyes,Total,2109,2056,53,1179
30 Veracruz de Ignacio de la Llave,14,014 Amatlán de los Reyes,Total,2194,2141,53,1129
30 Veracruz de Ignacio de la Llave,14,014 Amatlán de los Reyes,Total,1762,1727,35,989
30 Veracruz de Ignacio de la Llave,14,014 Amatlán de los Reyes,Total,1408,1372,36,880
30 Veracruz de Ignacio de la Llave,14,014 Amatlán de los Reyes,Total,1111,1076,35,731
30 Veracruz de Ignacio de la Llave,14,014 Amatlán de los Reyes,Total,889,861,28,716
30 Veracruz de Ignacio de la Llave,14,014 Amatlán de los Reyes,Total,583,559,24,717
30 Veracruz de Ignacio de la Llave,14,014 Amatlán de los Reyes,Total,357,346,11,623
30 Veracruz de Ignacio de la Llave,14,014 Amatlán de los Reyes,Total,256,248,8,639
30 Veracruz de Ignacio de la Llave,14,014 Amatlán de los Reyes,Total,136,132,4,411
30 Veracruz de Ignacio de la Llave,14,014 Amatlán de los Reyes,Total,82,80,2,327
30 Veracruz de Ignacio de la Llave,14,014 Amatlán de los Reyes,Total,41,41,0,266
30 Veracruz de Ignacio de la Llave,14,014 Amatlán de los Reyes,Hombres,12065,11555,510,3774
30 Veracruz de Ignacio de la Llave,14,014 Amatlán de los Reyes,Hombres,76,61,15,1103
30 Veracruz de Ignacio de la Llave,14,014 Amatlán de los Reyes,Hombres,936,853,83,1083
30 Veracruz de Ignacio de la Llave,14,014 Amatlán de los Reyes,Hombres,1474,1386,88,310
30 Veracruz de Ignacio de la Llave,14,014 Amatlán de los Reyes,Hombres,1548,1478,70,95
30 Veracruz de Ignacio de la Llave,14,014 Amatlán de los Reyes,Hombres,1485,1443,42,51
30 Veracruz de Ignacio de la Llave,14,014 Amatlán de los Reyes,Hombres,1546,1498,48,55
30 Veracruz de Ignacio de la Llave,14,014 Amatlán de los Reyes,Hombres,1236,1204,32,51
30 Veracruz de Ignacio de la Llave,14,014 Amatlán de los Reyes,Hombres,1033,1004,29,48
30 Veracruz de Ignacio de la Llave,14,014 Amatlán de los Reyes,Hombres,819,786,33,70
30 Veracruz de Ignacio de la Llave,14,014 Amatlán de los Reyes,Hombres,706,682,24,72
30 Veracruz de Ignacio de la Llave,14,014 Amatlán de los Reyes,Hombres,468,446,22,145
30 Veracruz de Ignacio de la Llave,14,014 Amatlán de los Reyes,Hombres,298,288,10,150
30 Veracruz de Ignacio de la Llave,14,014 Amatlán de los Reyes,Hombres,216,208,8,186
30 Veracruz de Ignacio de la Llave,14,014 Amatlán de los Reyes,Hombres,116,112,4,141
30 Veracruz de Ignacio de la Llave,14,014 Amatlán de los Reyes,Hombres,74,72,2,120
30 Veracruz de Ignacio de la Llave,14,014 Amatlán de los Reyes,Hombres,34,34,0,94
30 Veracruz de Ignacio de la Llave,14,014 Amatlán de los Reyes,Mujeres,4509,4391,118,12551
30 Veracruz de Ignacio de la Llave,14,014 Amatlán de los Reyes,Mujeres,16,15,1,1122
30 Veracruz de Ignacio de la Llave,14,014 Amatlán de los Reyes,Mujeres,243,226,17,1665
30 Veracruz de Ignacio de la Llave,14,014 Amatlán de los Reyes,Mujeres,706,667,39,1293
30 Veracruz de Ignacio de la Llave,14,014 Amatlán de los Reyes,Mujeres,647,621,26,1047
30 Veracruz de Ignacio de la Llave,14,014 Amatlán de los Reyes,Mujeres,624,613,11,1128
30 Veracruz de Ignacio de la Llave,14,014 Amatlán de los Reyes,Mujeres,648,643,5,1074
30 Veracruz de Ignacio de la Llave,14,014 Amatlán de los Reyes,Mujeres,526,523,3,938
30 Veracruz de Ignacio de la Llave,14,014 Amatlán de los Reyes,Mujeres,375,368,7,832
30 Veracruz de Ignacio de la Llave,14,014 Amatlán de los Reyes,Mujeres,292,290,2,661
30 Veracruz de Ignacio de la Llave,14,014 Amatlán de los Reyes,Mujeres,183,179,4,644
30 Veracruz de Ignacio de la Llave,14,014 Amatlán de los Reyes,Mujeres,115,113,2,572
30 Veracruz de Ignacio de la Llave,14,014 Amatlán de los Reyes,Mujeres,59,58,1,473
30 Veracruz de Ignacio de la Llave,14,014 Amatlán de los Reyes,Mujeres,40,40,0,453
30 Veracruz de Ignacio de la Llave,14,014 Amatlán de los Reyes,Mujeres,20,20,0,270
30 Veracruz de Ignacio de la Llave,14,014 Amatlán de los Reyes,Mujeres,8,8,0,207
30 Veracruz de Ignacio de la Llave,14,014 Amatlán de los Reyes,Mujeres,7,7,0,172
30 Veracruz de Ignacio de la Llave,15,015 Angel R. Cabada,Total,11499,10959,540,15136
30 Veracruz de Ignacio de la Llave,15,015 Angel R. Cabada,Total,77,64,13,1824
30 Veracruz de Ignacio de la Llave,15,015 Angel R. Cabada,Total,755,688,67,2392
30 Veracruz de Ignacio de la Llave,15,015 Angel R. Cabada,Total,1329,1232,97,1132
30 Veracruz de Ignacio de la Llave,15,015 Angel R. Cabada,Total,1122,1072,50,956
30 Veracruz de Ignacio de la Llave,15,015 Angel R. Cabada,Total,1196,1143,53,1039
30 Veracruz de Ignacio de la Llave,15,015 Angel R. Cabada,Total,1465,1414,51,1080
30 Veracruz de Ignacio de la Llave,15,015 Angel R. Cabada,Total,1328,1283,45,989
30 Veracruz de Ignacio de la Llave,15,015 Angel R. Cabada,Total,1189,1147,42,868
30 Veracruz de Ignacio de la Llave,15,015 Angel R. Cabada,Total,935,904,31,892
30 Veracruz de Ignacio de la Llave,15,015 Angel R. Cabada,Total,789,757,32,793
30 Veracruz de Ignacio de la Llave,15,015 Angel R. Cabada,Total,533,512,21,772
30 Veracruz de Ignacio de la Llave,15,015 Angel R. Cabada,Total,340,327,13,647
30 Veracruz de Ignacio de la Llave,15,015 Angel R. Cabada,Total,269,253,16,643
30 Veracruz de Ignacio de la Llave,15,015 Angel R. Cabada,Total,101,96,5,466
30 Veracruz de Ignacio de la Llave,15,015 Angel R. Cabada,Total,43,42,1,307
30 Veracruz de Ignacio de la Llave,15,015 Angel R. Cabada,Total,28,25,3,336
30 Veracruz de Ignacio de la Llave,15,015 Angel R. Cabada,Hombres,9360,8870,490,3407
30 Veracruz de Ignacio de la Llave,15,015 Angel R. Cabada,Hombres,66,53,13,873
30 Veracruz de Ignacio de la Llave,15,015 Angel R. Cabada,Hombres,644,586,58,970
30 Veracruz de Ignacio de la Llave,15,015 Angel R. Cabada,Hombres,1030,951,79,179
30 Veracruz de Ignacio de la Llave,15,015 Angel R. Cabada,Hombres,879,837,42,43
30 Veracruz de Ignacio de la Llave,15,015 Angel R. Cabada,Hombres,947,899,48,42
30 Veracruz de Ignacio de la Llave,15,015 Angel R. Cabada,Hombres,1161,1114,47,51
30 Veracruz de Ignacio de la Llave,15,015 Angel R. Cabada,Hombres,1063,1020,43,47
30 Veracruz de Ignacio de la Llave,15,015 Angel R. Cabada,Hombres,962,921,41,56
30 Veracruz de Ignacio de la Llave,15,015 Angel R. Cabada,Hombres,755,725,30,69
30 Veracruz de Ignacio de la Llave,15,015 Angel R. Cabada,Hombres,677,646,31,72
30 Veracruz de Ignacio de la Llave,15,015 Angel R. Cabada,Hombres,463,443,20,176
30 Veracruz de Ignacio de la Llave,15,015 Angel R. Cabada,Hombres,308,295,13,182
30 Veracruz de Ignacio de la Llave,15,015 Angel R. Cabada,Hombres,245,229,16,212
30 Veracruz de Ignacio de la Llave,15,015 Angel R. Cabada,Hombres,95,90,5,179
30 Veracruz de Ignacio de la Llave,15,015 Angel R. Cabada,Hombres,40,39,1,118
30 Veracruz de Ignacio de la Llave,15,015 Angel R. Cabada,Hombres,25,22,3,138
30 Veracruz de Ignacio de la Llave,15,015 Angel R. Cabada,Mujeres,2139,2089,50,11729
30 Veracruz de Ignacio de la Llave,15,015 Angel R. Cabada,Mujeres,11,11,0,951
30 Veracruz de Ignacio de la Llave,15,015 Angel R. Cabada,Mujeres,111,102,9,1422
30 Veracruz de Ignacio de la Llave,15,015 Angel R. Cabada,Mujeres,299,281,18,953
30 Veracruz de Ignacio de la Llave,15,015 Angel R. Cabada,Mujeres,243,235,8,913
30 Veracruz de Ignacio de la Llave,15,015 Angel R. Cabada,Mujeres,249,244,5,997
30 Veracruz de Ignacio de la Llave,15,015 Angel R. Cabada,Mujeres,304,300,4,1029
30 Veracruz de Ignacio de la Llave,15,015 Angel R. Cabada,Mujeres,265,263,2,942
30 Veracruz de Ignacio de la Llave,15,015 Angel R. Cabada,Mujeres,227,226,1,812
30 Veracruz de Ignacio de la Llave,15,015 Angel R. Cabada,Mujeres,180,179,1,823
30 Veracruz de Ignacio de la Llave,15,015 Angel R. Cabada,Mujeres,112,111,1,721
30 Veracruz de Ignacio de la Llave,15,015 Angel R. Cabada,Mujeres,70,69,1,596
30 Veracruz de Ignacio de la Llave,15,015 Angel R. Cabada,Mujeres,32,32,0,465
30 Veracruz de Ignacio de la Llave,15,015 Angel R. Cabada,Mujeres,24,24,0,431
30 Veracruz de Ignacio de la Llave,15,015 Angel R. Cabada,Mujeres,6,6,0,287
30 Veracruz de Ignacio de la Llave,15,015 Angel R. Cabada,Mujeres,3,3,0,189
30 Veracruz de Ignacio de la Llave,15,015 Angel R. Cabada,Mujeres,3,3,0,198
30 Veracruz de Ignacio de la Llave,17,017 Apazapan,Total,1318,1280,38,1889
30 Veracruz de Ignacio de la Llave,17,017 Apazapan,Total,4,4,0,222
30 Veracruz de Ignacio de la Llave,17,017 Apazapan,Total,85,78,7,296
30 Veracruz de Ignacio de la Llave,17,017 Apazapan,Total,154,144,10,157
30 Veracruz de Ignacio de la Llave,17,017 Apazapan,Total,127,122,5,108
30 Veracruz de Ignacio de la Llave,17,017 Apazapan,Total,153,149,4,133
30 Veracruz de Ignacio de la Llave,17,017 Apazapan,Total,155,152,3,119
30 Veracruz de Ignacio de la Llave,17,017 Apazapan,Total,141,139,2,121
30 Veracruz de Ignacio de la Llave,17,017 Apazapan,Total,127,124,3,105
30 Veracruz de Ignacio de la Llave,17,017 Apazapan,Total,108,107,1,87
30 Veracruz de Ignacio de la Llave,17,017 Apazapan,Total,95,93,2,91
30 Veracruz de Ignacio de la Llave,17,017 Apazapan,Total,57,56,1,94
30 Veracruz de Ignacio de la Llave,17,017 Apazapan,Total,34,34,0,93
30 Veracruz de Ignacio de la Llave,17,017 Apazapan,Total,36,36,0,92
30 Veracruz de Ignacio de la Llave,17,017 Apazapan,Total,25,25,0,77
30 Veracruz de Ignacio de la Llave,17,017 Apazapan,Total,13,13,0,46
30 Veracruz de Ignacio de la Llave,17,017 Apazapan,Total,4,4,0,48
30 Veracruz de Ignacio de la Llave,17,017 Apazapan,Hombres,992,964,28,581
30 Veracruz de Ignacio de la Llave,17,017 Apazapan,Hombres,2,2,0,115
30 Veracruz de Ignacio de la Llave,17,017 Apazapan,Hombres,60,54,6,145
30 Veracruz de Ignacio de la Llave,17,017 Apazapan,Hombres,102,96,6,44
30 Veracruz de Ignacio de la Llave,17,017 Apazapan,Hombres,100,97,3,24
30 Veracruz de Ignacio de la Llave,17,017 Apazapan,Hombres,112,110,2,12
30 Veracruz de Ignacio de la Llave,17,017 Apazapan,Hombres,114,112,2,14
30 Veracruz de Ignacio de la Llave,17,017 Apazapan,Hombres,108,106,2,18
30 Veracruz de Ignacio de la Llave,17,017 Apazapan,Hombres,90,87,3,22
30 Veracruz de Ignacio de la Llave,17,017 Apazapan,Hombres,85,84,1,16
30 Veracruz de Ignacio de la Llave,17,017 Apazapan,Hombres,81,79,2,27
30 Veracruz de Ignacio de la Llave,17,017 Apazapan,Hombres,47,46,1,16
30 Veracruz de Ignacio de la Llave,17,017 Apazapan,Hombres,26,26,0,25
30 Veracruz de Ignacio de la Llave,17,017 Apazapan,Hombres,28,28,0,28
30 Veracruz de Ignacio de la Llave,17,017 Apazapan,Hombres,23,23,0,36
30 Veracruz de Ignacio de la Llave,17,017 Apazapan,Hombres,11,11,0,19
30 Veracruz de Ignacio de la Llave,17,017 Apazapan,Hombres,3,3,0,20
30 Veracruz de Ignacio de la Llave,17,017 Apazapan,Mujeres,326,316,10,1308
30 Veracruz de Ignacio de la Llave,17,017 Apazapan,Mujeres,2,2,0,107
30 Veracruz de Ignacio de la Llave,17,017 Apazapan,Mujeres,25,24,1,151
30 Veracruz de Ignacio de la Llave,17,017 Apazapan,Mujeres,52,48,4,113
30 Veracruz de Ignacio de la Llave,17,017 Apazapan,Mujeres,27,25,2,84
30 Veracruz de Ignacio de la Llave,17,017 Apazapan,Mujeres,41,39,2,121
30 Veracruz de Ignacio de la Llave,17,017 Apazapan,Mujeres,41,40,1,105
30 Veracruz de Ignacio de la Llave,17,017 Apazapan,Mujeres,33,33,0,103
30 Veracruz de Ignacio de la Llave,17,017 Apazapan,Mujeres,37,37,0,83
30 Veracruz de Ignacio de la Llave,17,017 Apazapan,Mujeres,23,23,0,71
30 Veracruz de Ignacio de la Llave,17,017 Apazapan,Mujeres,14,14,0,64
30 Veracruz de Ignacio de la Llave,17,017 Apazapan,Mujeres,10,10,0,78
30 Veracruz de Ignacio de la Llave,17,017 Apazapan,Mujeres,8,8,0,68
30 Veracruz de Ignacio de la Llave,17,017 Apazapan,Mujeres,8,8,0,64
30 Veracruz de Ignacio de la Llave,17,017 Apazapan,Mujeres,2,2,0,41
30 Veracruz de Ignacio de la Llave,17,017 Apazapan,Mujeres,2,2,0,27
30 Veracruz de Ignacio de la Llave,17,017 Apazapan,Mujeres,1,1,0,28
30 Veracruz de Ignacio de la Llave,18,018 Aquila,Total,700,692,8,577
30 Veracruz de Ignacio de la Llave,18,018 Aquila,Total,23,23,0,101
30 Veracruz de Ignacio de la Llave,18,018 Aquila,Total,96,93,3,112
30 Veracruz de Ignacio de la Llave,18,018 Aquila,Total,100,99,1,63
30 Veracruz de Ignacio de la Llave,18,018 Aquila,Total,77,75,2,57
30 Veracruz de Ignacio de la Llave,18,018 Aquila,Total,75,74,1,43
30 Veracruz de Ignacio de la Llave,18,018 Aquila,Total,68,68,0,42
30 Veracruz de Ignacio de la Llave,18,018 Aquila,Total,60,60,0,36
30 Veracruz de Ignacio de la Llave,18,018 Aquila,Total,50,49,1,19
30 Veracruz de Ignacio de la Llave,18,018 Aquila,Total,26,26,0,17
30 Veracruz de Ignacio de la Llave,18,018 Aquila,Total,35,35,0,12
30 Veracruz de Ignacio de la Llave,18,018 Aquila,Total,24,24,0,12
30 Veracruz de Ignacio de la Llave,18,018 Aquila,Total,16,16,0,17
30 Veracruz de Ignacio de la Llave,18,018 Aquila,Total,27,27,0,9
30 Veracruz de Ignacio de la Llave,18,018 Aquila,Total,15,15,0,9
30 Veracruz de Ignacio de la Llave,18,018 Aquila,Total,3,3,0,15
30 Veracruz de Ignacio de la Llave,18,018 Aquila,Total,5,5,0,13
30 Veracruz de Ignacio de la Llave,18,018 Aquila,Hombres,488,482,6,124
30 Veracruz de Ignacio de la Llave,18,018 Aquila,Hombres,19,19,0,44
30 Veracruz de Ignacio de la Llave,18,018 Aquila,Hombres,74,73,1,34
30 Veracruz de Ignacio de la Llave,18,018 Aquila,Hombres,69,68,1,4
30 Veracruz de Ignacio de la Llave,18,018 Aquila,Hombres,61,59,2,3
30 Veracruz de Ignacio de la Llave,18,018 Aquila,Hombres,54,53,1,4
30 Veracruz de Ignacio de la Llave,18,018 Aquila,Hombres,45,45,0,4
30 Veracruz de Ignacio de la Llave,18,018 Aquila,Hombres,41,41,0,6
30 Veracruz de Ignacio de la Llave,18,018 Aquila,Hombres,29,28,1,2
30 Veracruz de Ignacio de la Llave,18,018 Aquila,Hombres,16,16,0,2
30 Veracruz de Ignacio de la Llave,18,018 Aquila,Hombres,21,21,0,0
30 Veracruz de Ignacio de la Llave,18,018 Aquila,Hombres,18,18,0,1
30 Veracruz de Ignacio de la Llave,18,018 Aquila,Hombres,11,11,0,4
30 Veracruz de Ignacio de la Llave,18,018 Aquila,Hombres,15,15,0,3
30 Veracruz de Ignacio de la Llave,18,018 Aquila,Hombres,11,11,0,2
30 Veracruz de Ignacio de la Llave,18,018 Aquila,Hombres,2,2,0,3
30 Veracruz de Ignacio de la Llave,18,018 Aquila,Hombres,2,2,0,8
30 Veracruz de Ignacio de la Llave,18,018 Aquila,Mujeres,212,210,2,453
30 Veracruz de Ignacio de la Llave,18,018 Aquila,Mujeres,4,4,0,57
30 Veracruz de Ignacio de la Llave,18,018 Aquila,Mujeres,22,20,2,78
30 Veracruz de Ignacio de la Llave,18,018 Aquila,Mujeres,31,31,0,59
30 Veracruz de Ignacio de la Llave,18,018 Aquila,Mujeres,16,16,0,54
30 Veracruz de Ignacio de la Llave,18,018 Aquila,Mujeres,21,21,0,39
30 Veracruz de Ignacio de la Llave,18,018 Aquila,Mujeres,23,23,0,38
30 Veracruz de Ignacio de la Llave,18,018 Aquila,Mujeres,19,19,0,30
30 Veracruz de Ignacio de la Llave,18,018 Aquila,Mujeres,21,21,0,17
30 Veracruz de Ignacio de la Llave,18,018 Aquila,Mujeres,10,10,0,15
30 Veracruz de Ignacio de la Llave,18,018 Aquila,Mujeres,14,14,0,12
30 Veracruz de Ignacio de la Llave,18,018 Aquila,Mujeres,6,6,0,11
30 Veracruz de Ignacio de la Llave,18,018 Aquila,Mujeres,5,5,0,13
30 Veracruz de Ignacio de la Llave,18,018 Aquila,Mujeres,12,12,0,6
30 Veracruz de Ignacio de la Llave,18,018 Aquila,Mujeres,4,4,0,7
30 Veracruz de Ignacio de la Llave,18,018 Aquila,Mujeres,1,1,0,12
30 Veracruz de Ignacio de la Llave,18,018 Aquila,Mujeres,3,3,0,5
30 Veracruz de Ignacio de la Llave,19,019 Astacinga,Total,1134,1119,15,2941
30 Veracruz de Ignacio de la Llave,19,019 Astacinga,Total,9,9,0,542
30 Veracruz de Ignacio de la Llave,19,019 Astacinga,Total,170,165,5,558
30 Veracruz de Ignacio de la Llave,19,019 Astacinga,Total,162,160,2,307
30 Veracruz de Ignacio de la Llave,19,019 Astacinga,Total,122,121,1,247
30 Veracruz de Ignacio de la Llave,19,019 Astacinga,Total,114,112,2,239
30 Veracruz de Ignacio de la Llave,19,019 Astacinga,Total,124,124,0,221
30 Veracruz de Ignacio de la Llave,19,019 Astacinga,Total,93,93,0,179
30 Veracruz de Ignacio de la Llave,19,019 Astacinga,Total,95,93,2,150
30 Veracruz de Ignacio de la Llave,19,019 Astacinga,Total,56,56,0,114
30 Veracruz de Ignacio de la Llave,19,019 Astacinga,Total,64,63,1,93
30 Veracruz de Ignacio de la Llave,19,019 Astacinga,Total,41,41,0,67
30 Veracruz de Ignacio de la Llave,19,019 Astacinga,Total,44,44,0,62
30 Veracruz de Ignacio de la Llave,19,019 Astacinga,Total,24,23,1,69
30 Veracruz de Ignacio de la Llave,19,019 Astacinga,Total,10,9,1,37
30 Veracruz de Ignacio de la Llave,19,019 Astacinga,Total,3,3,0,25
30 Veracruz de Ignacio de la Llave,19,019 Astacinga,Total,3,3,0,31
30 Veracruz de Ignacio de la Llave,19,019 Astacinga,Hombres,923,908,15,879
30 Veracruz de Ignacio de la Llave,19,019 Astacinga,Hombres,6,6,0,262
30 Veracruz de Ignacio de la Llave,19,019 Astacinga,Hombres,132,127,5,239
30 Veracruz de Ignacio de la Llave,19,019 Astacinga,Hombres,125,123,2,54
30 Veracruz de Ignacio de la Llave,19,019 Astacinga,Hombres,92,91,1,46
30 Veracruz de Ignacio de la Llave,19,019 Astacinga,Hombres,89,87,2,56
30 Veracruz de Ignacio de la Llave,19,019 Astacinga,Hombres,107,107,0,44
30 Veracruz de Ignacio de la Llave,19,019 Astacinga,Hombres,73,73,0,27
30 Veracruz de Ignacio de la Llave,19,019 Astacinga,Hombres,81,79,2,37
30 Veracruz de Ignacio de la Llave,19,019 Astacinga,Hombres,50,50,0,22
30 Veracruz de Ignacio de la Llave,19,019 Astacinga,Hombres,57,56,1,14
30 Veracruz de Ignacio de la Llave,19,019 Astacinga,Hombres,36,36,0,16
30 Veracruz de Ignacio de la Llave,19,019 Astacinga,Hombres,39,39,0,16
30 Veracruz de Ignacio de la Llave,19,019 Astacinga,Hombres,21,20,1,19
30 Veracruz de Ignacio de la Llave,19,019 Astacinga,Hombres,10,9,1,14
30 Veracruz de Ignacio de la Llave,19,019 Astacinga,Hombres,3,3,0,6
30 Veracruz de Ignacio de la Llave,19,019 Astacinga,Hombres,2,2,0,7
30 Veracruz de Ignacio de la Llave,19,019 Astacinga,Mujeres,211,211,0,2062
30 Veracruz de Ignacio de la Llave,19,019 Astacinga,Mujeres,3,3,0,280
30 Veracruz de Ignacio de la Llave,19,019 Astacinga,Mujeres,38,38,0,319
30 Veracruz de Ignacio de la Llave,19,019 Astacinga,Mujeres,37,37,0,253
30 Veracruz de Ignacio de la Llave,19,019 Astacinga,Mujeres,30,30,0,201
30 Veracruz de Ignacio de la Llave,19,019 Astacinga,Mujeres,25,25,0,183
30 Veracruz de Ignacio de la Llave,19,019 Astacinga,Mujeres,17,17,0,177
30 Veracruz de Ignacio de la Llave,19,019 Astacinga,Mujeres,20,20,0,152
30 Veracruz de Ignacio de la Llave,19,019 Astacinga,Mujeres,14,14,0,113
30 Veracruz de Ignacio de la Llave,19,019 Astacinga,Mujeres,6,6,0,92
30 Veracruz de Ignacio de la Llave,19,019 Astacinga,Mujeres,7,7,0,79
30 Veracruz de Ignacio de la Llave,19,019 Astacinga,Mujeres,5,5,0,51
30 Veracruz de Ignacio de la Llave,19,019 Astacinga,Mujeres,5,5,0,46
30 Veracruz de Ignacio de la Llave,19,019 Astacinga,Mujeres,3,3,0,50
30 Veracruz de Ignacio de la Llave,19,019 Astacinga,Mujeres,0,0,0,23
30 Veracruz de Ignacio de la Llave,19,019 Astacinga,Mujeres,0,0,0,19
30 Veracruz de Ignacio de la Llave,19,019 Astacinga,Mujeres,1,1,0,24
30 Veracruz de Ignacio de la Llave,20,020 Atlahuilco,Total,2824,2649,175,3871
30 Veracruz de Ignacio de la Llave,20,020 Atlahuilco,Total,64,51,13,617
30 Veracruz de Ignacio de la Llave,20,020 Atlahuilco,Total,379,343,36,683
30 Veracruz de Ignacio de la Llave,20,020 Atlahuilco,Total,440,412,28,466
30 Veracruz de Ignacio de la Llave,20,020 Atlahuilco,Total,383,366,17,403
30 Veracruz de Ignacio de la Llave,20,020 Atlahuilco,Total,358,345,13,337
30 Veracruz de Ignacio de la Llave,20,020 Atlahuilco,Total,279,265,14,266
30 Veracruz de Ignacio de la Llave,20,020 Atlahuilco,Total,224,214,10,217
30 Veracruz de Ignacio de la Llave,20,020 Atlahuilco,Total,191,188,3,165
30 Veracruz de Ignacio de la Llave,20,020 Atlahuilco,Total,155,143,12,148
30 Veracruz de Ignacio de la Llave,20,020 Atlahuilco,Total,118,113,5,141
30 Veracruz de Ignacio de la Llave,20,020 Atlahuilco,Total,89,84,5,113
30 Veracruz de Ignacio de la Llave,20,020 Atlahuilco,Total,60,55,5,77
30 Veracruz de Ignacio de la Llave,20,020 Atlahuilco,Total,45,39,6,101
30 Veracruz de Ignacio de la Llave,20,020 Atlahuilco,Total,21,17,4,51
30 Veracruz de Ignacio de la Llave,20,020 Atlahuilco,Total,10,8,2,44
30 Veracruz de Ignacio de la Llave,20,020 Atlahuilco,Total,8,6,2,42
30 Veracruz de Ignacio de la Llave,20,020 Atlahuilco,Hombres,2458,2300,158,704
30 Veracruz de Ignacio de la Llave,20,020 Atlahuilco,Hombres,59,47,12,274
30 Veracruz de Ignacio de la Llave,20,020 Atlahuilco,Hombres,340,311,29,166
30 Veracruz de Ignacio de la Llave,20,020 Atlahuilco,Hombres,372,348,24,47
30 Veracruz de Ignacio de la Llave,20,020 Atlahuilco,Hombres,332,316,16,25
30 Veracruz de Ignacio de la Llave,20,020 Atlahuilco,Hombres,320,307,13,21
30 Veracruz de Ignacio de la Llave,20,020 Atlahuilco,Hombres,244,230,14,20
30 Veracruz de Ignacio de la Llave,20,020 Atlahuilco,Hombres,202,194,8,18
30 Veracruz de Ignacio de la Llave,20,020 Atlahuilco,Hombres,156,154,2,9
30 Veracruz de Ignacio de la Llave,20,020 Atlahuilco,Hombres,130,118,12,20
30 Veracruz de Ignacio de la Llave,20,020 Atlahuilco,Hombres,100,95,5,13
30 Veracruz de Ignacio de la Llave,20,020 Atlahuilco,Hombres,76,71,5,15
30 Veracruz de Ignacio de la Llave,20,020 Atlahuilco,Hombres,56,51,5,13
30 Veracruz de Ignacio de la Llave,20,020 Atlahuilco,Hombres,36,31,5,24
30 Veracruz de Ignacio de la Llave,20,020 Atlahuilco,Hombres,20,16,4,12
30 Veracruz de Ignacio de la Llave,20,020 Atlahuilco,Hombres,8,6,2,14
30 Veracruz de Ignacio de la Llave,20,020 Atlahuilco,Hombres,7,5,2,13
30 Veracruz de Ignacio de la Llave,20,020 Atlahuilco,Mujeres,366,349,17,3167
30 Veracruz de Ignacio de la Llave,20,020 Atlahuilco,Mujeres,5,4,1,343
30 Veracruz de Ignacio de la Llave,20,020 Atlahuilco,Mujeres,39,32,7,517
30 Veracruz de Ignacio de la Llave,20,020 Atlahuilco,Mujeres,68,64,4,419
30 Veracruz de Ignacio de la Llave,20,020 Atlahuilco,Mujeres,51,50,1,378
30 Veracruz de Ignacio de la Llave,20,020 Atlahuilco,Mujeres,38,38,0,316
30 Veracruz de Ignacio de la Llave,20,020 Atlahuilco,Mujeres,35,35,0,246
30 Veracruz de Ignacio de la Llave,20,020 Atlahuilco,Mujeres,22,20,2,199
30 Veracruz de Ignacio de la Llave,20,020 Atlahuilco,Mujeres,35,34,1,156
30 Veracruz de Ignacio de la Llave,20,020 Atlahuilco,Mujeres,25,25,0,128
30 Veracruz de Ignacio de la Llave,20,020 Atlahuilco,Mujeres,18,18,0,128
30 Veracruz de Ignacio de la Llave,20,020 Atlahuilco,Mujeres,13,13,0,98
30 Veracruz de Ignacio de la Llave,20,020 Atlahuilco,Mujeres,4,4,0,64
30 Veracruz de Ignacio de la Llave,20,020 Atlahuilco,Mujeres,9,8,1,77
30 Veracruz de Ignacio de la Llave,20,020 Atlahuilco,Mujeres,1,1,0,39
30 Veracruz de Ignacio de la Llave,20,020 Atlahuilco,Mujeres,2,2,0,30
30 Veracruz de Ignacio de la Llave,20,020 Atlahuilco,Mujeres,1,1,0,29
30 Veracruz de Ignacio de la Llave,21,021 Atoyac,Total,8240,7726,514,9752
30 Veracruz de Ignacio de la Llave,21,021 Atoyac,Total,79,67,12,1168
30 Veracruz de Ignacio de la Llave,21,021 Atoyac,Total,610,536,74,1578
30 Veracruz de Ignacio de la Llave,21,021 Atoyac,Total,1035,929,106,934
30 Veracruz de Ignacio de la Llave,21,021 Atoyac,Total,1000,921,79,682
30 Veracruz de Ignacio de la Llave,21,021 Atoyac,Total,994,933,61,641
30 Veracruz de Ignacio de la Llave,21,021 Atoyac,Total,949,904,45,606
30 Veracruz de Ignacio de la Llave,21,021 Atoyac,Total,849,813,36,600
30 Veracruz de Ignacio de la Llave,21,021 Atoyac,Total,775,741,34,497
30 Veracruz de Ignacio de la Llave,21,021 Atoyac,Total,633,611,22,526
30 Veracruz de Ignacio de la Llave,21,021 Atoyac,Total,565,543,22,462
30 Veracruz de Ignacio de la Llave,21,021 Atoyac,Total,306,296,10,501
30 Veracruz de Ignacio de la Llave,21,021 Atoyac,Total,188,182,6,431
30 Veracruz de Ignacio de la Llave,21,021 Atoyac,Total,135,129,6,441
30 Veracruz de Ignacio de la Llave,21,021 Atoyac,Total,56,56,0,316
30 Veracruz de Ignacio de la Llave,21,021 Atoyac,Total,42,41,1,213
30 Veracruz de Ignacio de la Llave,21,021 Atoyac,Total,24,24,0,156
30 Veracruz de Ignacio de la Llave,21,021 Atoyac,Hombres,6213,5821,392,2325
30 Veracruz de Ignacio de la Llave,21,021 Atoyac,Hombres,72,61,11,554
30 Veracruz de Ignacio de la Llave,21,021 Atoyac,Hombres,485,426,59,594
30 Veracruz de Ignacio de la Llave,21,021 Atoyac,Hombres,729,665,64,215
30 Veracruz de Ignacio de la Llave,21,021 Atoyac,Hombres,731,670,61,60
30 Veracruz de Ignacio de la Llave,21,021 Atoyac,Hombres,698,658,40,32
30 Veracruz de Ignacio de la Llave,21,021 Atoyac,Hombres,696,660,36,24
30 Veracruz de Ignacio de la Llave,21,021 Atoyac,Hombres,616,587,29,29
30 Veracruz de Ignacio de la Llave,21,021 Atoyac,Hombres,574,544,30,55
30 Veracruz de Ignacio de la Llave,21,021 Atoyac,Hombres,498,476,22,39
30 Veracruz de Ignacio de la Llave,21,021 Atoyac,Hombres,483,464,19,52
30 Veracruz de Ignacio de la Llave,21,021 Atoyac,Hombres,257,247,10,137
30 Veracruz de Ignacio de la Llave,21,021 Atoyac,Hombres,153,148,5,129
30 Veracruz de Ignacio de la Llave,21,021 Atoyac,Hombres,115,110,5,163
30 Veracruz de Ignacio de la Llave,21,021 Atoyac,Hombres,47,47,0,110
30 Veracruz de Ignacio de la Llave,21,021 Atoyac,Hombres,40,39,1,72
30 Veracruz de Ignacio de la Llave,21,021 Atoyac,Hombres,19,19,0,60
30 Veracruz de Ignacio de la Llave,21,021 Atoyac,Mujeres,2027,1905,122,7427
30 Veracruz de Ignacio de la Llave,21,021 Atoyac,Mujeres,7,6,1,614
30 Veracruz de Ignacio de la Llave,21,021 Atoyac,Mujeres,125,110,15,984
30 Veracruz de Ignacio de la Llave,21,021 Atoyac,Mujeres,306,264,42,719
30 Veracruz de Ignacio de la Llave,21,021 Atoyac,Mujeres,269,251,18,622
30 Veracruz de Ignacio de la Llave,21,021 Atoyac,Mujeres,296,275,21,609
30 Veracruz de Ignacio de la Llave,21,021 Atoyac,Mujeres,253,244,9,582
30 Veracruz de Ignacio de la Llave,21,021 Atoyac,Mujeres,233,226,7,571
30 Veracruz de Ignacio de la Llave,21,021 Atoyac,Mujeres,201,197,4,442
30 Veracruz de Ignacio de la Llave,21,021 Atoyac,Mujeres,135,135,0,487
30 Veracruz de Ignacio de la Llave,21,021 Atoyac,Mujeres,82,79,3,410
30 Veracruz de Ignacio de la Llave,21,021 Atoyac,Mujeres,49,49,0,364
30 Veracruz de Ignacio de la Llave,21,021 Atoyac,Mujeres,35,34,1,302
30 Veracruz de Ignacio de la Llave,21,021 Atoyac,Mujeres,20,19,1,278
30 Veracruz de Ignacio de la Llave,21,021 Atoyac,Mujeres,9,9,0,206
30 Veracruz de Ignacio de la Llave,21,021 Atoyac,Mujeres,2,2,0,141
30 Veracruz de Ignacio de la Llave,21,021 Atoyac,Mujeres,5,5,0,96
30 Veracruz de Ignacio de la Llave,22,022 Atzacan,Total,7099,6860,239,7229
30 Veracruz de Ignacio de la Llave,22,022 Atzacan,Total,125,118,7,1152
30 Veracruz de Ignacio de la Llave,22,022 Atzacan,Total,666,609,57,1392
30 Veracruz de Ignacio de la Llave,22,022 Atzacan,Total,1027,981,46,806
30 Veracruz de Ignacio de la Llave,22,022 Atzacan,Total,897,879,18,630
30 Veracruz de Ignacio de la Llave,22,022 Atzacan,Total,893,857,36,548
30 Veracruz de Ignacio de la Llave,22,022 Atzacan,Total,841,821,20,476
30 Veracruz de Ignacio de la Llave,22,022 Atzacan,Total,678,662,16,331
30 Veracruz de Ignacio de la Llave,22,022 Atzacan,Total,493,481,12,321
30 Veracruz de Ignacio de la Llave,22,022 Atzacan,Total,411,400,11,286
30 Veracruz de Ignacio de la Llave,22,022 Atzacan,Total,373,365,8,250
30 Veracruz de Ignacio de la Llave,22,022 Atzacan,Total,247,245,2,250
30 Veracruz de Ignacio de la Llave,22,022 Atzacan,Total,181,179,2,227
30 Veracruz de Ignacio de la Llave,22,022 Atzacan,Total,140,139,1,207
30 Veracruz de Ignacio de la Llave,22,022 Atzacan,Total,60,59,1,144
30 Veracruz de Ignacio de la Llave,22,022 Atzacan,Total,38,37,1,103
30 Veracruz de Ignacio de la Llave,22,022 Atzacan,Total,29,28,1,106
30 Veracruz de Ignacio de la Llave,22,022 Atzacan,Hombres,5378,5161,217,1584
30 Veracruz de Ignacio de la Llave,22,022 Atzacan,Hombres,100,95,5,537
30 Veracruz de Ignacio de la Llave,22,022 Atzacan,Hombres,537,484,53,488
30 Veracruz de Ignacio de la Llave,22,022 Atzacan,Hombres,793,757,36,112
30 Veracruz de Ignacio de la Llave,22,022 Atzacan,Hombres,666,651,15,32
30 Veracruz de Ignacio de la Llave,22,022 Atzacan,Hombres,663,628,35,21
30 Veracruz de Ignacio de la Llave,22,022 Atzacan,Hombres,623,604,19,18
30 Veracruz de Ignacio de la Llave,22,022 Atzacan,Hombres,497,481,16,13
30 Veracruz de Ignacio de la Llave,22,022 Atzacan,Hombres,361,349,12,20
30 Veracruz de Ignacio de la Llave,22,022 Atzacan,Hombres,302,292,10,16
30 Veracruz de Ignacio de la Llave,22,022 Atzacan,Hombres,291,283,8,24
30 Veracruz de Ignacio de la Llave,22,022 Atzacan,Hombres,190,188,2,44
30 Veracruz de Ignacio de la Llave,22,022 Atzacan,Hombres,136,134,2,55
30 Veracruz de Ignacio de la Llave,22,022 Atzacan,Hombres,113,112,1,55
30 Veracruz de Ignacio de la Llave,22,022 Atzacan,Hombres,49,48,1,64
30 Veracruz de Ignacio de la Llave,22,022 Atzacan,Hombres,31,30,1,37
30 Veracruz de Ignacio de la Llave,22,022 Atzacan,Hombres,26,25,1,48
30 Veracruz de Ignacio de la Llave,22,022 Atzacan,Mujeres,1721,1699,22,5645
30 Veracruz de Ignacio de la Llave,22,022 Atzacan,Mujeres,25,23,2,615
30 Veracruz de Ignacio de la Llave,22,022 Atzacan,Mujeres,129,125,4,904
30 Veracruz de Ignacio de la Llave,22,022 Atzacan,Mujeres,234,224,10,694
30 Veracruz de Ignacio de la Llave,22,022 Atzacan,Mujeres,231,228,3,598
30 Veracruz de Ignacio de la Llave,22,022 Atzacan,Mujeres,230,229,1,527
30 Veracruz de Ignacio de la Llave,22,022 Atzacan,Mujeres,218,217,1,458
30 Veracruz de Ignacio de la Llave,22,022 Atzacan,Mujeres,181,181,0,318
30 Veracruz de Ignacio de la Llave,22,022 Atzacan,Mujeres,132,132,0,301
30 Veracruz de Ignacio de la Llave,22,022 Atzacan,Mujeres,109,108,1,270
30 Veracruz de Ignacio de la Llave,22,022 Atzacan,Mujeres,82,82,0,226
30 Veracruz de Ignacio de la Llave,22,022 Atzacan,Mujeres,57,57,0,206
30 Veracruz de Ignacio de la Llave,22,022 Atzacan,Mujeres,45,45,0,172
30 Veracruz de Ignacio de la Llave,22,022 Atzacan,Mujeres,27,27,0,152
30 Veracruz de Ignacio de la Llave,22,022 Atzacan,Mujeres,11,11,0,80
30 Veracruz de Ignacio de la Llave,22,022 Atzacan,Mujeres,7,7,0,66
30 Veracruz de Ignacio de la Llave,22,022 Atzacan,Mujeres,3,3,0,58
30 Veracruz de Ignacio de la Llave,23,023 Atzalan,Total,16201,15840,361,19146
30 Veracruz de Ignacio de la Llave,23,023 Atzalan,Total,292,282,10,3229
30 Veracruz de Ignacio de la Llave,23,023 Atzalan,Total,1782,1739,43,3533
30 Veracruz de Ignacio de la Llave,23,023 Atzalan,Total,2099,2050,49,1732
30 Veracruz de Ignacio de la Llave,23,023 Atzalan,Total,1688,1656,32,1496
30 Veracruz de Ignacio de la Llave,23,023 Atzalan,Total,1737,1702,35,1409
30 Veracruz de Ignacio de la Llave,23,023 Atzalan,Total,1693,1661,32,1309
30 Veracruz de Ignacio de la Llave,23,023 Atzalan,Total,1436,1407,29,1134
30 Veracruz de Ignacio de la Llave,23,023 Atzalan,Total,1229,1201,28,992
30 Veracruz de Ignacio de la Llave,23,023 Atzalan,Total,1037,1015,22,904
30 Veracruz de Ignacio de la Llave,23,023 Atzalan,Total,893,877,16,774
30 Veracruz de Ignacio de la Llave,23,023 Atzalan,Total,748,730,18,664
30 Veracruz de Ignacio de la Llave,23,023 Atzalan,Total,611,593,18,593
30 Veracruz de Ignacio de la Llave,23,023 Atzalan,Total,455,441,14,497
30 Veracruz de Ignacio de la Llave,23,023 Atzalan,Total,261,254,7,385
30 Veracruz de Ignacio de la Llave,23,023 Atzalan,Total,149,146,3,237
30 Veracruz de Ignacio de la Llave,23,023 Atzalan,Total,91,86,5,258
30 Veracruz de Ignacio de la Llave,23,023 Atzalan,Hombres,13978,13632,346,3548
30 Veracruz de Ignacio de la Llave,23,023 Atzalan,Hombres,264,254,10,1503
30 Veracruz de Ignacio de la Llave,23,023 Atzalan,Hombres,1493,1455,38,1200
30 Veracruz de Ignacio de la Llave,23,023 Atzalan,Hombres,1707,1665,42,164
30 Veracruz de Ignacio de la Llave,23,023 Atzalan,Hombres,1431,1400,31,49
30 Veracruz de Ignacio de la Llave,23,023 Atzalan,Hombres,1486,1451,35,48
30 Veracruz de Ignacio de la Llave,23,023 Atzalan,Hombres,1447,1415,32,36
30 Veracruz de Ignacio de la Llave,23,023 Atzalan,Hombres,1220,1191,29,33
30 Veracruz de Ignacio de la Llave,23,023 Atzalan,Hombres,1068,1040,28,34
30 Veracruz de Ignacio de la Llave,23,023 Atzalan,Hombres,913,891,22,39
30 Veracruz de Ignacio de la Llave,23,023 Atzalan,Hombres,801,785,16,48
30 Veracruz de Ignacio de la Llave,23,023 Atzalan,Hombres,676,658,18,42
30 Veracruz de Ignacio de la Llave,23,023 Atzalan,Hombres,568,551,17,56
30 Veracruz de Ignacio de la Llave,23,023 Atzalan,Hombres,431,418,13,64
30 Veracruz de Ignacio de la Llave,23,023 Atzalan,Hombres,248,241,7,75
30 Veracruz de Ignacio de la Llave,23,023 Atzalan,Hombres,137,134,3,65
30 Veracruz de Ignacio de la Llave,23,023 Atzalan,Hombres,88,83,5,92
30 Veracruz de Ignacio de la Llave,23,023 Atzalan,Mujeres,2223,2208,15,15598
30 Veracruz de Ignacio de la Llave,23,023 Atzalan,Mujeres,28,28,0,1726
30 Veracruz de Ignacio de la Llave,23,023 Atzalan,Mujeres,289,284,5,2333
30 Veracruz de Ignacio de la Llave,23,023 Atzalan,Mujeres,392,385,7,1568
30 Veracruz de Ignacio de la Llave,23,023 Atzalan,Mujeres,257,256,1,1447
30 Veracruz de Ignacio de la Llave,23,023 Atzalan,Mujeres,251,251,0,1361
30 Veracruz de Ignacio de la Llave,23,023 Atzalan,Mujeres,246,246,0,1273
30 Veracruz de Ignacio de la Llave,23,023 Atzalan,Mujeres,216,216,0,1101
30 Veracruz de Ignacio de la Llave,23,023 Atzalan,Mujeres,161,161,0,958
30 Veracruz de Ignacio de la Llave,23,023 Atzalan,Mujeres,124,124,0,865
30 Veracruz de Ignacio de la Llave,23,023 Atzalan,Mujeres,92,92,0,726
30 Veracruz de Ignacio de la Llave,23,023 Atzalan,Mujeres,72,72,0,622
30 Veracruz de Ignacio de la Llave,23,023 Atzalan,Mujeres,43,42,1,537
30 Veracruz de Ignacio de la Llave,23,023 Atzalan,Mujeres,24,23,1,433
30 Veracruz de Ignacio de la Llave,23,023 Atzalan,Mujeres,13,13,0,310
30 Veracruz de Ignacio de la Llave,23,023 Atzalan,Mujeres,12,12,0,172
30 Veracruz de Ignacio de la Llave,23,023 Atzalan,Mujeres,3,3,0,166
30 Veracruz de Ignacio de la Llave,25,025 Ayahualulco,Total,7657,7573,84,9523
30 Veracruz de Ignacio de la Llave,25,025 Ayahualulco,Total,158,155,3,1835
30 Veracruz de Ignacio de la Llave,25,025 Ayahualulco,Total,1225,1205,20,1640
30 Veracruz de Ignacio de la Llave,25,025 Ayahualulco,Total,1209,1201,8,909
30 Veracruz de Ignacio de la Llave,25,025 Ayahualulco,Total,921,912,9,750
30 Veracruz de Ignacio de la Llave,25,025 Ayahualulco,Total,786,776,10,744
30 Veracruz de Ignacio de la Llave,25,025 Ayahualulco,Total,754,742,12,666
30 Veracruz de Ignacio de la Llave,25,025 Ayahualulco,Total,588,583,5,582
30 Veracruz de Ignacio de la Llave,25,025 Ayahualulco,Total,541,531,10,504
30 Veracruz de Ignacio de la Llave,25,025 Ayahualulco,Total,407,403,4,404
30 Veracruz de Ignacio de la Llave,25,025 Ayahualulco,Total,351,351,0,345
30 Veracruz de Ignacio de la Llave,25,025 Ayahualulco,Total,258,256,2,300
30 Veracruz de Ignacio de la Llave,25,025 Ayahualulco,Total,201,201,0,278
30 Veracruz de Ignacio de la Llave,25,025 Ayahualulco,Total,154,153,1,227
30 Veracruz de Ignacio de la Llave,25,025 Ayahualulco,Total,47,47,0,130
30 Veracruz de Ignacio de la Llave,25,025 Ayahualulco,Total,26,26,0,93
30 Veracruz de Ignacio de la Llave,25,025 Ayahualulco,Total,31,31,0,116
30 Veracruz de Ignacio de la Llave,25,025 Ayahualulco,Hombres,6767,6690,77,1690
30 Veracruz de Ignacio de la Llave,25,025 Ayahualulco,Hombres,143,140,3,823
30 Veracruz de Ignacio de la Llave,25,025 Ayahualulco,Hombres,1013,997,16,461
30 Veracruz de Ignacio de la Llave,25,025 Ayahualulco,Hombres,996,989,7,50
30 Veracruz de Ignacio de la Llave,25,025 Ayahualulco,Hombres,815,806,9,15
30 Veracruz de Ignacio de la Llave,25,025 Ayahualulco,Hombres,710,701,9,16
30 Veracruz de Ignacio de la Llave,25,025 Ayahualulco,Hombres,689,678,11,18
30 Veracruz de Ignacio de la Llave,25,025 Ayahualulco,Hombres,538,533,5,11
30 Veracruz de Ignacio de la Llave,25,025 Ayahualulco,Hombres,500,490,10,23
30 Veracruz de Ignacio de la Llave,25,025 Ayahualulco,Hombres,372,368,4,16
30 Veracruz de Ignacio de la Llave,25,025 Ayahualulco,Hombres,325,325,0,35
30 Veracruz de Ignacio de la Llave,25,025 Ayahualulco,Hombres,240,238,2,31
30 Veracruz de Ignacio de la Llave,25,025 Ayahualulco,Hombres,190,190,0,41
30 Veracruz de Ignacio de la Llave,25,025 Ayahualulco,Hombres,143,142,1,58
30 Veracruz de Ignacio de la Llave,25,025 Ayahualulco,Hombres,44,44,0,33
30 Veracruz de Ignacio de la Llave,25,025 Ayahualulco,Hombres,22,22,0,22
30 Veracruz de Ignacio de la Llave,25,025 Ayahualulco,Hombres,27,27,0,37
30 Veracruz de Ignacio de la Llave,25,025 Ayahualulco,Mujeres,890,883,7,7833
30 Veracruz de Ignacio de la Llave,25,025 Ayahualulco,Mujeres,15,15,0,1012
30 Veracruz de Ignacio de la Llave,25,025 Ayahualulco,Mujeres,212,208,4,1179
30 Veracruz de Ignacio de la Llave,25,025 Ayahualulco,Mujeres,213,212,1,859
30 Veracruz de Ignacio de la Llave,25,025 Ayahualulco,Mujeres,106,106,0,735
30 Veracruz de Ignacio de la Llave,25,025 Ayahualulco,Mujeres,76,75,1,728
30 Veracruz de Ignacio de la Llave,25,025 Ayahualulco,Mujeres,65,64,1,648
30 Veracruz de Ignacio de la Llave,25,025 Ayahualulco,Mujeres,50,50,0,571
30 Veracruz de Ignacio de la Llave,25,025 Ayahualulco,Mujeres,41,41,0,481
30 Veracruz de Ignacio de la Llave,25,025 Ayahualulco,Mujeres,35,35,0,388
30 Veracruz de Ignacio de la Llave,25,025 Ayahualulco,Mujeres,26,26,0,310
30 Veracruz de Ignacio de la Llave,25,025 Ayahualulco,Mujeres,18,18,0,269
30 Veracruz de Ignacio de la Llave,25,025 Ayahualulco,Mujeres,11,11,0,237
30 Veracruz de Ignacio de la Llave,25,025 Ayahualulco,Mujeres,11,11,0,169
30 Veracruz de Ignacio de la Llave,25,025 Ayahualulco,Mujeres,3,3,0,97
30 Veracruz de Ignacio de la Llave,25,025 Ayahualulco,Mujeres,4,4,0,71
30 Veracruz de Ignacio de la Llave,25,025 Ayahualulco,Mujeres,4,4,0,79
30 Veracruz de Ignacio de la Llave,26,026 Banderilla,Total,9074,8714,360,7286
30 Veracruz de Ignacio de la Llave,26,026 Banderilla,Total,48,44,4,1150
30 Veracruz de Ignacio de la Llave,26,026 Banderilla,Total,601,550,51,1565
30 Veracruz de Ignacio de la Llave,26,026 Banderilla,Total,1088,1026,62,794
30 Veracruz de Ignacio de la Llave,26,026 Banderilla,Total,1236,1178,58,539
30 Veracruz de Ignacio de la Llave,26,026 Banderilla,Total,1293,1252,41,441
30 Veracruz de Ignacio de la Llave,26,026 Banderilla,Total,1203,1172,31,400
30 Veracruz de Ignacio de la Llave,26,026 Banderilla,Total,1028,994,34,374
30 Veracruz de Ignacio de la Llave,26,026 Banderilla,Total,882,855,27,311
30 Veracruz de Ignacio de la Llave,26,026 Banderilla,Total,692,672,20,307
30 Veracruz de Ignacio de la Llave,26,026 Banderilla,Total,445,426,19,295
30 Veracruz de Ignacio de la Llave,26,026 Banderilla,Total,262,254,8,272
30 Veracruz de Ignacio de la Llave,26,026 Banderilla,Total,153,152,1,232
30 Veracruz de Ignacio de la Llave,26,026 Banderilla,Total,76,73,3,243
30 Veracruz de Ignacio de la Llave,26,026 Banderilla,Total,30,29,1,153
30 Veracruz de Ignacio de la Llave,26,026 Banderilla,Total,22,22,0,104
30 Veracruz de Ignacio de la Llave,26,026 Banderilla,Total,15,15,0,106
30 Veracruz de Ignacio de la Llave,26,026 Banderilla,Hombres,5652,5364,288,1903
30 Veracruz de Ignacio de la Llave,26,026 Banderilla,Hombres,39,36,3,558
30 Veracruz de Ignacio de la Llave,26,026 Banderilla,Hombres,422,379,43,626
30 Veracruz de Ignacio de la Llave,26,026 Banderilla,Hombres,698,652,46,202
30 Veracruz de Ignacio de la Llave,26,026 Banderilla,Hombres,760,717,43,40
30 Veracruz de Ignacio de la Llave,26,026 Banderilla,Hombres,745,715,30,21
30 Veracruz de Ignacio de la Llave,26,026 Banderilla,Hombres,699,676,23,20
30 Veracruz de Ignacio de la Llave,26,026 Banderilla,Hombres,630,601,29,21
30 Veracruz de Ignacio de la Llave,26,026 Banderilla,Hombres,520,497,23,13
30 Veracruz de Ignacio de la Llave,26,026 Banderilla,Hombres,444,426,18,38
30 Veracruz de Ignacio de la Llave,26,026 Banderilla,Hombres,297,279,18,47
30 Veracruz de Ignacio de la Llave,26,026 Banderilla,Hombres,181,174,7,69
30 Veracruz de Ignacio de la Llave,26,026 Banderilla,Hombres,111,110,1,69
30 Veracruz de Ignacio de la Llave,26,026 Banderilla,Hombres,50,47,3,61
30 Veracruz de Ignacio de la Llave,26,026 Banderilla,Hombres,27,26,1,53
30 Veracruz de Ignacio de la Llave,26,026 Banderilla,Hombres,15,15,0,36
30 Veracruz de Ignacio de la Llave,26,026 Banderilla,Hombres,14,14,0,29
30 Veracruz de Ignacio de la Llave,26,026 Banderilla,Mujeres,3422,3350,72,5383
30 Veracruz de Ignacio de la Llave,26,026 Banderilla,Mujeres,9,8,1,592
30 Veracruz de Ignacio de la Llave,26,026 Banderilla,Mujeres,179,171,8,939
30 Veracruz de Ignacio de la Llave,26,026 Banderilla,Mujeres,390,374,16,592
30 Veracruz de Ignacio de la Llave,26,026 Banderilla,Mujeres,476,461,15,499
30 Veracruz de Ignacio de la Llave,26,026 Banderilla,Mujeres,548,537,11,420
30 Veracruz de Ignacio de la Llave,26,026 Banderilla,Mujeres,504,496,8,380
30 Veracruz de Ignacio de la Llave,26,026 Banderilla,Mujeres,398,393,5,353
30 Veracruz de Ignacio de la Llave,26,026 Banderilla,Mujeres,362,358,4,298
30 Veracruz de Ignacio de la Llave,26,026 Banderilla,Mujeres,248,246,2,269
30 Veracruz de Ignacio de la Llave,26,026 Banderilla,Mujeres,148,147,1,248
30 Veracruz de Ignacio de la Llave,26,026 Banderilla,Mujeres,81,80,1,203
30 Veracruz de Ignacio de la Llave,26,026 Banderilla,Mujeres,42,42,0,163
30 Veracruz de Ignacio de la Llave,26,026 Banderilla,Mujeres,26,26,0,182
30 Veracruz de Ignacio de la Llave,26,026 Banderilla,Mujeres,3,3,0,100
30 Veracruz de Ignacio de la Llave,26,026 Banderilla,Mujeres,7,7,0,68
30 Veracruz de Ignacio de la Llave,26,026 Banderilla,Mujeres,1,1,0,77
30 Veracruz de Ignacio de la Llave,27,027 Benito Juárez,Total,4761,4738,23,7409
30 Veracruz de Ignacio de la Llave,27,027 Benito Juárez,Total,44,42,2,1261
30 Veracruz de Ignacio de la Llave,27,027 Benito Juárez,Total,378,376,2,1572
30 Veracruz de Ignacio de la Llave,27,027 Benito Juárez,Total,486,477,9,573
30 Veracruz de Ignacio de la Llave,27,027 Benito Juárez,Total,440,439,1,412
30 Veracruz de Ignacio de la Llave,27,027 Benito Juárez,Total,442,440,2,418
30 Veracruz de Ignacio de la Llave,27,027 Benito Juárez,Total,473,473,0,471
30 Veracruz de Ignacio de la Llave,27,027 Benito Juárez,Total,466,465,1,382
30 Veracruz de Ignacio de la Llave,27,027 Benito Juárez,Total,418,418,0,410
30 Veracruz de Ignacio de la Llave,27,027 Benito Juárez,Total,391,387,4,409
30 Veracruz de Ignacio de la Llave,27,027 Benito Juárez,Total,366,364,2,378
30 Veracruz de Ignacio de la Llave,27,027 Benito Juárez,Total,296,296,0,301
30 Veracruz de Ignacio de la Llave,27,027 Benito Juárez,Total,228,228,0,271
30 Veracruz de Ignacio de la Llave,27,027 Benito Juárez,Total,166,166,0,221
30 Veracruz de Ignacio de la Llave,27,027 Benito Juárez,Total,85,85,0,140
30 Veracruz de Ignacio de la Llave,27,027 Benito Juárez,Total,48,48,0,110
30 Veracruz de Ignacio de la Llave,27,027 Benito Juárez,Total,34,34,0,80
30 Veracruz de Ignacio de la Llave,27,027 Benito Juárez,Hombres,4228,4205,23,1633
30 Veracruz de Ignacio de la Llave,27,027 Benito Juárez,Hombres,37,35,2,616
30 Veracruz de Ignacio de la Llave,27,027 Benito Juárez,Hombres,336,334,2,690
30 Veracruz de Ignacio de la Llave,27,027 Benito Juárez,Hombres,411,402,9,117
30 Veracruz de Ignacio de la Llave,27,027 Benito Juárez,Hombres,383,382,1,21
30 Veracruz de Ignacio de la Llave,27,027 Benito Juárez,Hombres,395,393,2,17
30 Veracruz de Ignacio de la Llave,27,027 Benito Juárez,Hombres,409,409,0,13
30 Veracruz de Ignacio de la Llave,27,027 Benito Juárez,Hombres,398,397,1,5
30 Veracruz de Ignacio de la Llave,27,027 Benito Juárez,Hombres,346,346,0,13
30 Veracruz de Ignacio de la Llave,27,027 Benito Juárez,Hombres,357,353,4,12
30 Veracruz de Ignacio de la Llave,27,027 Benito Juárez,Hombres,342,340,2,11
30 Veracruz de Ignacio de la Llave,27,027 Benito Juárez,Hombres,277,277,0,20
30 Veracruz de Ignacio de la Llave,27,027 Benito Juárez,Hombres,222,222,0,21
30 Veracruz de Ignacio de la Llave,27,027 Benito Juárez,Hombres,158,158,0,21
30 Veracruz de Ignacio de la Llave,27,027 Benito Juárez,Hombres,81,81,0,18
30 Veracruz de Ignacio de la Llave,27,027 Benito Juárez,Hombres,44,44,0,21
30 Veracruz de Ignacio de la Llave,27,027 Benito Juárez,Hombres,32,32,0,17
30 Veracruz de Ignacio de la Llave,27,027 Benito Juárez,Mujeres,533,533,0,5776
30 Veracruz de Ignacio de la Llave,27,027 Benito Juárez,Mujeres,7,7,0,645
30 Veracruz de Ignacio de la Llave,27,027 Benito Juárez,Mujeres,42,42,0,882
30 Veracruz de Ignacio de la Llave,27,027 Benito Juárez,Mujeres,75,75,0,456
30 Veracruz de Ignacio de la Llave,27,027 Benito Juárez,Mujeres,57,57,0,391
30 Veracruz de Ignacio de la Llave,27,027 Benito Juárez,Mujeres,47,47,0,401
30 Veracruz de Ignacio de la Llave,27,027 Benito Juárez,Mujeres,64,64,0,458
30 Veracruz de Ignacio de la Llave,27,027 Benito Juárez,Mujeres,68,68,0,377
30 Veracruz de Ignacio de la Llave,27,027 Benito Juárez,Mujeres,72,72,0,397
30 Veracruz de Ignacio de la Llave,27,027 Benito Juárez,Mujeres,34,34,0,397
30 Veracruz de Ignacio de la Llave,27,027 Benito Juárez,Mujeres,24,24,0,367
30 Veracruz de Ignacio de la Llave,27,027 Benito Juárez,Mujeres,19,19,0,281
30 Veracruz de Ignacio de la Llave,27,027 Benito Juárez,Mujeres,6,6,0,250
30 Veracruz de Ignacio de la Llave,27,027 Benito Juárez,Mujeres,8,8,0,200
30 Veracruz de Ignacio de la Llave,27,027 Benito Juárez,Mujeres,4,4,0,122
30 Veracruz de Ignacio de la Llave,27,027 Benito Juárez,Mujeres,4,4,0,89
30 Veracruz de Ignacio de la Llave,27,027 Benito Juárez,Mujeres,2,2,0,63
30 Veracruz de Ignacio de la Llave,28,028 Boca del Río,Total,59195,57009,2186,50329
30 Veracruz de Ignacio de la Llave,28,028 Boca del Río,Total,113,95,18,5687
30 Veracruz de Ignacio de la Llave,28,028 Boca del Río,Total,2606,2375,231,8860
30 Veracruz de Ignacio de la Llave,28,028 Boca del Río,Total,6719,6254,465,5733
30 Veracruz de Ignacio de la Llave,28,028 Boca del Río,Total,7976,7593,383,2484
30 Veracruz de Ignacio de la Llave,28,028 Boca del Río,Total,7293,7067,226,2295
30 Veracruz de Ignacio de la Llave,28,028 Boca del Río,Total,7637,7456,181,2496
30 Veracruz de Ignacio de la Llave,28,028 Boca del Río,Total,7059,6898,161,2319
30 Veracruz de Ignacio de la Llave,28,028 Boca del Río,Total,6256,6116,140,2429
30 Veracruz de Ignacio de la Llave,28,028 Boca del Río,Total,5460,5332,128,2725
30 Veracruz de Ignacio de la Llave,28,028 Boca del Río,Total,3688,3593,95,2853
30 Veracruz de Ignacio de la Llave,28,028 Boca del Río,Total,2120,2050,70,3210
30 Veracruz de Ignacio de la Llave,28,028 Boca del Río,Total,1166,1123,43,2847
30 Veracruz de Ignacio de la Llave,28,028 Boca del Río,Total,691,671,20,2594
30 Veracruz de Ignacio de la Llave,28,028 Boca del Río,Total,260,243,17,1742
30 Veracruz de Ignacio de la Llave,28,028 Boca del Río,Total,85,81,4,1133
30 Veracruz de Ignacio de la Llave,28,028 Boca del Río,Total,66,62,4,922
30 Veracruz de Ignacio de la Llave,28,028 Boca del Río,Hombres,35554,34024,1530,14644
30 Veracruz de Ignacio de la Llave,28,028 Boca del Río,Hombres,80,63,17,2838
30 Veracruz de Ignacio de la Llave,28,028 Boca del Río,Hombres,1713,1543,170,4030
30 Veracruz de Ignacio de la Llave,28,028 Boca del Río,Hombres,3878,3603,275,2057
30 Veracruz de Ignacio de la Llave,28,028 Boca del Río,Hombres,4520,4289,231,392
30 Veracruz de Ignacio de la Llave,28,028 Boca del Río,Hombres,4129,3992,137,118
30 Veracruz de Ignacio de la Llave,28,028 Boca del Río,Hombres,4460,4334,126,119
30 Veracruz de Ignacio de la Llave,28,028 Boca del Río,Hombres,4109,3989,120,134
30 Veracruz de Ignacio de la Llave,28,028 Boca del Río,Hombres,3702,3589,113,183
30 Veracruz de Ignacio de la Llave,28,028 Boca del Río,Hombres,3383,3278,105,260
30 Veracruz de Ignacio de la Llave,28,028 Boca del Río,Hombres,2416,2333,83,500
30 Veracruz de Ignacio de la Llave,28,028 Boca del Río,Hombres,1486,1417,69,888
30 Veracruz de Ignacio de la Llave,28,028 Boca del Río,Hombres,837,796,41,947
30 Veracruz de Ignacio de la Llave,28,028 Boca del Río,Hombres,515,496,19,887
30 Veracruz de Ignacio de la Llave,28,028 Boca del Río,Hombres,209,193,16,602
30 Veracruz de Ignacio de la Llave,28,028 Boca del Río,Hombres,68,64,4,408
30 Veracruz de Ignacio de la Llave,28,028 Boca del Río,Hombres,49,45,4,281
30 Veracruz de Ignacio de la Llave,28,028 Boca del Río,Mujeres,23641,22985,656,35685
30 Veracruz de Ignacio de la Llave,28,028 Boca del Río,Mujeres,33,32,1,2849
30 Veracruz de Ignacio de la Llave,28,028 Boca del Río,Mujeres,893,832,61,4830
30 Veracruz de Ignacio de la Llave,28,028 Boca del Río,Mujeres,2841,2651,190,3676
30 Veracruz de Ignacio de la Llave,28,028 Boca del Río,Mujeres,3456,3304,152,2092
30 Veracruz de Ignacio de la Llave,28,028 Boca del Río,Mujeres,3164,3075,89,2177
30 Veracruz de Ignacio de la Llave,28,028 Boca del Río,Mujeres,3177,3122,55,2377
30 Veracruz de Ignacio de la Llave,28,028 Boca del Río,Mujeres,2950,2909,41,2185
30 Veracruz de Ignacio de la Llave,28,028 Boca del Río,Mujeres,2554,2527,27,2246
30 Veracruz de Ignacio de la Llave,28,028 Boca del Río,Mujeres,2077,2054,23,2465
30 Veracruz de Ignacio de la Llave,28,028 Boca del Río,Mujeres,1272,1260,12,2353
30 Veracruz de Ignacio de la Llave,28,028 Boca del Río,Mujeres,634,633,1,2322
30 Veracruz de Ignacio de la Llave,28,028 Boca del Río,Mujeres,329,327,2,1900
30 Veracruz de Ignacio de la Llave,28,028 Boca del Río,Mujeres,176,175,1,1707
30 Veracruz de Ignacio de la Llave,28,028 Boca del Río,Mujeres,51,50,1,1140
30 Veracruz de Ignacio de la Llave,28,028 Boca del Río,Mujeres,17,17,0,725
30 Veracruz de Ignacio de la Llave,28,028 Boca del Río,Mujeres,17,17,0,641
30 Veracruz de Ignacio de la Llave,29,029 Calcahualco,Total,3583,3534,49,4939
30 Veracruz de Ignacio de la Llave,29,029 Calcahualco,Total,81,80,1,965
30 Veracruz de Ignacio de la Llave,29,029 Calcahualco,Total,545,540,5,1077
30 Veracruz de Ignacio de la Llave,29,029 Calcahualco,Total,515,510,5,463
30 Veracruz de Ignacio de la Llave,29,029 Calcahualco,Total,395,383,12,401
30 Veracruz de Ignacio de la Llave,29,029 Calcahualco,Total,373,367,6,339
30 Veracruz de Ignacio de la Llave,29,029 Calcahualco,Total,382,375,7,359
30 Veracruz de Ignacio de la Llave,29,029 Calcahualco,Total,290,286,4,258
30 Veracruz de Ignacio de la Llave,29,029 Calcahualco,Total,256,254,2,227
30 Veracruz de Ignacio de la Llave,29,029 Calcahualco,Total,174,171,3,160
30 Veracruz de Ignacio de la Llave,29,029 Calcahualco,Total,168,166,2,159
30 Veracruz de Ignacio de la Llave,29,029 Calcahualco,Total,126,125,1,114
30 Veracruz de Ignacio de la Llave,29,029 Calcahualco,Total,99,98,1,140
30 Veracruz de Ignacio de la Llave,29,029 Calcahualco,Total,74,74,0,106
30 Veracruz de Ignacio de la Llave,29,029 Calcahualco,Total,62,62,0,78
30 Veracruz de Ignacio de la Llave,29,029 Calcahualco,Total,31,31,0,48
30 Veracruz de Ignacio de la Llave,29,029 Calcahualco,Total,12,12,0,45
30 Veracruz de Ignacio de la Llave,29,029 Calcahualco,Hombres,3182,3135,47,1011
30 Veracruz de Ignacio de la Llave,29,029 Calcahualco,Hombres,66,65,1,453
30 Veracruz de Ignacio de la Llave,29,029 Calcahualco,Hombres,465,461,4,342
30 Veracruz de Ignacio de la Llave,29,029 Calcahualco,Hombres,437,432,5,44
30 Veracruz de Ignacio de la Llave,29,029 Calcahualco,Hombres,355,344,11,17
30 Veracruz de Ignacio de la Llave,29,029 Calcahualco,Hombres,327,321,6,21
30 Veracruz de Ignacio de la Llave,29,029 Calcahualco,Hombres,344,337,7,7
30 Veracruz de Ignacio de la Llave,29,029 Calcahualco,Hombres,273,269,4,10
30 Veracruz de Ignacio de la Llave,29,029 Calcahualco,Hombres,236,234,2,9
30 Veracruz de Ignacio de la Llave,29,029 Calcahualco,Hombres,158,155,3,6
30 Veracruz de Ignacio de la Llave,29,029 Calcahualco,Hombres,150,148,2,7
30 Veracruz de Ignacio de la Llave,29,029 Calcahualco,Hombres,116,115,1,13
30 Veracruz de Ignacio de la Llave,29,029 Calcahualco,Hombres,92,91,1,21
30 Veracruz de Ignacio de la Llave,29,029 Calcahualco,Hombres,63,63,0,15
30 Veracruz de Ignacio de la Llave,29,029 Calcahualco,Hombres,60,60,0,15
30 Veracruz de Ignacio de la Llave,29,029 Calcahualco,Hombres,29,29,0,13
30 Veracruz de Ignacio de la Llave,29,029 Calcahualco,Hombres,11,11,0,18
30 Veracruz de Ignacio de la Llave,29,029 Calcahualco,Mujeres,401,399,2,3928
30 Veracruz de Ignacio de la Llave,29,029 Calcahualco,Mujeres,15,15,0,512
30 Veracruz de Ignacio de la Llave,29,029 Calcahualco,Mujeres,80,79,1,735
30 Veracruz de Ignacio de la Llave,29,029 Calcahualco,Mujeres,78,78,0,419
30 Veracruz de Ignacio de la Llave,29,029 Calcahualco,Mujeres,40,39,1,384
30 Veracruz de Ignacio de la Llave,29,029 Calcahualco,Mujeres,46,46,0,318
30 Veracruz de Ignacio de la Llave,29,029 Calcahualco,Mujeres,38,38,0,352
30 Veracruz de Ignacio de la Llave,29,029 Calcahualco,Mujeres,17,17,0,248
30 Veracruz de Ignacio de la Llave,29,029 Calcahualco,Mujeres,20,20,0,218
30 Veracruz de Ignacio de la Llave,29,029 Calcahualco,Mujeres,16,16,0,154
30 Veracruz de Ignacio de la Llave,29,029 Calcahualco,Mujeres,18,18,0,152
30 Veracruz de Ignacio de la Llave,29,029 Calcahualco,Mujeres,10,10,0,101
30 Veracruz de Ignacio de la Llave,29,029 Calcahualco,Mujeres,7,7,0,119
30 Veracruz de Ignacio de la Llave,29,029 Calcahualco,Mujeres,11,11,0,91
30 Veracruz de Ignacio de la Llave,29,029 Calcahualco,Mujeres,2,2,0,63
30 Veracruz de Ignacio de la Llave,29,029 Calcahualco,Mujeres,2,2,0,35
30 Veracruz de Ignacio de la Llave,29,029 Calcahualco,Mujeres,1,1,0,27
30 Veracruz de Ignacio de la Llave,7,007 Camarón de Tejeda,Total,2260,2182,78,2628
30 Veracruz de Ignacio de la Llave,7,007 Camarón de Tejeda,Total,25,25,0,303
30 Veracruz de Ignacio de la Llave,7,007 Camarón de Tejeda,Total,178,171,7,375
30 Veracruz de Ignacio de la Llave,7,007 Camarón de Tejeda,Total,270,248,22,253
30 Veracruz de Ignacio de la Llave,7,007 Camarón de Tejeda,Total,229,213,16,203
30 Veracruz de Ignacio de la Llave,7,007 Camarón de Tejeda,Total,246,238,8,217
30 Veracruz de Ignacio de la Llave,7,007 Camarón de Tejeda,Total,258,252,6,225
30 Veracruz de Ignacio de la Llave,7,007 Camarón de Tejeda,Total,231,226,5,184
30 Veracruz de Ignacio de la Llave,7,007 Camarón de Tejeda,Total,205,200,5,142
30 Veracruz de Ignacio de la Llave,7,007 Camarón de Tejeda,Total,149,148,1,138
30 Veracruz de Ignacio de la Llave,7,007 Camarón de Tejeda,Total,143,141,2,106
30 Veracruz de Ignacio de la Llave,7,007 Camarón de Tejeda,Total,93,90,3,101
30 Veracruz de Ignacio de la Llave,7,007 Camarón de Tejeda,Total,102,100,2,101
30 Veracruz de Ignacio de la Llave,7,007 Camarón de Tejeda,Total,58,58,0,84
30 Veracruz de Ignacio de la Llave,7,007 Camarón de Tejeda,Total,35,34,1,87
30 Veracruz de Ignacio de la Llave,7,007 Camarón de Tejeda,Total,15,15,0,50
30 Veracruz de Ignacio de la Llave,7,007 Camarón de Tejeda,Total,23,23,0,59
30 Veracruz de Ignacio de la Llave,7,007 Camarón de Tejeda,Hombres,1938,1866,72,470
30 Veracruz de Ignacio de la Llave,7,007 Camarón de Tejeda,Hombres,20,20,0,154
30 Veracruz de Ignacio de la Llave,7,007 Camarón de Tejeda,Hombres,142,136,6,133
30 Veracruz de Ignacio de la Llave,7,007 Camarón de Tejeda,Hombres,221,202,19,28
30 Veracruz de Ignacio de la Llave,7,007 Camarón de Tejeda,Hombres,189,175,14,5
30 Veracruz de Ignacio de la Llave,7,007 Camarón de Tejeda,Hombres,215,207,8,12
30 Veracruz de Ignacio de la Llave,7,007 Camarón de Tejeda,Hombres,222,216,6,11
30 Veracruz de Ignacio de la Llave,7,007 Camarón de Tejeda,Hombres,202,197,5,5
30 Veracruz de Ignacio de la Llave,7,007 Camarón de Tejeda,Hombres,180,175,5,6
30 Veracruz de Ignacio de la Llave,7,007 Camarón de Tejeda,Hombres,122,121,1,10
30 Veracruz de Ignacio de la Llave,7,007 Camarón de Tejeda,Hombres,126,124,2,9
30 Veracruz de Ignacio de la Llave,7,007 Camarón de Tejeda,Hombres,84,81,3,10
30 Veracruz de Ignacio de la Llave,7,007 Camarón de Tejeda,Hombres,96,94,2,20
30 Veracruz de Ignacio de la Llave,7,007 Camarón de Tejeda,Hombres,53,53,0,18
30 Veracruz de Ignacio de la Llave,7,007 Camarón de Tejeda,Hombres,31,30,1,20
30 Veracruz de Ignacio de la Llave,7,007 Camarón de Tejeda,Hombres,15,15,0,12
30 Veracruz de Ignacio de la Llave,7,007 Camarón de Tejeda,Hombres,20,20,0,17
30 Veracruz de Ignacio de la Llave,7,007 Camarón de Tejeda,Mujeres,322,316,6,2158
30 Veracruz de Ignacio de la Llave,7,007 Camarón de Tejeda,Mujeres,5,5,0,149
30 Veracruz de Ignacio de la Llave,7,007 Camarón de Tejeda,Mujeres,36,35,1,242
30 Veracruz de Ignacio de la Llave,7,007 Camarón de Tejeda,Mujeres,49,46,3,225
30 Veracruz de Ignacio de la Llave,7,007 Camarón de Tejeda,Mujeres,40,38,2,198
30 Veracruz de Ignacio de la Llave,7,007 Camarón de Tejeda,Mujeres,31,31,0,205
30 Veracruz de Ignacio de la Llave,7,007 Camarón de Tejeda,Mujeres,36,36,0,214
30 Veracruz de Ignacio de la Llave,7,007 Camarón de Tejeda,Mujeres,29,29,0,179
30 Veracruz de Ignacio de la Llave,7,007 Camarón de Tejeda,Mujeres,25,25,0,136
30 Veracruz de Ignacio de la Llave,7,007 Camarón de Tejeda,Mujeres,27,27,0,128
30 Veracruz de Ignacio de la Llave,7,007 Camarón de Tejeda,Mujeres,17,17,0,97
30 Veracruz de Ignacio de la Llave,7,007 Camarón de Tejeda,Mujeres,9,9,0,91
30 Veracruz de Ignacio de la Llave,7,007 Camarón de Tejeda,Mujeres,6,6,0,81
30 Veracruz de Ignacio de la Llave,7,007 Camarón de Tejeda,Mujeres,5,5,0,66
30 Veracruz de Ignacio de la Llave,7,007 Camarón de Tejeda,Mujeres,4,4,0,67
30 Veracruz de Ignacio de la Llave,7,007 Camarón de Tejeda,Mujeres,0,0,0,38
30 Veracruz de Ignacio de la Llave,7,007 Camarón de Tejeda,Mujeres,3,3,0,42
30 Veracruz de Ignacio de la Llave,30,030 Camerino Z. Mendoza,Total,15513,14388,1125,16466
30 Veracruz de Ignacio de la Llave,30,030 Camerino Z. Mendoza,Total,100,82,18,2066
30 Veracruz de Ignacio de la Llave,30,030 Camerino Z. Mendoza,Total,900,765,135,3151
30 Veracruz de Ignacio de la Llave,30,030 Camerino Z. Mendoza,Total,1797,1591,206,1912
30 Veracruz de Ignacio de la Llave,30,030 Camerino Z. Mendoza,Total,2192,2019,173,1088
30 Veracruz de Ignacio de la Llave,30,030 Camerino Z. Mendoza,Total,1941,1825,116,887
30 Veracruz de Ignacio de la Llave,30,030 Camerino Z. Mendoza,Total,1987,1874,113,778
30 Veracruz de Ignacio de la Llave,30,030 Camerino Z. Mendoza,Total,1764,1679,85,758
30 Veracruz de Ignacio de la Llave,30,030 Camerino Z. Mendoza,Total,1585,1496,89,646
30 Veracruz de Ignacio de la Llave,30,030 Camerino Z. Mendoza,Total,1266,1200,66,705
30 Veracruz de Ignacio de la Llave,30,030 Camerino Z. Mendoza,Total,823,767,56,700
30 Veracruz de Ignacio de la Llave,30,030 Camerino Z. Mendoza,Total,482,457,25,908
30 Veracruz de Ignacio de la Llave,30,030 Camerino Z. Mendoza,Total,296,277,19,781
30 Veracruz de Ignacio de la Llave,30,030 Camerino Z. Mendoza,Total,205,193,12,713
30 Veracruz de Ignacio de la Llave,30,030 Camerino Z. Mendoza,Total,110,103,7,541
30 Veracruz de Ignacio de la Llave,30,030 Camerino Z. Mendoza,Total,46,41,5,423
30 Veracruz de Ignacio de la Llave,30,030 Camerino Z. Mendoza,Total,19,19,0,409
30 Veracruz de Ignacio de la Llave,30,030 Camerino Z. Mendoza,Hombres,10019,9103,916,4777
30 Veracruz de Ignacio de la Llave,30,030 Camerino Z. Mendoza,Hombres,82,67,15,1015
30 Veracruz de Ignacio de la Llave,30,030 Camerino Z. Mendoza,Hombres,717,605,112,1263
30 Veracruz de Ignacio de la Llave,30,030 Camerino Z. Mendoza,Hombres,1227,1089,138,548
30 Veracruz de Ignacio de la Llave,30,030 Camerino Z. Mendoza,Hombres,1411,1281,130,154
30 Veracruz de Ignacio de la Llave,30,030 Camerino Z. Mendoza,Hombres,1205,1113,92,68
30 Veracruz de Ignacio de la Llave,30,030 Camerino Z. Mendoza,Hombres,1212,1117,95,50
30 Veracruz de Ignacio de la Llave,30,030 Camerino Z. Mendoza,Hombres,1068,993,75,61
30 Veracruz de Ignacio de la Llave,30,030 Camerino Z. Mendoza,Hombres,982,903,79,62
30 Veracruz de Ignacio de la Llave,30,030 Camerino Z. Mendoza,Hombres,782,720,62,100
30 Veracruz de Ignacio de la Llave,30,030 Camerino Z. Mendoza,Hombres,540,489,51,127
30 Veracruz de Ignacio de la Llave,30,030 Camerino Z. Mendoza,Hombres,322,297,25,286
30 Veracruz de Ignacio de la Llave,30,030 Camerino Z. Mendoza,Hombres,205,187,18,275
30 Veracruz de Ignacio de la Llave,30,030 Camerino Z. Mendoza,Hombres,142,130,12,252
30 Veracruz de Ignacio de la Llave,30,030 Camerino Z. Mendoza,Hombres,80,73,7,192
30 Veracruz de Ignacio de la Llave,30,030 Camerino Z. Mendoza,Hombres,32,27,5,167
30 Veracruz de Ignacio de la Llave,30,030 Camerino Z. Mendoza,Hombres,12,12,0,157
30 Veracruz de Ignacio de la Llave,30,030 Camerino Z. Mendoza,Mujeres,5494,5285,209,11689
30 Veracruz de Ignacio de la Llave,30,030 Camerino Z. Mendoza,Mujeres,18,15,3,1051
30 Veracruz de Ignacio de la Llave,30,030 Camerino Z. Mendoza,Mujeres,183,160,23,1888
30 Veracruz de Ignacio de la Llave,30,030 Camerino Z. Mendoza,Mujeres,570,502,68,1364
30 Veracruz de Ignacio de la Llave,30,030 Camerino Z. Mendoza,Mujeres,781,738,43,934
30 Veracruz de Ignacio de la Llave,30,030 Camerino Z. Mendoza,Mujeres,736,712,24,819
30 Veracruz de Ignacio de la Llave,30,030 Camerino Z. Mendoza,Mujeres,775,757,18,728
30 Veracruz de Ignacio de la Llave,30,030 Camerino Z. Mendoza,Mujeres,696,686,10,697
30 Veracruz de Ignacio de la Llave,30,030 Camerino Z. Mendoza,Mujeres,603,593,10,584
30 Veracruz de Ignacio de la Llave,30,030 Camerino Z. Mendoza,Mujeres,484,480,4,605
30 Veracruz de Ignacio de la Llave,30,030 Camerino Z. Mendoza,Mujeres,283,278,5,573
30 Veracruz de Ignacio de la Llave,30,030 Camerino Z. Mendoza,Mujeres,160,160,0,622
30 Veracruz de Ignacio de la Llave,30,030 Camerino Z. Mendoza,Mujeres,91,90,1,506
30 Veracruz de Ignacio de la Llave,30,030 Camerino Z. Mendoza,Mujeres,63,63,0,461
30 Veracruz de Ignacio de la Llave,30,030 Camerino Z. Mendoza,Mujeres,30,30,0,349
30 Veracruz de Ignacio de la Llave,30,030 Camerino Z. Mendoza,Mujeres,14,14,0,256
30 Veracruz de Ignacio de la Llave,30,030 Camerino Z. Mendoza,Mujeres,7,7,0,252
30 Veracruz de Ignacio de la Llave,208,208 Carlos A. Carrillo,Total,7835,7604,231,10593
30 Veracruz de Ignacio de la Llave,208,208 Carlos A. Carrillo,Total,32,28,4,1072
30 Veracruz de Ignacio de la Llave,208,208 Carlos A. Carrillo,Total,419,373,46,1504
30 Veracruz de Ignacio de la Llave,208,208 Carlos A. Carrillo,Total,874,828,46,863
30 Veracruz de Ignacio de la Llave,208,208 Carlos A. Carrillo,Total,917,889,28,546
30 Veracruz de Ignacio de la Llave,208,208 Carlos A. Carrillo,Total,914,869,45,589
30 Veracruz de Ignacio de la Llave,208,208 Carlos A. Carrillo,Total,919,902,17,652
30 Veracruz de Ignacio de la Llave,208,208 Carlos A. Carrillo,Total,946,931,15,669
30 Veracruz de Ignacio de la Llave,208,208 Carlos A. Carrillo,Total,891,885,6,675
30 Veracruz de Ignacio de la Llave,208,208 Carlos A. Carrillo,Total,765,755,10,631
30 Veracruz de Ignacio de la Llave,208,208 Carlos A. Carrillo,Total,598,592,6,594
30 Veracruz de Ignacio de la Llave,208,208 Carlos A. Carrillo,Total,266,262,4,860
30 Veracruz de Ignacio de la Llave,208,208 Carlos A. Carrillo,Total,128,126,2,620
30 Veracruz de Ignacio de la Llave,208,208 Carlos A. Carrillo,Total,95,94,1,564
30 Veracruz de Ignacio de la Llave,208,208 Carlos A. Carrillo,Total,48,47,1,371
30 Veracruz de Ignacio de la Llave,208,208 Carlos A. Carrillo,Total,12,12,0,216
30 Veracruz de Ignacio de la Llave,208,208 Carlos A. Carrillo,Total,11,11,0,167
30 Veracruz de Ignacio de la Llave,208,208 Carlos A. Carrillo,Hombres,5822,5639,183,2808
30 Veracruz de Ignacio de la Llave,208,208 Carlos A. Carrillo,Hombres,31,27,4,535
30 Veracruz de Ignacio de la Llave,208,208 Carlos A. Carrillo,Hombres,340,302,38,625
30 Veracruz de Ignacio de la Llave,208,208 Carlos A. Carrillo,Hombres,647,612,35,185
30 Veracruz de Ignacio de la Llave,208,208 Carlos A. Carrillo,Hombres,641,621,20,54
30 Veracruz de Ignacio de la Llave,208,208 Carlos A. Carrillo,Hombres,621,591,30,30
30 Veracruz de Ignacio de la Llave,208,208 Carlos A. Carrillo,Hombres,635,620,15,32
30 Veracruz de Ignacio de la Llave,208,208 Carlos A. Carrillo,Hombres,673,659,14,30
30 Veracruz de Ignacio de la Llave,208,208 Carlos A. Carrillo,Hombres,678,673,5,46
30 Veracruz de Ignacio de la Llave,208,208 Carlos A. Carrillo,Hombres,610,600,10,39
30 Veracruz de Ignacio de la Llave,208,208 Carlos A. Carrillo,Hombres,502,497,5,69
30 Veracruz de Ignacio de la Llave,208,208 Carlos A. Carrillo,Hombres,218,214,4,331
30 Veracruz de Ignacio de la Llave,208,208 Carlos A. Carrillo,Hombres,93,92,1,273
30 Veracruz de Ignacio de la Llave,208,208 Carlos A. Carrillo,Hombres,78,77,1,235
30 Veracruz de Ignacio de la Llave,208,208 Carlos A. Carrillo,Hombres,38,37,1,156
30 Veracruz de Ignacio de la Llave,208,208 Carlos A. Carrillo,Hombres,9,9,0,98
30 Veracruz de Ignacio de la Llave,208,208 Carlos A. Carrillo,Hombres,8,8,0,70
30 Veracruz de Ignacio de la Llave,208,208 Carlos A. Carrillo,Mujeres,2013,1965,48,7785
30 Veracruz de Ignacio de la Llave,208,208 Carlos A. Carrillo,Mujeres,1,1,0,537
30 Veracruz de Ignacio de la Llave,208,208 Carlos A. Carrillo,Mujeres,79,71,8,879
30 Veracruz de Ignacio de la Llave,208,208 Carlos A. Carrillo,Mujeres,227,216,11,678
30 Veracruz de Ignacio de la Llave,208,208 Carlos A. Carrillo,Mujeres,276,268,8,492
30 Veracruz de Ignacio de la Llave,208,208 Carlos A. Carrillo,Mujeres,293,278,15,559
30 Veracruz de Ignacio de la Llave,208,208 Carlos A. Carrillo,Mujeres,284,282,2,620
30 Veracruz de Ignacio de la Llave,208,208 Carlos A. Carrillo,Mujeres,273,272,1,639
30 Veracruz de Ignacio de la Llave,208,208 Carlos A. Carrillo,Mujeres,213,212,1,629
30 Veracruz de Ignacio de la Llave,208,208 Carlos A. Carrillo,Mujeres,155,155,0,592
30 Veracruz de Ignacio de la Llave,208,208 Carlos A. Carrillo,Mujeres,96,95,1,525
30 Veracruz de Ignacio de la Llave,208,208 Carlos A. Carrillo,Mujeres,48,48,0,529
30 Veracruz de Ignacio de la Llave,208,208 Carlos A. Carrillo,Mujeres,35,34,1,347
30 Veracruz de Ignacio de la Llave,208,208 Carlos A. Carrillo,Mujeres,17,17,0,329
30 Veracruz de Ignacio de la Llave,208,208 Carlos A. Carrillo,Mujeres,10,10,0,215
30 Veracruz de Ignacio de la Llave,208,208 Carlos A. Carrillo,Mujeres,3,3,0,118
30 Veracruz de Ignacio de la Llave,208,208 Carlos A. Carrillo,Mujeres,3,3,0,97
30 Veracruz de Ignacio de la Llave,31,031 Carrillo Puerto,Total,5223,5088,135,7170
30 Veracruz de Ignacio de la Llave,31,031 Carrillo Puerto,Total,108,103,5,938
30 Veracruz de Ignacio de la Llave,31,031 Carrillo Puerto,Total,688,672,16,1147
30 Veracruz de Ignacio de la Llave,31,031 Carrillo Puerto,Total,752,737,15,779
30 Veracruz de Ignacio de la Llave,31,031 Carrillo Puerto,Total,598,585,13,650
30 Veracruz de Ignacio de la Llave,31,031 Carrillo Puerto,Total,561,544,17,604
30 Veracruz de Ignacio de la Llave,31,031 Carrillo Puerto,Total,523,511,12,598
30 Veracruz de Ignacio de la Llave,31,031 Carrillo Puerto,Total,465,456,9,486
30 Veracruz de Ignacio de la Llave,31,031 Carrillo Puerto,Total,404,394,10,420
30 Veracruz de Ignacio de la Llave,31,031 Carrillo Puerto,Total,299,292,7,331
30 Veracruz de Ignacio de la Llave,31,031 Carrillo Puerto,Total,258,251,7,280
30 Veracruz de Ignacio de la Llave,31,031 Carrillo Puerto,Total,218,210,8,232
30 Veracruz de Ignacio de la Llave,31,031 Carrillo Puerto,Total,145,136,9,216
30 Veracruz de Ignacio de la Llave,31,031 Carrillo Puerto,Total,107,104,3,184
30 Veracruz de Ignacio de la Llave,31,031 Carrillo Puerto,Total,60,58,2,131
30 Veracruz de Ignacio de la Llave,31,031 Carrillo Puerto,Total,22,21,1,86
30 Veracruz de Ignacio de la Llave,31,031 Carrillo Puerto,Total,15,14,1,88
30 Veracruz de Ignacio de la Llave,31,031 Carrillo Puerto,Hombres,4757,4630,127,1229
30 Veracruz de Ignacio de la Llave,31,031 Carrillo Puerto,Hombres,97,92,5,412
30 Veracruz de Ignacio de la Llave,31,031 Carrillo Puerto,Hombres,621,608,13,305
30 Veracruz de Ignacio de la Llave,31,031 Carrillo Puerto,Hombres,645,632,13,56
30 Veracruz de Ignacio de la Llave,31,031 Carrillo Puerto,Hombres,535,522,13,48
30 Veracruz de Ignacio de la Llave,31,031 Carrillo Puerto,Hombres,497,481,16,37
30 Veracruz de Ignacio de la Llave,31,031 Carrillo Puerto,Hombres,482,470,12,35
30 Veracruz de Ignacio de la Llave,31,031 Carrillo Puerto,Hombres,426,417,9,36
30 Veracruz de Ignacio de la Llave,31,031 Carrillo Puerto,Hombres,378,368,10,37
30 Veracruz de Ignacio de la Llave,31,031 Carrillo Puerto,Hombres,282,276,6,38
30 Veracruz de Ignacio de la Llave,31,031 Carrillo Puerto,Hombres,244,237,7,26
30 Veracruz de Ignacio de la Llave,31,031 Carrillo Puerto,Hombres,210,202,8,27
30 Veracruz de Ignacio de la Llave,31,031 Carrillo Puerto,Hombres,140,131,9,39
30 Veracruz de Ignacio de la Llave,31,031 Carrillo Puerto,Hombres,105,102,3,35
30 Veracruz de Ignacio de la Llave,31,031 Carrillo Puerto,Hombres,59,57,2,36
30 Veracruz de Ignacio de la Llave,31,031 Carrillo Puerto,Hombres,22,21,1,27
30 Veracruz de Ignacio de la Llave,31,031 Carrillo Puerto,Hombres,14,14,0,35
30 Veracruz de Ignacio de la Llave,31,031 Carrillo Puerto,Mujeres,466,458,8,5941
30 Veracruz de Ignacio de la Llave,31,031 Carrillo Puerto,Mujeres,11,11,0,526
30 Veracruz de Ignacio de la Llave,31,031 Carrillo Puerto,Mujeres,67,64,3,842
30 Veracruz de Ignacio de la Llave,31,031 Carrillo Puerto,Mujeres,107,105,2,723
30 Veracruz de Ignacio de la Llave,31,031 Carrillo Puerto,Mujeres,63,63,0,602
30 Veracruz de Ignacio de la Llave,31,031 Carrillo Puerto,Mujeres,64,63,1,567
30 Veracruz de Ignacio de la Llave,31,031 Carrillo Puerto,Mujeres,41,41,0,563
30 Veracruz de Ignacio de la Llave,31,031 Carrillo Puerto,Mujeres,39,39,0,450
30 Veracruz de Ignacio de la Llave,31,031 Carrillo Puerto,Mujeres,26,26,0,383
30 Veracruz de Ignacio de la Llave,31,031 Carrillo Puerto,Mujeres,17,16,1,293
30 Veracruz de Ignacio de la Llave,31,031 Carrillo Puerto,Mujeres,14,14,0,254
30 Veracruz de Ignacio de la Llave,31,031 Carrillo Puerto,Mujeres,8,8,0,205
30 Veracruz de Ignacio de la Llave,31,031 Carrillo Puerto,Mujeres,5,5,0,177
30 Veracruz de Ignacio de la Llave,31,031 Carrillo Puerto,Mujeres,2,2,0,149
30 Veracruz de Ignacio de la Llave,31,031 Carrillo Puerto,Mujeres,1,1,0,95
30 Veracruz de Ignacio de la Llave,31,031 Carrillo Puerto,Mujeres,0,0,0,59
30 Veracruz de Ignacio de la Llave,31,031 Carrillo Puerto,Mujeres,1,0,1,53
30 Veracruz de Ignacio de la Llave,157,157 Castillo de Teayo,Total,6395,6318,77,8072
30 Veracruz de Ignacio de la Llave,157,157 Castillo de Teayo,Total,34,33,1,1142
30 Veracruz de Ignacio de la Llave,157,157 Castillo de Teayo,Total,464,457,7,1674
30 Veracruz de Ignacio de la Llave,157,157 Castillo de Teayo,Total,678,655,23,670
30 Veracruz de Ignacio de la Llave,157,157 Castillo de Teayo,Total,606,599,7,497
30 Veracruz de Ignacio de la Llave,157,157 Castillo de Teayo,Total,676,668,8,513
30 Veracruz de Ignacio de la Llave,157,157 Castillo de Teayo,Total,682,676,6,553
30 Veracruz de Ignacio de la Llave,157,157 Castillo de Teayo,Total,661,657,4,503
30 Veracruz de Ignacio de la Llave,157,157 Castillo de Teayo,Total,573,568,5,443
30 Veracruz de Ignacio de la Llave,157,157 Castillo de Teayo,Total,476,470,6,405
30 Veracruz de Ignacio de la Llave,157,157 Castillo de Teayo,Total,434,429,5,377
30 Veracruz de Ignacio de la Llave,157,157 Castillo de Teayo,Total,366,363,3,296
30 Veracruz de Ignacio de la Llave,157,157 Castillo de Teayo,Total,292,291,1,308
30 Veracruz de Ignacio de la Llave,157,157 Castillo de Teayo,Total,226,226,0,276
30 Veracruz de Ignacio de la Llave,157,157 Castillo de Teayo,Total,127,126,1,177
30 Veracruz de Ignacio de la Llave,157,157 Castillo de Teayo,Total,60,60,0,108
30 Veracruz de Ignacio de la Llave,157,157 Castillo de Teayo,Total,40,40,0,130
30 Veracruz de Ignacio de la Llave,157,157 Castillo de Teayo,Hombres,5436,5374,62,1748
30 Veracruz de Ignacio de la Llave,157,157 Castillo de Teayo,Hombres,26,26,0,582
30 Veracruz de Ignacio de la Llave,157,157 Castillo de Teayo,Hombres,390,386,4,701
30 Veracruz de Ignacio de la Llave,157,157 Castillo de Teayo,Hombres,557,543,14,104
30 Veracruz de Ignacio de la Llave,157,157 Castillo de Teayo,Hombres,507,501,6,23
30 Veracruz de Ignacio de la Llave,157,157 Castillo de Teayo,Hombres,566,559,7,14
30 Veracruz de Ignacio de la Llave,157,157 Castillo de Teayo,Hombres,569,563,6,19
30 Veracruz de Ignacio de la Llave,157,157 Castillo de Teayo,Hombres,550,546,4,12
30 Veracruz de Ignacio de la Llave,157,157 Castillo de Teayo,Hombres,468,463,5,16
30 Veracruz de Ignacio de la Llave,157,157 Castillo de Teayo,Hombres,399,393,6,21
30 Veracruz de Ignacio de la Llave,157,157 Castillo de Teayo,Hombres,383,378,5,21
30 Veracruz de Ignacio de la Llave,157,157 Castillo de Teayo,Hombres,333,330,3,28
30 Veracruz de Ignacio de la Llave,157,157 Castillo de Teayo,Hombres,259,258,1,37
30 Veracruz de Ignacio de la Llave,157,157 Castillo de Teayo,Hombres,211,211,0,53
30 Veracruz de Ignacio de la Llave,157,157 Castillo de Teayo,Hombres,121,120,1,43
30 Veracruz de Ignacio de la Llave,157,157 Castillo de Teayo,Hombres,58,58,0,37
30 Veracruz de Ignacio de la Llave,157,157 Castillo de Teayo,Hombres,39,39,0,37
30 Veracruz de Ignacio de la Llave,157,157 Castillo de Teayo,Mujeres,959,944,15,6324
30 Veracruz de Ignacio de la Llave,157,157 Castillo de Teayo,Mujeres,8,7,1,560
30 Veracruz de Ignacio de la Llave,157,157 Castillo de Teayo,Mujeres,74,71,3,973
30 Veracruz de Ignacio de la Llave,157,157 Castillo de Teayo,Mujeres,121,112,9,566
30 Veracruz de Ignacio de la Llave,157,157 Castillo de Teayo,Mujeres,99,98,1,474
30 Veracruz de Ignacio de la Llave,157,157 Castillo de Teayo,Mujeres,110,109,1,499
30 Veracruz de Ignacio de la Llave,157,157 Castillo de Teayo,Mujeres,113,113,0,534
30 Veracruz de Ignacio de la Llave,157,157 Castillo de Teayo,Mujeres,111,111,0,491
30 Veracruz de Ignacio de la Llave,157,157 Castillo de Teayo,Mujeres,105,105,0,427
30 Veracruz de Ignacio de la Llave,157,157 Castillo de Teayo,Mujeres,77,77,0,384
30 Veracruz de Ignacio de la Llave,157,157 Castillo de Teayo,Mujeres,51,51,0,356
30 Veracruz de Ignacio de la Llave,157,157 Castillo de Teayo,Mujeres,33,33,0,268
30 Veracruz de Ignacio de la Llave,157,157 Castillo de Teayo,Mujeres,33,33,0,271
30 Veracruz de Ignacio de la Llave,157,157 Castillo de Teayo,Mujeres,15,15,0,223
30 Veracruz de Ignacio de la Llave,157,157 Castillo de Teayo,Mujeres,6,6,0,134
30 Veracruz de Ignacio de la Llave,157,157 Castillo de Teayo,Mujeres,2,2,0,71
30 Veracruz de Ignacio de la Llave,157,157 Castillo de Teayo,Mujeres,1,1,0,93
30 Veracruz de Ignacio de la Llave,32,032 Catemaco,Total,17898,17223,675,18872
30 Veracruz de Ignacio de la Llave,32,032 Catemaco,Total,172,155,17,2904
30 Veracruz de Ignacio de la Llave,32,032 Catemaco,Total,1302,1221,81,3837
30 Veracruz de Ignacio de la Llave,32,032 Catemaco,Total,2151,2035,116,1860
30 Veracruz de Ignacio de la Llave,32,032 Catemaco,Total,2143,2055,88,1389
30 Veracruz de Ignacio de la Llave,32,032 Catemaco,Total,2204,2146,58,1392
30 Veracruz de Ignacio de la Llave,32,032 Catemaco,Total,2183,2113,70,1256
30 Veracruz de Ignacio de la Llave,32,032 Catemaco,Total,1879,1823,56,1092
30 Veracruz de Ignacio de la Llave,32,032 Catemaco,Total,1609,1564,45,983
30 Veracruz de Ignacio de la Llave,32,032 Catemaco,Total,1291,1246,45,808
30 Veracruz de Ignacio de la Llave,32,032 Catemaco,Total,1028,993,35,737
30 Veracruz de Ignacio de la Llave,32,032 Catemaco,Total,738,718,20,655
30 Veracruz de Ignacio de la Llave,32,032 Catemaco,Total,488,467,21,570
30 Veracruz de Ignacio de la Llave,32,032 Catemaco,Total,394,381,13,582
30 Veracruz de Ignacio de la Llave,32,032 Catemaco,Total,184,177,7,327
30 Veracruz de Ignacio de la Llave,32,032 Catemaco,Total,81,79,2,226
30 Veracruz de Ignacio de la Llave,32,032 Catemaco,Total,51,50,1,254
30 Veracruz de Ignacio de la Llave,32,032 Catemaco,Hombres,13409,12823,586,4009
30 Veracruz de Ignacio de la Llave,32,032 Catemaco,Hombres,135,121,14,1394
30 Veracruz de Ignacio de la Llave,32,032 Catemaco,Hombres,1049,979,70,1490
30 Veracruz de Ignacio de la Llave,32,032 Catemaco,Hombres,1590,1497,93,291
30 Veracruz de Ignacio de la Llave,32,032 Catemaco,Hombres,1532,1466,66,57
30 Veracruz de Ignacio de la Llave,32,032 Catemaco,Hombres,1545,1498,47,34
30 Veracruz de Ignacio de la Llave,32,032 Catemaco,Hombres,1544,1480,64,28
30 Veracruz de Ignacio de la Llave,32,032 Catemaco,Hombres,1393,1343,50,35
30 Veracruz de Ignacio de la Llave,32,032 Catemaco,Hombres,1192,1149,43,53
30 Veracruz de Ignacio de la Llave,32,032 Catemaco,Hombres,976,935,41,33
30 Veracruz de Ignacio de la Llave,32,032 Catemaco,Hombres,811,776,35,50
30 Veracruz de Ignacio de la Llave,32,032 Catemaco,Hombres,606,587,19,79
30 Veracruz de Ignacio de la Llave,32,032 Catemaco,Hombres,413,392,21,98
30 Veracruz de Ignacio de la Llave,32,032 Catemaco,Hombres,333,320,13,124
30 Veracruz de Ignacio de la Llave,32,032 Catemaco,Hombres,171,164,7,81
30 Veracruz de Ignacio de la Llave,32,032 Catemaco,Hombres,73,71,2,72
30 Veracruz de Ignacio de la Llave,32,032 Catemaco,Hombres,46,45,1,90
30 Veracruz de Ignacio de la Llave,32,032 Catemaco,Mujeres,4489,4400,89,14863
30 Veracruz de Ignacio de la Llave,32,032 Catemaco,Mujeres,37,34,3,1510
30 Veracruz de Ignacio de la Llave,32,032 Catemaco,Mujeres,253,242,11,2347
30 Veracruz de Ignacio de la Llave,32,032 Catemaco,Mujeres,561,538,23,1569
30 Veracruz de Ignacio de la Llave,32,032 Catemaco,Mujeres,611,589,22,1332
30 Veracruz de Ignacio de la Llave,32,032 Catemaco,Mujeres,659,648,11,1358
30 Veracruz de Ignacio de la Llave,32,032 Catemaco,Mujeres,639,633,6,1228
30 Veracruz de Ignacio de la Llave,32,032 Catemaco,Mujeres,486,480,6,1057
30 Veracruz de Ignacio de la Llave,32,032 Catemaco,Mujeres,417,415,2,930
30 Veracruz de Ignacio de la Llave,32,032 Catemaco,Mujeres,315,311,4,775
30 Veracruz de Ignacio de la Llave,32,032 Catemaco,Mujeres,217,217,0,687
30 Veracruz de Ignacio de la Llave,32,032 Catemaco,Mujeres,132,131,1,576
30 Veracruz de Ignacio de la Llave,32,032 Catemaco,Mujeres,75,75,0,472
30 Veracruz de Ignacio de la Llave,32,032 Catemaco,Mujeres,61,61,0,458
30 Veracruz de Ignacio de la Llave,32,032 Catemaco,Mujeres,13,13,0,246
30 Veracruz de Ignacio de la Llave,32,032 Catemaco,Mujeres,8,8,0,154
30 Veracruz de Ignacio de la Llave,32,032 Catemaco,Mujeres,5,5,0,164
30 Veracruz de Ignacio de la Llave,33,033 Cazones de Herrera,Total,7910,7585,325,9974
30 Veracruz de Ignacio de la Llave,33,033 Cazones de Herrera,Total,47,43,4,1537
30 Veracruz de Ignacio de la Llave,33,033 Cazones de Herrera,Total,537,502,35,2079
30 Veracruz de Ignacio de la Llave,33,033 Cazones de Herrera,Total,986,927,59,820
30 Veracruz de Ignacio de la Llave,33,033 Cazones de Herrera,Total,832,803,29,595
30 Veracruz de Ignacio de la Llave,33,033 Cazones de Herrera,Total,808,783,25,639
30 Veracruz de Ignacio de la Llave,33,033 Cazones de Herrera,Total,896,860,36,676
30 Veracruz de Ignacio de la Llave,33,033 Cazones de Herrera,Total,840,816,24,607
30 Veracruz de Ignacio de la Llave,33,033 Cazones de Herrera,Total,758,731,27,531
30 Veracruz de Ignacio de la Llave,33,033 Cazones de Herrera,Total,603,576,27,475
30 Veracruz de Ignacio de la Llave,33,033 Cazones de Herrera,Total,453,426,27,480
30 Veracruz de Ignacio de la Llave,33,033 Cazones de Herrera,Total,439,428,11,376
30 Veracruz de Ignacio de la Llave,33,033 Cazones de Herrera,Total,312,304,8,342
30 Veracruz de Ignacio de la Llave,33,033 Cazones de Herrera,Total,188,180,8,320
30 Veracruz de Ignacio de la Llave,33,033 Cazones de Herrera,Total,119,116,3,188
30 Veracruz de Ignacio de la Llave,33,033 Cazones de Herrera,Total,49,48,1,127
30 Veracruz de Ignacio de la Llave,33,033 Cazones de Herrera,Total,43,42,1,182
30 Veracruz de Ignacio de la Llave,33,033 Cazones de Herrera,Hombres,6357,6058,299,2235
30 Veracruz de Ignacio de la Llave,33,033 Cazones de Herrera,Hombres,29,27,2,737
30 Veracruz de Ignacio de la Llave,33,033 Cazones de Herrera,Hombres,423,392,31,841
30 Veracruz de Ignacio de la Llave,33,033 Cazones de Herrera,Hombres,766,715,51,139
30 Veracruz de Ignacio de la Llave,33,033 Cazones de Herrera,Hombres,639,614,25,27
30 Veracruz de Ignacio de la Llave,33,033 Cazones de Herrera,Hombres,633,610,23,17
30 Veracruz de Ignacio de la Llave,33,033 Cazones de Herrera,Hombres,688,654,34,33
30 Veracruz de Ignacio de la Llave,33,033 Cazones de Herrera,Hombres,668,645,23,31
30 Veracruz de Ignacio de la Llave,33,033 Cazones de Herrera,Hombres,600,575,25,20
30 Veracruz de Ignacio de la Llave,33,033 Cazones de Herrera,Hombres,495,468,27,30
30 Veracruz de Ignacio de la Llave,33,033 Cazones de Herrera,Hombres,390,363,27,45
30 Veracruz de Ignacio de la Llave,33,033 Cazones de Herrera,Hombres,379,368,11,42
30 Veracruz de Ignacio de la Llave,33,033 Cazones de Herrera,Hombres,281,273,8,49
30 Veracruz de Ignacio de la Llave,33,033 Cazones de Herrera,Hombres,170,163,7,66
30 Veracruz de Ignacio de la Llave,33,033 Cazones de Herrera,Hombres,109,106,3,43
30 Veracruz de Ignacio de la Llave,33,033 Cazones de Herrera,Hombres,46,45,1,44
30 Veracruz de Ignacio de la Llave,33,033 Cazones de Herrera,Hombres,41,40,1,71
30 Veracruz de Ignacio de la Llave,33,033 Cazones de Herrera,Mujeres,1553,1527,26,7739
30 Veracruz de Ignacio de la Llave,33,033 Cazones de Herrera,Mujeres,18,16,2,800
30 Veracruz de Ignacio de la Llave,33,033 Cazones de Herrera,Mujeres,114,110,4,1238
30 Veracruz de Ignacio de la Llave,33,033 Cazones de Herrera,Mujeres,220,212,8,681
30 Veracruz de Ignacio de la Llave,33,033 Cazones de Herrera,Mujeres,193,189,4,568
30 Veracruz de Ignacio de la Llave,33,033 Cazones de Herrera,Mujeres,175,173,2,622
30 Veracruz de Ignacio de la Llave,33,033 Cazones de Herrera,Mujeres,208,206,2,643
30 Veracruz de Ignacio de la Llave,33,033 Cazones de Herrera,Mujeres,172,171,1,576
30 Veracruz de Ignacio de la Llave,33,033 Cazones de Herrera,Mujeres,158,156,2,511
30 Veracruz de Ignacio de la Llave,33,033 Cazones de Herrera,Mujeres,108,108,0,445
30 Veracruz de Ignacio de la Llave,33,033 Cazones de Herrera,Mujeres,63,63,0,435
30 Veracruz de Ignacio de la Llave,33,033 Cazones de Herrera,Mujeres,60,60,0,334
30 Veracruz de Ignacio de la Llave,33,033 Cazones de Herrera,Mujeres,31,31,0,293
30 Veracruz de Ignacio de la Llave,33,033 Cazones de Herrera,Mujeres,18,17,1,254
30 Veracruz de Ignacio de la Llave,33,033 Cazones de Herrera,Mujeres,10,10,0,145
30 Veracruz de Ignacio de la Llave,33,033 Cazones de Herrera,Mujeres,3,3,0,83
30 Veracruz de Ignacio de la Llave,33,033 Cazones de Herrera,Mujeres,2,2,0,111
30 Veracruz de Ignacio de la Llave,34,034 Cerro Azul,Total,9912,9381,531,10697
30 Veracruz de Ignacio de la Llave,34,034 Cerro Azul,Total,28,28,0,1275
30 Veracruz de Ignacio de la Llave,34,034 Cerro Azul,Total,398,355,43,1932
30 Veracruz de Ignacio de la Llave,34,034 Cerro Azul,Total,1051,919,132,1129
30 Veracruz de Ignacio de la Llave,34,034 Cerro Azul,Total,1204,1117,87,548
30 Veracruz de Ignacio de la Llave,34,034 Cerro Azul,Total,1055,1002,53,487
30 Veracruz de Ignacio de la Llave,34,034 Cerro Azul,Total,1161,1113,48,533
30 Veracruz de Ignacio de la Llave,34,034 Cerro Azul,Total,1236,1208,28,532
30 Veracruz de Ignacio de la Llave,34,034 Cerro Azul,Total,1150,1114,36,487
30 Veracruz de Ignacio de la Llave,34,034 Cerro Azul,Total,903,872,31,507
30 Veracruz de Ignacio de la Llave,34,034 Cerro Azul,Total,600,579,21,556
30 Veracruz de Ignacio de la Llave,34,034 Cerro Azul,Total,433,422,11,662
30 Veracruz de Ignacio de la Llave,34,034 Cerro Azul,Total,326,309,17,597
30 Veracruz de Ignacio de la Llave,34,034 Cerro Azul,Total,212,197,15,571
30 Veracruz de Ignacio de la Llave,34,034 Cerro Azul,Total,98,92,6,394
30 Veracruz de Ignacio de la Llave,34,034 Cerro Azul,Total,35,34,1,258
30 Veracruz de Ignacio de la Llave,34,034 Cerro Azul,Total,22,20,2,229
30 Veracruz de Ignacio de la Llave,34,034 Cerro Azul,Hombres,6412,5994,418,3135
30 Veracruz de Ignacio de la Llave,34,034 Cerro Azul,Hombres,23,23,0,644
30 Veracruz de Ignacio de la Llave,34,034 Cerro Azul,Hombres,287,250,37,880
30 Veracruz de Ignacio de la Llave,34,034 Cerro Azul,Hombres,678,587,91,383
30 Veracruz de Ignacio de la Llave,34,034 Cerro Azul,Hombres,760,707,53,63
30 Veracruz de Ignacio de la Llave,34,034 Cerro Azul,Hombres,660,619,41,21
30 Veracruz de Ignacio de la Llave,34,034 Cerro Azul,Hombres,735,693,42,28
30 Veracruz de Ignacio de la Llave,34,034 Cerro Azul,Hombres,758,736,22,31
30 Veracruz de Ignacio de la Llave,34,034 Cerro Azul,Hombres,733,700,33,32
30 Veracruz de Ignacio de la Llave,34,034 Cerro Azul,Hombres,578,550,28,64
30 Veracruz de Ignacio de la Llave,34,034 Cerro Azul,Hombres,395,374,21,110
30 Veracruz de Ignacio de la Llave,34,034 Cerro Azul,Hombres,282,273,9,183
30 Veracruz de Ignacio de la Llave,34,034 Cerro Azul,Hombres,240,223,17,182
30 Veracruz de Ignacio de la Llave,34,034 Cerro Azul,Hombres,155,140,15,186
30 Veracruz de Ignacio de la Llave,34,034 Cerro Azul,Hombres,84,78,6,140
30 Veracruz de Ignacio de la Llave,34,034 Cerro Azul,Hombres,25,24,1,104
30 Veracruz de Ignacio de la Llave,34,034 Cerro Azul,Hombres,19,17,2,84
30 Veracruz de Ignacio de la Llave,34,034 Cerro Azul,Mujeres,3500,3387,113,7562
30 Veracruz de Ignacio de la Llave,34,034 Cerro Azul,Mujeres,5,5,0,631
30 Veracruz de Ignacio de la Llave,34,034 Cerro Azul,Mujeres,111,105,6,1052
30 Veracruz de Ignacio de la Llave,34,034 Cerro Azul,Mujeres,373,332,41,746
30 Veracruz de Ignacio de la Llave,34,034 Cerro Azul,Mujeres,444,410,34,485
30 Veracruz de Ignacio de la Llave,34,034 Cerro Azul,Mujeres,395,383,12,466
30 Veracruz de Ignacio de la Llave,34,034 Cerro Azul,Mujeres,426,420,6,505
30 Veracruz de Ignacio de la Llave,34,034 Cerro Azul,Mujeres,478,472,6,501
30 Veracruz de Ignacio de la Llave,34,034 Cerro Azul,Mujeres,417,414,3,455
30 Veracruz de Ignacio de la Llave,34,034 Cerro Azul,Mujeres,325,322,3,443
30 Veracruz de Ignacio de la Llave,34,034 Cerro Azul,Mujeres,205,205,0,446
30 Veracruz de Ignacio de la Llave,34,034 Cerro Azul,Mujeres,151,149,2,479
30 Veracruz de Ignacio de la Llave,34,034 Cerro Azul,Mujeres,86,86,0,415
30 Veracruz de Ignacio de la Llave,34,034 Cerro Azul,Mujeres,57,57,0,385
30 Veracruz de Ignacio de la Llave,34,034 Cerro Azul,Mujeres,14,14,0,254
30 Veracruz de Ignacio de la Llave,34,034 Cerro Azul,Mujeres,10,10,0,154
30 Veracruz de Ignacio de la Llave,34,034 Cerro Azul,Mujeres,3,3,0,145
30 Veracruz de Ignacio de la Llave,54,054 Chacaltianguis,Total,3929,3831,98,5385
30 Veracruz de Ignacio de la Llave,54,054 Chacaltianguis,Total,24,23,1,596
30 Veracruz de Ignacio de la Llave,54,054 Chacaltianguis,Total,230,216,14,817
30 Veracruz de Ignacio de la Llave,54,054 Chacaltianguis,Total,393,378,15,442
30 Veracruz de Ignacio de la Llave,54,054 Chacaltianguis,Total,377,367,10,337
30 Veracruz de Ignacio de la Llave,54,054 Chacaltianguis,Total,424,415,9,352
30 Veracruz de Ignacio de la Llave,54,054 Chacaltianguis,Total,527,513,14,394
30 Veracruz de Ignacio de la Llave,54,054 Chacaltianguis,Total,499,487,12,290
30 Veracruz de Ignacio de la Llave,54,054 Chacaltianguis,Total,377,373,4,292
30 Veracruz de Ignacio de la Llave,54,054 Chacaltianguis,Total,336,328,8,287
30 Veracruz de Ignacio de la Llave,54,054 Chacaltianguis,Total,306,300,6,271
30 Veracruz de Ignacio de la Llave,54,054 Chacaltianguis,Total,195,192,3,294
30 Veracruz de Ignacio de la Llave,54,054 Chacaltianguis,Total,103,102,1,261
30 Veracruz de Ignacio de la Llave,54,054 Chacaltianguis,Total,71,70,1,271
30 Veracruz de Ignacio de la Llave,54,054 Chacaltianguis,Total,40,40,0,190
30 Veracruz de Ignacio de la Llave,54,054 Chacaltianguis,Total,17,17,0,140
30 Veracruz de Ignacio de la Llave,54,054 Chacaltianguis,Total,10,10,0,151
30 Veracruz de Ignacio de la Llave,54,054 Chacaltianguis,Hombres,3180,3095,85,1308
30 Veracruz de Ignacio de la Llave,54,054 Chacaltianguis,Hombres,23,22,1,284
30 Veracruz de Ignacio de la Llave,54,054 Chacaltianguis,Hombres,191,180,11,326
30 Veracruz de Ignacio de la Llave,54,054 Chacaltianguis,Hombres,320,309,11,76
30 Veracruz de Ignacio de la Llave,54,054 Chacaltianguis,Hombres,293,285,8,19
30 Veracruz de Ignacio de la Llave,54,054 Chacaltianguis,Hombres,342,335,7,15
30 Veracruz de Ignacio de la Llave,54,054 Chacaltianguis,Hombres,418,405,13,13
30 Veracruz de Ignacio de la Llave,54,054 Chacaltianguis,Hombres,392,380,12,5
30 Veracruz de Ignacio de la Llave,54,054 Chacaltianguis,Hombres,283,280,3,23
30 Veracruz de Ignacio de la Llave,54,054 Chacaltianguis,Hombres,262,254,8,22
30 Veracruz de Ignacio de la Llave,54,054 Chacaltianguis,Hombres,264,258,6,26
30 Veracruz de Ignacio de la Llave,54,054 Chacaltianguis,Hombres,172,169,3,99
30 Veracruz de Ignacio de la Llave,54,054 Chacaltianguis,Hombres,93,92,1,89
30 Veracruz de Ignacio de la Llave,54,054 Chacaltianguis,Hombres,63,62,1,93
30 Veracruz de Ignacio de la Llave,54,054 Chacaltianguis,Hombres,37,37,0,80
30 Veracruz de Ignacio de la Llave,54,054 Chacaltianguis,Hombres,17,17,0,59
30 Veracruz de Ignacio de la Llave,54,054 Chacaltianguis,Hombres,10,10,0,79
30 Veracruz de Ignacio de la Llave,54,054 Chacaltianguis,Mujeres,749,736,13,4077
30 Veracruz de Ignacio de la Llave,54,054 Chacaltianguis,Mujeres,1,1,0,312
30 Veracruz de Ignacio de la Llave,54,054 Chacaltianguis,Mujeres,39,36,3,491
30 Veracruz de Ignacio de la Llave,54,054 Chacaltianguis,Mujeres,73,69,4,366
30 Veracruz de Ignacio de la Llave,54,054 Chacaltianguis,Mujeres,84,82,2,318
30 Veracruz de Ignacio de la Llave,54,054 Chacaltianguis,Mujeres,82,80,2,337
30 Veracruz de Ignacio de la Llave,54,054 Chacaltianguis,Mujeres,109,108,1,381
30 Veracruz de Ignacio de la Llave,54,054 Chacaltianguis,Mujeres,107,107,0,285
30 Veracruz de Ignacio de la Llave,54,054 Chacaltianguis,Mujeres,94,93,1,269
30 Veracruz de Ignacio de la Llave,54,054 Chacaltianguis,Mujeres,74,74,0,265
30 Veracruz de Ignacio de la Llave,54,054 Chacaltianguis,Mujeres,42,42,0,245
30 Veracruz de Ignacio de la Llave,54,054 Chacaltianguis,Mujeres,23,23,0,195
30 Veracruz de Ignacio de la Llave,54,054 Chacaltianguis,Mujeres,10,10,0,172
30 Veracruz de Ignacio de la Llave,54,054 Chacaltianguis,Mujeres,8,8,0,178
30 Veracruz de Ignacio de la Llave,54,054 Chacaltianguis,Mujeres,3,3,0,110
30 Veracruz de Ignacio de la Llave,54,054 Chacaltianguis,Mujeres,0,0,0,81
30 Veracruz de Ignacio de la Llave,54,054 Chacaltianguis,Mujeres,0,0,0,72
30 Veracruz de Ignacio de la Llave,55,055 Chalma,Total,4231,4146,85,5502
30 Veracruz de Ignacio de la Llave,55,055 Chalma,Total,14,11,3,781
30 Veracruz de Ignacio de la Llave,55,055 Chalma,Total,228,210,18,1076
30 Veracruz de Ignacio de la Llave,55,055 Chalma,Total,446,425,21,442
30 Veracruz de Ignacio de la Llave,55,055 Chalma,Total,459,449,10,309
30 Veracruz de Ignacio de la Llave,55,055 Chalma,Total,464,455,9,314
30 Veracruz de Ignacio de la Llave,55,055 Chalma,Total,468,461,7,300
30 Veracruz de Ignacio de la Llave,55,055 Chalma,Total,457,451,6,330
30 Veracruz de Ignacio de la Llave,55,055 Chalma,Total,344,341,3,297
30 Veracruz de Ignacio de la Llave,55,055 Chalma,Total,332,329,3,312
30 Veracruz de Ignacio de la Llave,55,055 Chalma,Total,272,270,2,280
30 Veracruz de Ignacio de la Llave,55,055 Chalma,Total,254,254,0,262
30 Veracruz de Ignacio de la Llave,55,055 Chalma,Total,190,189,1,214
30 Veracruz de Ignacio de la Llave,55,055 Chalma,Total,169,168,1,253
30 Veracruz de Ignacio de la Llave,55,055 Chalma,Total,69,68,1,137
30 Veracruz de Ignacio de la Llave,55,055 Chalma,Total,37,37,0,101
30 Veracruz de Ignacio de la Llave,55,055 Chalma,Total,28,28,0,94
30 Veracruz de Ignacio de la Llave,55,055 Chalma,Hombres,3372,3305,67,1365
30 Veracruz de Ignacio de la Llave,55,055 Chalma,Hombres,7,6,1,402
30 Veracruz de Ignacio de la Llave,55,055 Chalma,Hombres,167,153,14,526
30 Veracruz de Ignacio de la Llave,55,055 Chalma,Hombres,321,304,17,122
30 Veracruz de Ignacio de la Llave,55,055 Chalma,Hombres,328,321,7,18
30 Veracruz de Ignacio de la Llave,55,055 Chalma,Hombres,346,338,8,14
30 Veracruz de Ignacio de la Llave,55,055 Chalma,Hombres,360,354,6,13
30 Veracruz de Ignacio de la Llave,55,055 Chalma,Hombres,368,363,5,13
30 Veracruz de Ignacio de la Llave,55,055 Chalma,Hombres,270,268,2,7
30 Veracruz de Ignacio de la Llave,55,055 Chalma,Hombres,287,284,3,18
30 Veracruz de Ignacio de la Llave,55,055 Chalma,Hombres,240,238,2,15
30 Veracruz de Ignacio de la Llave,55,055 Chalma,Hombres,232,232,0,32
30 Veracruz de Ignacio de la Llave,55,055 Chalma,Hombres,170,169,1,31
30 Veracruz de Ignacio de la Llave,55,055 Chalma,Hombres,153,153,0,51
30 Veracruz de Ignacio de la Llave,55,055 Chalma,Hombres,64,63,1,38
30 Veracruz de Ignacio de la Llave,55,055 Chalma,Hombres,33,33,0,27
30 Veracruz de Ignacio de la Llave,55,055 Chalma,Hombres,26,26,0,38
30 Veracruz de Ignacio de la Llave,55,055 Chalma,Mujeres,859,841,18,4137
30 Veracruz de Ignacio de la Llave,55,055 Chalma,Mujeres,7,5,2,379
30 Veracruz de Ignacio de la Llave,55,055 Chalma,Mujeres,61,57,4,550
30 Veracruz de Ignacio de la Llave,55,055 Chalma,Mujeres,125,121,4,320
30 Veracruz de Ignacio de la Llave,55,055 Chalma,Mujeres,131,128,3,291
30 Veracruz de Ignacio de la Llave,55,055 Chalma,Mujeres,118,117,1,300
30 Veracruz de Ignacio de la Llave,55,055 Chalma,Mujeres,108,107,1,287
30 Veracruz de Ignacio de la Llave,55,055 Chalma,Mujeres,89,88,1,317
30 Veracruz de Ignacio de la Llave,55,055 Chalma,Mujeres,74,73,1,290
30 Veracruz de Ignacio de la Llave,55,055 Chalma,Mujeres,45,45,0,294
30 Veracruz de Ignacio de la Llave,55,055 Chalma,Mujeres,32,32,0,265
30 Veracruz de Ignacio de la Llave,55,055 Chalma,Mujeres,22,22,0,230
30 Veracruz de Ignacio de la Llave,55,055 Chalma,Mujeres,20,20,0,183
30 Veracruz de Ignacio de la Llave,55,055 Chalma,Mujeres,16,15,1,202
30 Veracruz de Ignacio de la Llave,55,055 Chalma,Mujeres,5,5,0,99
30 Veracruz de Ignacio de la Llave,55,055 Chalma,Mujeres,4,4,0,74
30 Veracruz de Ignacio de la Llave,55,055 Chalma,Mujeres,2,2,0,56
30 Veracruz de Ignacio de la Llave,56,056 Chiconamel,Total,1981,1937,44,2967
30 Veracruz de Ignacio de la Llave,56,056 Chiconamel,Total,9,8,1,519
30 Veracruz de Ignacio de la Llave,56,056 Chiconamel,Total,148,141,7,592
30 Veracruz de Ignacio de la Llave,56,056 Chiconamel,Total,191,182,9,205
30 Veracruz de Ignacio de la Llave,56,056 Chiconamel,Total,200,191,9,159
30 Veracruz de Ignacio de la Llave,56,056 Chiconamel,Total,206,201,5,187
30 Veracruz de Ignacio de la Llave,56,056 Chiconamel,Total,219,213,6,180
30 Veracruz de Ignacio de la Llave,56,056 Chiconamel,Total,200,196,4,163
30 Veracruz de Ignacio de la Llave,56,056 Chiconamel,Total,190,190,0,160
30 Veracruz de Ignacio de la Llave,56,056 Chiconamel,Total,153,152,1,145
30 Veracruz de Ignacio de la Llave,56,056 Chiconamel,Total,127,126,1,157
30 Veracruz de Ignacio de la Llave,56,056 Chiconamel,Total,108,107,1,140
30 Veracruz de Ignacio de la Llave,56,056 Chiconamel,Total,78,78,0,105
30 Veracruz de Ignacio de la Llave,56,056 Chiconamel,Total,86,86,0,97
30 Veracruz de Ignacio de la Llave,56,056 Chiconamel,Total,40,40,0,68
30 Veracruz de Ignacio de la Llave,56,056 Chiconamel,Total,19,19,0,43
30 Veracruz de Ignacio de la Llave,56,056 Chiconamel,Total,7,7,0,47
30 Veracruz de Ignacio de la Llave,56,056 Chiconamel,Hombres,1665,1636,29,741
30 Veracruz de Ignacio de la Llave,56,056 Chiconamel,Hombres,4,3,1,256
30 Veracruz de Ignacio de la Llave,56,056 Chiconamel,Hombres,108,106,2,295
30 Veracruz de Ignacio de la Llave,56,056 Chiconamel,Hombres,152,146,6,40
30 Veracruz de Ignacio de la Llave,56,056 Chiconamel,Hombres,155,149,6,10
30 Veracruz de Ignacio de la Llave,56,056 Chiconamel,Hombres,172,168,4,7
30 Veracruz de Ignacio de la Llave,56,056 Chiconamel,Hombres,174,171,3,8
30 Veracruz de Ignacio de la Llave,56,056 Chiconamel,Hombres,172,168,4,6
30 Veracruz de Ignacio de la Llave,56,056 Chiconamel,Hombres,168,168,0,2
30 Veracruz de Ignacio de la Llave,56,056 Chiconamel,Hombres,135,134,1,4
30 Veracruz de Ignacio de la Llave,56,056 Chiconamel,Hombres,116,115,1,13
30 Veracruz de Ignacio de la Llave,56,056 Chiconamel,Hombres,98,97,1,15
30 Veracruz de Ignacio de la Llave,56,056 Chiconamel,Hombres,71,71,0,14
30 Veracruz de Ignacio de la Llave,56,056 Chiconamel,Hombres,79,79,0,19
30 Veracruz de Ignacio de la Llave,56,056 Chiconamel,Hombres,36,36,0,20
30 Veracruz de Ignacio de la Llave,56,056 Chiconamel,Hombres,19,19,0,13
30 Veracruz de Ignacio de la Llave,56,056 Chiconamel,Hombres,6,6,0,19
30 Veracruz de Ignacio de la Llave,56,056 Chiconamel,Mujeres,316,301,15,2226
30 Veracruz de Ignacio de la Llave,56,056 Chiconamel,Mujeres,5,5,0,263
30 Veracruz de Ignacio de la Llave,56,056 Chiconamel,Mujeres,40,35,5,297
30 Veracruz de Ignacio de la Llave,56,056 Chiconamel,Mujeres,39,36,3,165
30 Veracruz de Ignacio de la Llave,56,056 Chiconamel,Mujeres,45,42,3,149
30 Veracruz de Ignacio de la Llave,56,056 Chiconamel,Mujeres,34,33,1,180
30 Veracruz de Ignacio de la Llave,56,056 Chiconamel,Mujeres,45,42,3,172
30 Veracruz de Ignacio de la Llave,56,056 Chiconamel,Mujeres,28,28,0,157
30 Veracruz de Ignacio de la Llave,56,056 Chiconamel,Mujeres,22,22,0,158
30 Veracruz de Ignacio de la Llave,56,056 Chiconamel,Mujeres,18,18,0,141
30 Veracruz de Ignacio de la Llave,56,056 Chiconamel,Mujeres,11,11,0,144
30 Veracruz de Ignacio de la Llave,56,056 Chiconamel,Mujeres,10,10,0,125
30 Veracruz de Ignacio de la Llave,56,056 Chiconamel,Mujeres,7,7,0,91
30 Veracruz de Ignacio de la Llave,56,056 Chiconamel,Mujeres,7,7,0,78
30 Veracruz de Ignacio de la Llave,56,056 Chiconamel,Mujeres,4,4,0,48
30 Veracruz de Ignacio de la Llave,56,056 Chiconamel,Mujeres,0,0,0,30
30 Veracruz de Ignacio de la Llave,56,056 Chiconamel,Mujeres,1,1,0,28
30 Veracruz de Ignacio de la Llave,57,057 Chiconquiaco,Total,4527,4468,59,4873
30 Veracruz de Ignacio de la Llave,57,057 Chiconquiaco,Total,345,345,0,651
30 Veracruz de Ignacio de la Llave,57,057 Chiconquiaco,Total,718,710,8,827
30 Veracruz de Ignacio de la Llave,57,057 Chiconquiaco,Total,579,566,13,466
30 Veracruz de Ignacio de la Llave,57,057 Chiconquiaco,Total,405,399,6,419
30 Veracruz de Ignacio de la Llave,57,057 Chiconquiaco,Total,422,415,7,405
30 Veracruz de Ignacio de la Llave,57,057 Chiconquiaco,Total,468,460,8,422
30 Veracruz de Ignacio de la Llave,57,057 Chiconquiaco,Total,364,361,3,295
30 Veracruz de Ignacio de la Llave,57,057 Chiconquiaco,Total,294,292,2,260
30 Veracruz de Ignacio de la Llave,57,057 Chiconquiaco,Total,244,239,5,238
30 Veracruz de Ignacio de la Llave,57,057 Chiconquiaco,Total,215,212,3,198
30 Veracruz de Ignacio de la Llave,57,057 Chiconquiaco,Total,168,166,2,171
30 Veracruz de Ignacio de la Llave,57,057 Chiconquiaco,Total,100,99,1,149
30 Veracruz de Ignacio de la Llave,57,057 Chiconquiaco,Total,96,96,0,140
30 Veracruz de Ignacio de la Llave,57,057 Chiconquiaco,Total,53,52,1,91
30 Veracruz de Ignacio de la Llave,57,057 Chiconquiaco,Total,33,33,0,62
30 Veracruz de Ignacio de la Llave,57,057 Chiconquiaco,Total,23,23,0,79
30 Veracruz de Ignacio de la Llave,57,057 Chiconquiaco,Hombres,3788,3733,55,823
30 Veracruz de Ignacio de la Llave,57,057 Chiconquiaco,Hombres,226,226,0,289
30 Veracruz de Ignacio de la Llave,57,057 Chiconquiaco,Hombres,533,526,7,238
30 Veracruz de Ignacio de la Llave,57,057 Chiconquiaco,Hombres,467,455,12,44
30 Veracruz de Ignacio de la Llave,57,057 Chiconquiaco,Hombres,346,341,5,24
30 Veracruz de Ignacio de la Llave,57,057 Chiconquiaco,Hombres,368,362,6,14
30 Veracruz de Ignacio de la Llave,57,057 Chiconquiaco,Hombres,413,405,8,24
30 Veracruz de Ignacio de la Llave,57,057 Chiconquiaco,Hombres,318,315,3,18
30 Veracruz de Ignacio de la Llave,57,057 Chiconquiaco,Hombres,259,257,2,20
30 Veracruz de Ignacio de la Llave,57,057 Chiconquiaco,Hombres,225,220,5,19
30 Veracruz de Ignacio de la Llave,57,057 Chiconquiaco,Hombres,197,194,3,15
30 Veracruz de Ignacio de la Llave,57,057 Chiconquiaco,Hombres,152,150,2,11
30 Veracruz de Ignacio de la Llave,57,057 Chiconquiaco,Hombres,95,94,1,24
30 Veracruz de Ignacio de la Llave,57,057 Chiconquiaco,Hombres,86,86,0,18
30 Veracruz de Ignacio de la Llave,57,057 Chiconquiaco,Hombres,50,49,1,23
30 Veracruz de Ignacio de la Llave,57,057 Chiconquiaco,Hombres,32,32,0,17
30 Veracruz de Ignacio de la Llave,57,057 Chiconquiaco,Hombres,21,21,0,25
30 Veracruz de Ignacio de la Llave,57,057 Chiconquiaco,Mujeres,739,735,4,4050
30 Veracruz de Ignacio de la Llave,57,057 Chiconquiaco,Mujeres,119,119,0,362
30 Veracruz de Ignacio de la Llave,57,057 Chiconquiaco,Mujeres,185,184,1,589
30 Veracruz de Ignacio de la Llave,57,057 Chiconquiaco,Mujeres,112,111,1,422
30 Veracruz de Ignacio de la Llave,57,057 Chiconquiaco,Mujeres,59,58,1,395
30 Veracruz de Ignacio de la Llave,57,057 Chiconquiaco,Mujeres,54,53,1,391
30 Veracruz de Ignacio de la Llave,57,057 Chiconquiaco,Mujeres,55,55,0,398
30 Veracruz de Ignacio de la Llave,57,057 Chiconquiaco,Mujeres,46,46,0,277
30 Veracruz de Ignacio de la Llave,57,057 Chiconquiaco,Mujeres,35,35,0,240
30 Veracruz de Ignacio de la Llave,57,057 Chiconquiaco,Mujeres,19,19,0,219
30 Veracruz de Ignacio de la Llave,57,057 Chiconquiaco,Mujeres,18,18,0,183
30 Veracruz de Ignacio de la Llave,57,057 Chiconquiaco,Mujeres,16,16,0,160
30 Veracruz de Ignacio de la Llave,57,057 Chiconquiaco,Mujeres,5,5,0,125
30 Veracruz de Ignacio de la Llave,57,057 Chiconquiaco,Mujeres,10,10,0,122
30 Veracruz de Ignacio de la Llave,57,057 Chiconquiaco,Mujeres,3,3,0,68
30 Veracruz de Ignacio de la Llave,57,057 Chiconquiaco,Mujeres,1,1,0,45
30 Veracruz de Ignacio de la Llave,57,057 Chiconquiaco,Mujeres,2,2,0,54
30 Veracruz de Ignacio de la Llave,58,058 Chicontepec,Total,17757,17616,141,25738
30 Veracruz de Ignacio de la Llave,58,058 Chicontepec,Total,125,123,2,3659
30 Veracruz de Ignacio de la Llave,58,058 Chicontepec,Total,1048,1032,16,5311
30 Veracruz de Ignacio de la Llave,58,058 Chicontepec,Total,1673,1631,42,1908
30 Veracruz de Ignacio de la Llave,58,058 Chicontepec,Total,1558,1537,21,1245
30 Veracruz de Ignacio de la Llave,58,058 Chicontepec,Total,1615,1599,16,1294
30 Veracruz de Ignacio de la Llave,58,058 Chicontepec,Total,1826,1819,7,1364
30 Veracruz de Ignacio de la Llave,58,058 Chicontepec,Total,1857,1847,10,1518
30 Veracruz de Ignacio de la Llave,58,058 Chicontepec,Total,1674,1664,10,1453
30 Veracruz de Ignacio de la Llave,58,058 Chicontepec,Total,1402,1396,6,1545
30 Veracruz de Ignacio de la Llave,58,058 Chicontepec,Total,1254,1249,5,1442
30 Veracruz de Ignacio de la Llave,58,058 Chicontepec,Total,1155,1152,3,1301
30 Veracruz de Ignacio de la Llave,58,058 Chicontepec,Total,1017,1015,2,1195
30 Veracruz de Ignacio de la Llave,58,058 Chicontepec,Total,755,754,1,1044
30 Veracruz de Ignacio de la Llave,58,058 Chicontepec,Total,416,416,0,601
30 Veracruz de Ignacio de la Llave,58,058 Chicontepec,Total,189,189,0,396
30 Veracruz de Ignacio de la Llave,58,058 Chicontepec,Total,193,193,0,462
30 Veracruz de Ignacio de la Llave,58,058 Chicontepec,Hombres,15266,15161,105,5571
30 Veracruz de Ignacio de la Llave,58,058 Chicontepec,Hombres,107,106,1,1767
30 Veracruz de Ignacio de la Llave,58,058 Chicontepec,Hombres,861,852,9,2358
30 Veracruz de Ignacio de la Llave,58,058 Chicontepec,Hombres,1290,1267,23,434
30 Veracruz de Ignacio de la Llave,58,058 Chicontepec,Hombres,1267,1251,16,62
30 Veracruz de Ignacio de la Llave,58,058 Chicontepec,Hombres,1324,1310,14,36
30 Veracruz de Ignacio de la Llave,58,058 Chicontepec,Hombres,1500,1493,7,48
30 Veracruz de Ignacio de la Llave,58,058 Chicontepec,Hombres,1545,1535,10,48
30 Veracruz de Ignacio de la Llave,58,058 Chicontepec,Hombres,1421,1412,9,43
30 Veracruz de Ignacio de la Llave,58,058 Chicontepec,Hombres,1256,1250,6,70
30 Veracruz de Ignacio de la Llave,58,058 Chicontepec,Hombres,1153,1148,5,93
30 Veracruz de Ignacio de la Llave,58,058 Chicontepec,Hombres,1085,1082,3,98
30 Veracruz de Ignacio de la Llave,58,058 Chicontepec,Hombres,971,969,2,97
30 Veracruz de Ignacio de la Llave,58,058 Chicontepec,Hombres,721,721,0,120
30 Veracruz de Ignacio de la Llave,58,058 Chicontepec,Hombres,399,399,0,99
30 Veracruz de Ignacio de la Llave,58,058 Chicontepec,Hombres,180,180,0,82
30 Veracruz de Ignacio de la Llave,58,058 Chicontepec,Hombres,186,186,0,116
30 Veracruz de Ignacio de la Llave,58,058 Chicontepec,Mujeres,2491,2455,36,20167
30 Veracruz de Ignacio de la Llave,58,058 Chicontepec,Mujeres,18,17,1,1892
30 Veracruz de Ignacio de la Llave,58,058 Chicontepec,Mujeres,187,180,7,2953
30 Veracruz de Ignacio de la Llave,58,058 Chicontepec,Mujeres,383,364,19,1474
30 Veracruz de Ignacio de la Llave,58,058 Chicontepec,Mujeres,291,286,5,1183
30 Veracruz de Ignacio de la Llave,58,058 Chicontepec,Mujeres,291,289,2,1258
30 Veracruz de Ignacio de la Llave,58,058 Chicontepec,Mujeres,326,326,0,1316
30 Veracruz de Ignacio de la Llave,58,058 Chicontepec,Mujeres,312,312,0,1470
30 Veracruz de Ignacio de la Llave,58,058 Chicontepec,Mujeres,253,252,1,1410
30 Veracruz de Ignacio de la Llave,58,058 Chicontepec,Mujeres,146,146,0,1475
30 Veracruz de Ignacio de la Llave,58,058 Chicontepec,Mujeres,101,101,0,1349
30 Veracruz de Ignacio de la Llave,58,058 Chicontepec,Mujeres,70,70,0,1203
30 Veracruz de Ignacio de la Llave,58,058 Chicontepec,Mujeres,46,46,0,1098
30 Veracruz de Ignacio de la Llave,58,058 Chicontepec,Mujeres,34,33,1,924
30 Veracruz de Ignacio de la Llave,58,058 Chicontepec,Mujeres,17,17,0,502
30 Veracruz de Ignacio de la Llave,58,058 Chicontepec,Mujeres,9,9,0,314
30 Veracruz de Ignacio de la Llave,58,058 Chicontepec,Mujeres,7,7,0,346
30 Veracruz de Ignacio de la Llave,59,059 Chinameca,Total,6049,5707,342,5987
30 Veracruz de Ignacio de la Llave,59,059 Chinameca,Total,28,28,0,770
30 Veracruz de Ignacio de la Llave,59,059 Chinameca,Total,379,344,35,1169
30 Veracruz de Ignacio de la Llave,59,059 Chinameca,Total,803,737,66,638
30 Veracruz de Ignacio de la Llave,59,059 Chinameca,Total,790,749,41,432
30 Veracruz de Ignacio de la Llave,59,059 Chinameca,Total,738,707,31,446
30 Veracruz de Ignacio de la Llave,59,059 Chinameca,Total,739,707,32,401
30 Veracruz de Ignacio de la Llave,59,059 Chinameca,Total,660,633,27,369
30 Veracruz de Ignacio de la Llave,59,059 Chinameca,Total,556,524,32,328
30 Veracruz de Ignacio de la Llave,59,059 Chinameca,Total,447,418,29,294
30 Veracruz de Ignacio de la Llave,59,059 Chinameca,Total,358,335,23,272
30 Veracruz de Ignacio de la Llave,59,059 Chinameca,Total,206,195,11,196
30 Veracruz de Ignacio de la Llave,59,059 Chinameca,Total,136,130,6,184
30 Veracruz de Ignacio de la Llave,59,059 Chinameca,Total,105,102,3,176
30 Veracruz de Ignacio de la Llave,59,059 Chinameca,Total,62,57,5,143
30 Veracruz de Ignacio de la Llave,59,059 Chinameca,Total,30,29,1,82
30 Veracruz de Ignacio de la Llave,59,059 Chinameca,Total,12,12,0,87
30 Veracruz de Ignacio de la Llave,59,059 Chinameca,Hombres,4398,4099,299,1379
30 Veracruz de Ignacio de la Llave,59,059 Chinameca,Hombres,18,18,0,353
30 Veracruz de Ignacio de la Llave,59,059 Chinameca,Hombres,296,266,30,468
30 Veracruz de Ignacio de la Llave,59,059 Chinameca,Hombres,576,524,52,132
30 Veracruz de Ignacio de la Llave,59,059 Chinameca,Hombres,553,524,29,36
30 Veracruz de Ignacio de la Llave,59,059 Chinameca,Hombres,511,482,29,12
30 Veracruz de Ignacio de la Llave,59,059 Chinameca,Hombres,510,479,31,19
30 Veracruz de Ignacio de la Llave,59,059 Chinameca,Hombres,473,450,23,13
30 Veracruz de Ignacio de la Llave,59,059 Chinameca,Hombres,395,364,31,28
30 Veracruz de Ignacio de la Llave,59,059 Chinameca,Hombres,343,316,27,23
30 Veracruz de Ignacio de la Llave,59,059 Chinameca,Hombres,269,246,23,42
30 Veracruz de Ignacio de la Llave,59,059 Chinameca,Hombres,161,150,11,38
30 Veracruz de Ignacio de la Llave,59,059 Chinameca,Hombres,113,107,6,51
30 Veracruz de Ignacio de la Llave,59,059 Chinameca,Hombres,89,87,2,45
30 Veracruz de Ignacio de la Llave,59,059 Chinameca,Hombres,52,48,4,50
30 Veracruz de Ignacio de la Llave,59,059 Chinameca,Hombres,27,26,1,32
30 Veracruz de Ignacio de la Llave,59,059 Chinameca,Hombres,12,12,0,37
30 Veracruz de Ignacio de la Llave,59,059 Chinameca,Mujeres,1651,1608,43,4608
30 Veracruz de Ignacio de la Llave,59,059 Chinameca,Mujeres,10,10,0,417
30 Veracruz de Ignacio de la Llave,59,059 Chinameca,Mujeres,83,78,5,701
30 Veracruz de Ignacio de la Llave,59,059 Chinameca,Mujeres,227,213,14,506
30 Veracruz de Ignacio de la Llave,59,059 Chinameca,Mujeres,237,225,12,396
30 Veracruz de Ignacio de la Llave,59,059 Chinameca,Mujeres,227,225,2,434
30 Veracruz de Ignacio de la Llave,59,059 Chinameca,Mujeres,229,228,1,382
30 Veracruz de Ignacio de la Llave,59,059 Chinameca,Mujeres,187,183,4,356
30 Veracruz de Ignacio de la Llave,59,059 Chinameca,Mujeres,161,160,1,300
30 Veracruz de Ignacio de la Llave,59,059 Chinameca,Mujeres,104,102,2,271
30 Veracruz de Ignacio de la Llave,59,059 Chinameca,Mujeres,89,89,0,230
30 Veracruz de Ignacio de la Llave,59,059 Chinameca,Mujeres,45,45,0,158
30 Veracruz de Ignacio de la Llave,59,059 Chinameca,Mujeres,23,23,0,133
30 Veracruz de Ignacio de la Llave,59,059 Chinameca,Mujeres,16,15,1,131
30 Veracruz de Ignacio de la Llave,59,059 Chinameca,Mujeres,10,9,1,93
30 Veracruz de Ignacio de la Llave,59,059 Chinameca,Mujeres,3,3,0,50
30 Veracruz de Ignacio de la Llave,59,059 Chinameca,Mujeres,0,0,0,50
30 Veracruz de Ignacio de la Llave,60,060 Chinampa de Gorostiza,Total,5413,5308,105,6099
30 Veracruz de Ignacio de la Llave,60,060 Chinampa de Gorostiza,Total,56,54,2,990
30 Veracruz de Ignacio de la Llave,60,060 Chinampa de Gorostiza,Total,448,428,20,1259
30 Veracruz de Ignacio de la Llave,60,060 Chinampa de Gorostiza,Total,676,654,22,528
30 Veracruz de Ignacio de la Llave,60,060 Chinampa de Gorostiza,Total,567,556,11,356
30 Veracruz de Ignacio de la Llave,60,060 Chinampa de Gorostiza,Total,558,547,11,317
30 Veracruz de Ignacio de la Llave,60,060 Chinampa de Gorostiza,Total,587,578,9,386
30 Veracruz de Ignacio de la Llave,60,060 Chinampa de Gorostiza,Total,615,608,7,364
30 Veracruz de Ignacio de la Llave,60,060 Chinampa de Gorostiza,Total,552,546,6,373
30 Veracruz de Ignacio de la Llave,60,060 Chinampa de Gorostiza,Total,370,364,6,265
30 Veracruz de Ignacio de la Llave,60,060 Chinampa de Gorostiza,Total,267,265,2,254
30 Veracruz de Ignacio de la Llave,60,060 Chinampa de Gorostiza,Total,236,232,4,236
30 Veracruz de Ignacio de la Llave,60,060 Chinampa de Gorostiza,Total,214,211,3,265
30 Veracruz de Ignacio de la Llave,60,060 Chinampa de Gorostiza,Total,155,153,2,187
30 Veracruz de Ignacio de la Llave,60,060 Chinampa de Gorostiza,Total,70,70,0,141
30 Veracruz de Ignacio de la Llave,60,060 Chinampa de Gorostiza,Total,26,26,0,91
30 Veracruz de Ignacio de la Llave,60,060 Chinampa de Gorostiza,Total,16,16,0,87
30 Veracruz de Ignacio de la Llave,60,060 Chinampa de Gorostiza,Hombres,4112,4027,85,1432
30 Veracruz de Ignacio de la Llave,60,060 Chinampa de Gorostiza,Hombres,41,39,2,467
30 Veracruz de Ignacio de la Llave,60,060 Chinampa de Gorostiza,Hombres,320,301,19,524
30 Veracruz de Ignacio de la Llave,60,060 Chinampa de Gorostiza,Hombres,486,470,16,93
30 Veracruz de Ignacio de la Llave,60,060 Chinampa de Gorostiza,Hombres,423,415,8,19
30 Veracruz de Ignacio de la Llave,60,060 Chinampa de Gorostiza,Hombres,397,390,7,11
30 Veracruz de Ignacio de la Llave,60,060 Chinampa de Gorostiza,Hombres,415,410,5,13
30 Veracruz de Ignacio de la Llave,60,060 Chinampa de Gorostiza,Hombres,459,453,6,17
30 Veracruz de Ignacio de la Llave,60,060 Chinampa de Gorostiza,Hombres,430,424,6,18
30 Veracruz de Ignacio de la Llave,60,060 Chinampa de Gorostiza,Hombres,299,294,5,15
30 Veracruz de Ignacio de la Llave,60,060 Chinampa de Gorostiza,Hombres,206,204,2,28
30 Veracruz de Ignacio de la Llave,60,060 Chinampa de Gorostiza,Hombres,204,200,4,40
30 Veracruz de Ignacio de la Llave,60,060 Chinampa de Gorostiza,Hombres,188,185,3,43
30 Veracruz de Ignacio de la Llave,60,060 Chinampa de Gorostiza,Hombres,137,135,2,45
30 Veracruz de Ignacio de la Llave,60,060 Chinampa de Gorostiza,Hombres,67,67,0,39
30 Veracruz de Ignacio de la Llave,60,060 Chinampa de Gorostiza,Hombres,24,24,0,28
30 Veracruz de Ignacio de la Llave,60,060 Chinampa de Gorostiza,Hombres,16,16,0,32
30 Veracruz de Ignacio de la Llave,60,060 Chinampa de Gorostiza,Mujeres,1301,1281,20,4667
30 Veracruz de Ignacio de la Llave,60,060 Chinampa de Gorostiza,Mujeres,15,15,0,523
30 Veracruz de Ignacio de la Llave,60,060 Chinampa de Gorostiza,Mujeres,128,127,1,735
30 Veracruz de Ignacio de la Llave,60,060 Chinampa de Gorostiza,Mujeres,190,184,6,435
30 Veracruz de Ignacio de la Llave,60,060 Chinampa de Gorostiza,Mujeres,144,141,3,337
30 Veracruz de Ignacio de la Llave,60,060 Chinampa de Gorostiza,Mujeres,161,157,4,306
30 Veracruz de Ignacio de la Llave,60,060 Chinampa de Gorostiza,Mujeres,172,168,4,373
30 Veracruz de Ignacio de la Llave,60,060 Chinampa de Gorostiza,Mujeres,156,155,1,347
30 Veracruz de Ignacio de la Llave,60,060 Chinampa de Gorostiza,Mujeres,122,122,0,355
30 Veracruz de Ignacio de la Llave,60,060 Chinampa de Gorostiza,Mujeres,71,70,1,250
30 Veracruz de Ignacio de la Llave,60,060 Chinampa de Gorostiza,Mujeres,61,61,0,226
30 Veracruz de Ignacio de la Llave,60,060 Chinampa de Gorostiza,Mujeres,32,32,0,196
30 Veracruz de Ignacio de la Llave,60,060 Chinampa de Gorostiza,Mujeres,26,26,0,222
30 Veracruz de Ignacio de la Llave,60,060 Chinampa de Gorostiza,Mujeres,18,18,0,142
30 Veracruz de Ignacio de la Llave,60,060 Chinampa de Gorostiza,Mujeres,3,3,0,102
30 Veracruz de Ignacio de la Llave,60,060 Chinampa de Gorostiza,Mujeres,2,2,0,63
30 Veracruz de Ignacio de la Llave,60,060 Chinampa de Gorostiza,Mujeres,0,0,0,55
30 Veracruz de Ignacio de la Llave,62,062 Chocamán,Total,7148,6806,342,6564
30 Veracruz de Ignacio de la Llave,62,062 Chocamán,Total,132,124,8,923
30 Veracruz de Ignacio de la Llave,62,062 Chocamán,Total,782,726,56,1237
30 Veracruz de Ignacio de la Llave,62,062 Chocamán,Total,1012,961,51,764
30 Veracruz de Ignacio de la Llave,62,062 Chocamán,Total,904,856,48,584
30 Veracruz de Ignacio de la Llave,62,062 Chocamán,Total,893,842,51,528
30 Veracruz de Ignacio de la Llave,62,062 Chocamán,Total,824,793,31,461
30 Veracruz de Ignacio de la Llave,62,062 Chocamán,Total,614,586,28,347
30 Veracruz de Ignacio de la Llave,62,062 Chocamán,Total,533,509,24,283
30 Veracruz de Ignacio de la Llave,62,062 Chocamán,Total,410,397,13,306
30 Veracruz de Ignacio de la Llave,62,062 Chocamán,Total,364,349,15,254
30 Veracruz de Ignacio de la Llave,62,062 Chocamán,Total,240,233,7,210
30 Veracruz de Ignacio de la Llave,62,062 Chocamán,Total,201,195,6,197
30 Veracruz de Ignacio de la Llave,62,062 Chocamán,Total,130,126,4,185
30 Veracruz de Ignacio de la Llave,62,062 Chocamán,Total,65,65,0,137
30 Veracruz de Ignacio de la Llave,62,062 Chocamán,Total,32,32,0,77
30 Veracruz de Ignacio de la Llave,62,062 Chocamán,Total,12,12,0,71
30 Veracruz de Ignacio de la Llave,62,062 Chocamán,Hombres,5381,5089,292,1312
30 Veracruz de Ignacio de la Llave,62,062 Chocamán,Hombres,109,102,7,410
30 Veracruz de Ignacio de la Llave,62,062 Chocamán,Hombres,598,553,45,421
30 Veracruz de Ignacio de la Llave,62,062 Chocamán,Hombres,754,714,40,115
30 Veracruz de Ignacio de la Llave,62,062 Chocamán,Hombres,676,635,41,26
30 Veracruz de Ignacio de la Llave,62,062 Chocamán,Hombres,659,615,44,21
30 Veracruz de Ignacio de la Llave,62,062 Chocamán,Hombres,593,568,25,23
30 Veracruz de Ignacio de la Llave,62,062 Chocamán,Hombres,450,426,24,17
30 Veracruz de Ignacio de la Llave,62,062 Chocamán,Hombres,390,367,23,23
30 Veracruz de Ignacio de la Llave,62,062 Chocamán,Hombres,301,289,12,25
30 Veracruz de Ignacio de la Llave,62,062 Chocamán,Hombres,284,269,15,21
30 Veracruz de Ignacio de la Llave,62,062 Chocamán,Hombres,194,187,7,40
30 Veracruz de Ignacio de la Llave,62,062 Chocamán,Hombres,166,161,5,39
30 Veracruz de Ignacio de la Llave,62,062 Chocamán,Hombres,104,100,4,42
30 Veracruz de Ignacio de la Llave,62,062 Chocamán,Hombres,62,62,0,42
30 Veracruz de Ignacio de la Llave,62,062 Chocamán,Hombres,32,32,0,22
30 Veracruz de Ignacio de la Llave,62,062 Chocamán,Hombres,9,9,0,25
30 Veracruz de Ignacio de la Llave,62,062 Chocamán,Mujeres,1767,1717,50,5252
30 Veracruz de Ignacio de la Llave,62,062 Chocamán,Mujeres,23,22,1,513
30 Veracruz de Ignacio de la Llave,62,062 Chocamán,Mujeres,184,173,11,816
30 Veracruz de Ignacio de la Llave,62,062 Chocamán,Mujeres,258,247,11,649
30 Veracruz de Ignacio de la Llave,62,062 Chocamán,Mujeres,228,221,7,558
30 Veracruz de Ignacio de la Llave,62,062 Chocamán,Mujeres,234,227,7,507
30 Veracruz de Ignacio de la Llave,62,062 Chocamán,Mujeres,231,225,6,438
30 Veracruz de Ignacio de la Llave,62,062 Chocamán,Mujeres,164,160,4,330
30 Veracruz de Ignacio de la Llave,62,062 Chocamán,Mujeres,143,142,1,260
30 Veracruz de Ignacio de la Llave,62,062 Chocamán,Mujeres,109,108,1,281
30 Veracruz de Ignacio de la Llave,62,062 Chocamán,Mujeres,80,80,0,233
30 Veracruz de Ignacio de la Llave,62,062 Chocamán,Mujeres,46,46,0,170
30 Veracruz de Ignacio de la Llave,62,062 Chocamán,Mujeres,35,34,1,158
30 Veracruz de Ignacio de la Llave,62,062 Chocamán,Mujeres,26,26,0,143
30 Veracruz de Ignacio de la Llave,62,062 Chocamán,Mujeres,3,3,0,95
30 Veracruz de Ignacio de la Llave,62,062 Chocamán,Mujeres,0,0,0,55
30 Veracruz de Ignacio de la Llave,62,062 Chocamán,Mujeres,3,3,0,46
30 Veracruz de Ignacio de la Llave,63,063 Chontla,Total,5052,4964,88,6180
30 Veracruz de Ignacio de la Llave,63,063 Chontla,Total,69,69,0,1063
30 Veracruz de Ignacio de la Llave,63,063 Chontla,Total,397,388,9,1431
30 Veracruz de Ignacio de la Llave,63,063 Chontla,Total,415,402,13,373
30 Veracruz de Ignacio de la Llave,63,063 Chontla,Total,394,386,8,317
30 Veracruz de Ignacio de la Llave,63,063 Chontla,Total,451,443,8,348
30 Veracruz de Ignacio de la Llave,63,063 Chontla,Total,511,504,7,322
30 Veracruz de Ignacio de la Llave,63,063 Chontla,Total,497,491,6,369
30 Veracruz de Ignacio de la Llave,63,063 Chontla,Total,498,490,8,283
30 Veracruz de Ignacio de la Llave,63,063 Chontla,Total,433,423,10,306
30 Veracruz de Ignacio de la Llave,63,063 Chontla,Total,365,361,4,245
30 Veracruz de Ignacio de la Llave,63,063 Chontla,Total,315,308,7,256
30 Veracruz de Ignacio de la Llave,63,063 Chontla,Total,278,275,3,246
30 Veracruz de Ignacio de la Llave,63,063 Chontla,Total,240,238,2,233
30 Veracruz de Ignacio de la Llave,63,063 Chontla,Total,120,117,3,176
30 Veracruz de Ignacio de la Llave,63,063 Chontla,Total,49,49,0,115
30 Veracruz de Ignacio de la Llave,63,063 Chontla,Total,20,20,0,97
30 Veracruz de Ignacio de la Llave,63,063 Chontla,Hombres,4056,3979,77,1573
30 Veracruz de Ignacio de la Llave,63,063 Chontla,Hombres,61,61,0,517
30 Veracruz de Ignacio de la Llave,63,063 Chontla,Hombres,322,316,6,647
30 Veracruz de Ignacio de la Llave,63,063 Chontla,Hombres,337,329,8,67
30 Veracruz de Ignacio de la Llave,63,063 Chontla,Hombres,324,316,8,20
30 Veracruz de Ignacio de la Llave,63,063 Chontla,Hombres,364,358,6,18
30 Veracruz de Ignacio de la Llave,63,063 Chontla,Hombres,382,375,7,16
30 Veracruz de Ignacio de la Llave,63,063 Chontla,Hombres,390,384,6,16
30 Veracruz de Ignacio de la Llave,63,063 Chontla,Hombres,394,386,8,15
30 Veracruz de Ignacio de la Llave,63,063 Chontla,Hombres,345,336,9,17
30 Veracruz de Ignacio de la Llave,63,063 Chontla,Hombres,286,282,4,25
30 Veracruz de Ignacio de la Llave,63,063 Chontla,Hombres,253,246,7,27
30 Veracruz de Ignacio de la Llave,63,063 Chontla,Hombres,221,218,3,25
30 Veracruz de Ignacio de la Llave,63,063 Chontla,Hombres,204,202,2,39
30 Veracruz de Ignacio de la Llave,63,063 Chontla,Hombres,113,110,3,40
30 Veracruz de Ignacio de la Llave,63,063 Chontla,Hombres,43,43,0,43
30 Veracruz de Ignacio de la Llave,63,063 Chontla,Hombres,17,17,0,41
30 Veracruz de Ignacio de la Llave,63,063 Chontla,Mujeres,996,985,11,4607
30 Veracruz de Ignacio de la Llave,63,063 Chontla,Mujeres,8,8,0,546
30 Veracruz de Ignacio de la Llave,63,063 Chontla,Mujeres,75,72,3,784
30 Veracruz de Ignacio de la Llave,63,063 Chontla,Mujeres,78,73,5,306
30 Veracruz de Ignacio de la Llave,63,063 Chontla,Mujeres,70,70,0,297
30 Veracruz de Ignacio de la Llave,63,063 Chontla,Mujeres,87,85,2,330
30 Veracruz de Ignacio de la Llave,63,063 Chontla,Mujeres,129,129,0,306
30 Veracruz de Ignacio de la Llave,63,063 Chontla,Mujeres,107,107,0,353
30 Veracruz de Ignacio de la Llave,63,063 Chontla,Mujeres,104,104,0,268
30 Veracruz de Ignacio de la Llave,63,063 Chontla,Mujeres,88,87,1,289
30 Veracruz de Ignacio de la Llave,63,063 Chontla,Mujeres,79,79,0,220
30 Veracruz de Ignacio de la Llave,63,063 Chontla,Mujeres,62,62,0,229
30 Veracruz de Ignacio de la Llave,63,063 Chontla,Mujeres,57,57,0,221
30 Veracruz de Ignacio de la Llave,63,063 Chontla,Mujeres,36,36,0,194
30 Veracruz de Ignacio de la Llave,63,063 Chontla,Mujeres,7,7,0,136
30 Veracruz de Ignacio de la Llave,63,063 Chontla,Mujeres,6,6,0,72
30 Veracruz de Ignacio de la Llave,63,063 Chontla,Mujeres,3,3,0,56
30 Veracruz de Ignacio de la Llave,64,064 Chumatlán,Total,1201,1194,7,1672
30 Veracruz de Ignacio de la Llave,64,064 Chumatlán,Total,11,11,0,297
30 Veracruz de Ignacio de la Llave,64,064 Chumatlán,Total,87,86,1,378
30 Veracruz de Ignacio de la Llave,64,064 Chumatlán,Total,159,158,1,138
30 Veracruz de Ignacio de la Llave,64,064 Chumatlán,Total,118,117,1,114
30 Veracruz de Ignacio de la Llave,64,064 Chumatlán,Total,149,149,0,113
30 Veracruz de Ignacio de la Llave,64,064 Chumatlán,Total,146,143,3,99
30 Veracruz de Ignacio de la Llave,64,064 Chumatlán,Total,118,118,0,78
30 Veracruz de Ignacio de la Llave,64,064 Chumatlán,Total,111,111,0,66
30 Veracruz de Ignacio de la Llave,64,064 Chumatlán,Total,87,87,0,60
30 Veracruz de Ignacio de la Llave,64,064 Chumatlán,Total,65,65,0,69
30 Veracruz de Ignacio de la Llave,64,064 Chumatlán,Total,50,50,0,61
30 Veracruz de Ignacio de la Llave,64,064 Chumatlán,Total,40,40,0,56
30 Veracruz de Ignacio de la Llave,64,064 Chumatlán,Total,33,33,0,55
30 Veracruz de Ignacio de la Llave,64,064 Chumatlán,Total,12,12,0,38
30 Veracruz de Ignacio de la Llave,64,064 Chumatlán,Total,7,6,1,19
30 Veracruz de Ignacio de la Llave,64,064 Chumatlán,Total,8,8,0,31
30 Veracruz de Ignacio de la Llave,64,064 Chumatlán,Hombres,901,894,7,477
30 Veracruz de Ignacio de la Llave,64,064 Chumatlán,Hombres,9,9,0,134
30 Veracruz de Ignacio de la Llave,64,064 Chumatlán,Hombres,65,64,1,166
30 Veracruz de Ignacio de la Llave,64,064 Chumatlán,Hombres,114,113,1,26
30 Veracruz de Ignacio de la Llave,64,064 Chumatlán,Hombres,83,82,1,19
30 Veracruz de Ignacio de la Llave,64,064 Chumatlán,Hombres,113,113,0,18
30 Veracruz de Ignacio de la Llave,64,064 Chumatlán,Hombres,113,110,3,8
30 Veracruz de Ignacio de la Llave,64,064 Chumatlán,Hombres,86,86,0,3
30 Veracruz de Ignacio de la Llave,64,064 Chumatlán,Hombres,82,82,0,13
30 Veracruz de Ignacio de la Llave,64,064 Chumatlán,Hombres,67,67,0,6
30 Veracruz de Ignacio de la Llave,64,064 Chumatlán,Hombres,49,49,0,10
30 Veracruz de Ignacio de la Llave,64,064 Chumatlán,Hombres,35,35,0,16
30 Veracruz de Ignacio de la Llave,64,064 Chumatlán,Hombres,33,33,0,11
30 Veracruz de Ignacio de la Llave,64,064 Chumatlán,Hombres,29,29,0,15
30 Veracruz de Ignacio de la Llave,64,064 Chumatlán,Hombres,11,11,0,13
30 Veracruz de Ignacio de la Llave,64,064 Chumatlán,Hombres,5,4,1,4
30 Veracruz de Ignacio de la Llave,64,064 Chumatlán,Hombres,7,7,0,15
30 Veracruz de Ignacio de la Llave,64,064 Chumatlán,Mujeres,300,300,0,1195
30 Veracruz de Ignacio de la Llave,64,064 Chumatlán,Mujeres,2,2,0,163
30 Veracruz de Ignacio de la Llave,64,064 Chumatlán,Mujeres,22,22,0,212
30 Veracruz de Ignacio de la Llave,64,064 Chumatlán,Mujeres,45,45,0,112
30 Veracruz de Ignacio de la Llave,64,064 Chumatlán,Mujeres,35,35,0,95
30 Veracruz de Ignacio de la Llave,64,064 Chumatlán,Mujeres,36,36,0,95
30 Veracruz de Ignacio de la Llave,64,064 Chumatlán,Mujeres,33,33,0,91
30 Veracruz de Ignacio de la Llave,64,064 Chumatlán,Mujeres,32,32,0,75
30 Veracruz de Ignacio de la Llave,64,064 Chumatlán,Mujeres,29,29,0,53
30 Veracruz de Ignacio de la Llave,64,064 Chumatlán,Mujeres,20,20,0,54
30 Veracruz de Ignacio de la Llave,64,064 Chumatlán,Mujeres,16,16,0,59
30 Veracruz de Ignacio de la Llave,64,064 Chumatlán,Mujeres,15,15,0,45
30 Veracruz de Ignacio de la Llave,64,064 Chumatlán,Mujeres,7,7,0,45
30 Veracruz de Ignacio de la Llave,64,064 Chumatlán,Mujeres,4,4,0,40
30 Veracruz de Ignacio de la Llave,64,064 Chumatlán,Mujeres,1,1,0,25
30 Veracruz de Ignacio de la Llave,64,064 Chumatlán,Mujeres,2,2,0,15
30 Veracruz de Ignacio de la Llave,64,064 Chumatlán,Mujeres,1,1,0,16
30 Veracruz de Ignacio de la Llave,35,035 Citlaltépetl,Total,3633,3465,168,4638
30 Veracruz de Ignacio de la Llave,35,035 Citlaltépetl,Total,34,34,0,843
30 Veracruz de Ignacio de la Llave,35,035 Citlaltépetl,Total,266,247,19,1007
30 Veracruz de Ignacio de la Llave,35,035 Citlaltépetl,Total,335,304,31,265
30 Veracruz de Ignacio de la Llave,35,035 Citlaltépetl,Total,310,293,17,243
30 Veracruz de Ignacio de la Llave,35,035 Citlaltépetl,Total,342,330,12,229
30 Veracruz de Ignacio de la Llave,35,035 Citlaltépetl,Total,385,372,13,282
30 Veracruz de Ignacio de la Llave,35,035 Citlaltépetl,Total,385,373,12,256
30 Veracruz de Ignacio de la Llave,35,035 Citlaltépetl,Total,328,316,12,237
30 Veracruz de Ignacio de la Llave,35,035 Citlaltépetl,Total,297,284,13,202
30 Veracruz de Ignacio de la Llave,35,035 Citlaltépetl,Total,263,252,11,190
30 Veracruz de Ignacio de la Llave,35,035 Citlaltépetl,Total,239,228,11,198
30 Veracruz de Ignacio de la Llave,35,035 Citlaltépetl,Total,180,174,6,179
30 Veracruz de Ignacio de la Llave,35,035 Citlaltépetl,Total,130,123,7,183
30 Veracruz de Ignacio de la Llave,35,035 Citlaltépetl,Total,75,72,3,139
30 Veracruz de Ignacio de la Llave,35,035 Citlaltépetl,Total,38,38,0,97
30 Veracruz de Ignacio de la Llave,35,035 Citlaltépetl,Total,26,25,1,88
30 Veracruz de Ignacio de la Llave,35,035 Citlaltépetl,Hombres,2850,2697,153,1167
30 Veracruz de Ignacio de la Llave,35,035 Citlaltépetl,Hombres,23,23,0,406
30 Veracruz de Ignacio de la Llave,35,035 Citlaltépetl,Hombres,204,189,15,435
30 Veracruz de Ignacio de la Llave,35,035 Citlaltépetl,Hombres,248,223,25,49
30 Veracruz de Ignacio de la Llave,35,035 Citlaltépetl,Hombres,229,214,15,14
30 Veracruz de Ignacio de la Llave,35,035 Citlaltépetl,Hombres,259,247,12,9
30 Veracruz de Ignacio de la Llave,35,035 Citlaltépetl,Hombres,296,285,11,15
30 Veracruz de Ignacio de la Llave,35,035 Citlaltépetl,Hombres,291,279,12,12
30 Veracruz de Ignacio de la Llave,35,035 Citlaltépetl,Hombres,251,240,11,19
30 Veracruz de Ignacio de la Llave,35,035 Citlaltépetl,Hombres,244,231,13,16
30 Veracruz de Ignacio de la Llave,35,035 Citlaltépetl,Hombres,220,209,11,16
30 Veracruz de Ignacio de la Llave,35,035 Citlaltépetl,Hombres,191,180,11,24
30 Veracruz de Ignacio de la Llave,35,035 Citlaltépetl,Hombres,156,150,6,23
30 Veracruz de Ignacio de la Llave,35,035 Citlaltépetl,Hombres,116,109,7,27
30 Veracruz de Ignacio de la Llave,35,035 Citlaltépetl,Hombres,61,58,3,28
30 Veracruz de Ignacio de la Llave,35,035 Citlaltépetl,Hombres,35,35,0,36
30 Veracruz de Ignacio de la Llave,35,035 Citlaltépetl,Hombres,26,25,1,38
30 Veracruz de Ignacio de la Llave,35,035 Citlaltépetl,Mujeres,783,768,15,3471
30 Veracruz de Ignacio de la Llave,35,035 Citlaltépetl,Mujeres,11,11,0,437
30 Veracruz de Ignacio de la Llave,35,035 Citlaltépetl,Mujeres,62,58,4,572
30 Veracruz de Ignacio de la Llave,35,035 Citlaltépetl,Mujeres,87,81,6,216
30 Veracruz de Ignacio de la Llave,35,035 Citlaltépetl,Mujeres,81,79,2,229
30 Veracruz de Ignacio de la Llave,35,035 Citlaltépetl,Mujeres,83,83,0,220
30 Veracruz de Ignacio de la Llave,35,035 Citlaltépetl,Mujeres,89,87,2,267
30 Veracruz de Ignacio de la Llave,35,035 Citlaltépetl,Mujeres,94,94,0,244
30 Veracruz de Ignacio de la Llave,35,035 Citlaltépetl,Mujeres,77,76,1,218
30 Veracruz de Ignacio de la Llave,35,035 Citlaltépetl,Mujeres,53,53,0,186
30 Veracruz de Ignacio de la Llave,35,035 Citlaltépetl,Mujeres,43,43,0,174
30 Veracruz de Ignacio de la Llave,35,035 Citlaltépetl,Mujeres,48,48,0,174
30 Veracruz de Ignacio de la Llave,35,035 Citlaltépetl,Mujeres,24,24,0,156
30 Veracruz de Ignacio de la Llave,35,035 Citlaltépetl,Mujeres,14,14,0,156
30 Veracruz de Ignacio de la Llave,35,035 Citlaltépetl,Mujeres,14,14,0,111
30 Veracruz de Ignacio de la Llave,35,035 Citlaltépetl,Mujeres,3,3,0,61
30 Veracruz de Ignacio de la Llave,35,035 Citlaltépetl,Mujeres,0,0,0,50
30 Veracruz de Ignacio de la Llave,36,036 Coacoatzintla,Total,3296,3157,139,3454
30 Veracruz de Ignacio de la Llave,36,036 Coacoatzintla,Total,46,41,5,589
30 Veracruz de Ignacio de la Llave,36,036 Coacoatzintla,Total,359,334,25,662
30 Veracruz de Ignacio de la Llave,36,036 Coacoatzintla,Total,457,434,23,351
30 Veracruz de Ignacio de la Llave,36,036 Coacoatzintla,Total,444,429,15,308
30 Veracruz de Ignacio de la Llave,36,036 Coacoatzintla,Total,426,407,19,298
30 Veracruz de Ignacio de la Llave,36,036 Coacoatzintla,Total,395,382,13,250
30 Veracruz de Ignacio de la Llave,36,036 Coacoatzintla,Total,283,276,7,162
30 Veracruz de Ignacio de la Llave,36,036 Coacoatzintla,Total,258,249,9,157
30 Veracruz de Ignacio de la Llave,36,036 Coacoatzintla,Total,200,196,4,143
30 Veracruz de Ignacio de la Llave,36,036 Coacoatzintla,Total,170,163,7,118
30 Veracruz de Ignacio de la Llave,36,036 Coacoatzintla,Total,97,93,4,99
30 Veracruz de Ignacio de la Llave,36,036 Coacoatzintla,Total,69,66,3,93
30 Veracruz de Ignacio de la Llave,36,036 Coacoatzintla,Total,47,44,3,82
30 Veracruz de Ignacio de la Llave,36,036 Coacoatzintla,Total,22,20,2,63
30 Veracruz de Ignacio de la Llave,36,036 Coacoatzintla,Total,14,14,0,34
30 Veracruz de Ignacio de la Llave,36,036 Coacoatzintla,Total,9,9,0,45
30 Veracruz de Ignacio de la Llave,36,036 Coacoatzintla,Hombres,2504,2381,123,713
30 Veracruz de Ignacio de la Llave,36,036 Coacoatzintla,Hombres,39,34,5,286
30 Veracruz de Ignacio de la Llave,36,036 Coacoatzintla,Hombres,267,244,23,221
30 Veracruz de Ignacio de la Llave,36,036 Coacoatzintla,Hombres,333,317,16,47
30 Veracruz de Ignacio de la Llave,36,036 Coacoatzintla,Hombres,332,321,11,11
30 Veracruz de Ignacio de la Llave,36,036 Coacoatzintla,Hombres,319,300,19,17
30 Veracruz de Ignacio de la Llave,36,036 Coacoatzintla,Hombres,299,288,11,9
30 Veracruz de Ignacio de la Llave,36,036 Coacoatzintla,Hombres,201,195,6,8
30 Veracruz de Ignacio de la Llave,36,036 Coacoatzintla,Hombres,200,191,9,6
30 Veracruz de Ignacio de la Llave,36,036 Coacoatzintla,Hombres,149,145,4,7
30 Veracruz de Ignacio de la Llave,36,036 Coacoatzintla,Hombres,133,126,7,9
30 Veracruz de Ignacio de la Llave,36,036 Coacoatzintla,Hombres,87,83,4,13
30 Veracruz de Ignacio de la Llave,36,036 Coacoatzintla,Hombres,62,59,3,18
30 Veracruz de Ignacio de la Llave,36,036 Coacoatzintla,Hombres,40,37,3,21
30 Veracruz de Ignacio de la Llave,36,036 Coacoatzintla,Hombres,22,20,2,19
30 Veracruz de Ignacio de la Llave,36,036 Coacoatzintla,Hombres,13,13,0,9
30 Veracruz de Ignacio de la Llave,36,036 Coacoatzintla,Hombres,8,8,0,12
30 Veracruz de Ignacio de la Llave,36,036 Coacoatzintla,Mujeres,792,776,16,2741
30 Veracruz de Ignacio de la Llave,36,036 Coacoatzintla,Mujeres,7,7,0,303
30 Veracruz de Ignacio de la Llave,36,036 Coacoatzintla,Mujeres,92,90,2,441
30 Veracruz de Ignacio de la Llave,36,036 Coacoatzintla,Mujeres,124,117,7,304
30 Veracruz de Ignacio de la Llave,36,036 Coacoatzintla,Mujeres,112,108,4,297
30 Veracruz de Ignacio de la Llave,36,036 Coacoatzintla,Mujeres,107,107,0,281
30 Veracruz de Ignacio de la Llave,36,036 Coacoatzintla,Mujeres,96,94,2,241
30 Veracruz de Ignacio de la Llave,36,036 Coacoatzintla,Mujeres,82,81,1,154
30 Veracruz de Ignacio de la Llave,36,036 Coacoatzintla,Mujeres,58,58,0,151
30 Veracruz de Ignacio de la Llave,36,036 Coacoatzintla,Mujeres,51,51,0,136
30 Veracruz de Ignacio de la Llave,36,036 Coacoatzintla,Mujeres,37,37,0,109
30 Veracruz de Ignacio de la Llave,36,036 Coacoatzintla,Mujeres,10,10,0,86
30 Veracruz de Ignacio de la Llave,36,036 Coacoatzintla,Mujeres,7,7,0,75
30 Veracruz de Ignacio de la Llave,36,036 Coacoatzintla,Mujeres,7,7,0,61
30 Veracruz de Ignacio de la Llave,36,036 Coacoatzintla,Mujeres,0,0,0,44
30 Veracruz de Ignacio de la Llave,36,036 Coacoatzintla,Mujeres,1,1,0,25
30 Veracruz de Ignacio de la Llave,36,036 Coacoatzintla,Mujeres,1,1,0,33
30 Veracruz de Ignacio de la Llave,37,037 Coahuitlán,Total,2175,2162,13,3408
30 Veracruz de Ignacio de la Llave,37,037 Coahuitlán,Total,27,26,1,585
30 Veracruz de Ignacio de la Llave,37,037 Coahuitlán,Total,220,218,2,694
30 Veracruz de Ignacio de la Llave,37,037 Coahuitlán,Total,314,313,1,306
30 Veracruz de Ignacio de la Llave,37,037 Coahuitlán,Total,252,250,2,283
30 Veracruz de Ignacio de la Llave,37,037 Coahuitlán,Total,241,238,3,264
30 Veracruz de Ignacio de la Llave,37,037 Coahuitlán,Total,248,246,2,217
30 Veracruz de Ignacio de la Llave,37,037 Coahuitlán,Total,202,202,0,211
30 Veracruz de Ignacio de la Llave,37,037 Coahuitlán,Total,183,182,1,168
30 Veracruz de Ignacio de la Llave,37,037 Coahuitlán,Total,131,130,1,145
30 Veracruz de Ignacio de la Llave,37,037 Coahuitlán,Total,126,126,0,134
30 Veracruz de Ignacio de la Llave,37,037 Coahuitlán,Total,91,91,0,115
30 Veracruz de Ignacio de la Llave,37,037 Coahuitlán,Total,70,70,0,86
30 Veracruz de Ignacio de la Llave,37,037 Coahuitlán,Total,43,43,0,81
30 Veracruz de Ignacio de la Llave,37,037 Coahuitlán,Total,17,17,0,53
30 Veracruz de Ignacio de la Llave,37,037 Coahuitlán,Total,7,7,0,35
30 Veracruz de Ignacio de la Llave,37,037 Coahuitlán,Total,3,3,0,31
30 Veracruz de Ignacio de la Llave,37,037 Coahuitlán,Hombres,1892,1881,11,841
30 Veracruz de Ignacio de la Llave,37,037 Coahuitlán,Hombres,24,23,1,293
30 Veracruz de Ignacio de la Llave,37,037 Coahuitlán,Hombres,187,186,1,273
30 Veracruz de Ignacio de la Llave,37,037 Coahuitlán,Hombres,254,253,1,41
30 Veracruz de Ignacio de la Llave,37,037 Coahuitlán,Hombres,219,217,2,19
30 Veracruz de Ignacio de la Llave,37,037 Coahuitlán,Hombres,207,205,2,23
30 Veracruz de Ignacio de la Llave,37,037 Coahuitlán,Hombres,221,219,2,22
30 Veracruz de Ignacio de la Llave,37,037 Coahuitlán,Hombres,174,174,0,20
30 Veracruz de Ignacio de la Llave,37,037 Coahuitlán,Hombres,157,156,1,14
30 Veracruz de Ignacio de la Llave,37,037 Coahuitlán,Hombres,118,117,1,19
30 Veracruz de Ignacio de la Llave,37,037 Coahuitlán,Hombres,122,122,0,15
30 Veracruz de Ignacio de la Llave,37,037 Coahuitlán,Hombres,82,82,0,14
30 Veracruz de Ignacio de la Llave,37,037 Coahuitlán,Hombres,61,61,0,17
30 Veracruz de Ignacio de la Llave,37,037 Coahuitlán,Hombres,39,39,0,23
30 Veracruz de Ignacio de la Llave,37,037 Coahuitlán,Hombres,17,17,0,23
30 Veracruz de Ignacio de la Llave,37,037 Coahuitlán,Hombres,7,7,0,13
30 Veracruz de Ignacio de la Llave,37,037 Coahuitlán,Hombres,3,3,0,12
30 Veracruz de Ignacio de la Llave,37,037 Coahuitlán,Mujeres,283,281,2,2567
30 Veracruz de Ignacio de la Llave,37,037 Coahuitlán,Mujeres,3,3,0,292
30 Veracruz de Ignacio de la Llave,37,037 Coahuitlán,Mujeres,33,32,1,421
30 Veracruz de Ignacio de la Llave,37,037 Coahuitlán,Mujeres,60,60,0,265
30 Veracruz de Ignacio de la Llave,37,037 Coahuitlán,Mujeres,33,33,0,264
30 Veracruz de Ignacio de la Llave,37,037 Coahuitlán,Mujeres,34,33,1,241
30 Veracruz de Ignacio de la Llave,37,037 Coahuitlán,Mujeres,27,27,0,195
30 Veracruz de Ignacio de la Llave,37,037 Coahuitlán,Mujeres,28,28,0,191
30 Veracruz de Ignacio de la Llave,37,037 Coahuitlán,Mujeres,26,26,0,154
30 Veracruz de Ignacio de la Llave,37,037 Coahuitlán,Mujeres,13,13,0,126
30 Veracruz de Ignacio de la Llave,37,037 Coahuitlán,Mujeres,4,4,0,119
30 Veracruz de Ignacio de la Llave,37,037 Coahuitlán,Mujeres,9,9,0,101
30 Veracruz de Ignacio de la Llave,37,037 Coahuitlán,Mujeres,9,9,0,69
30 Veracruz de Ignacio de la Llave,37,037 Coahuitlán,Mujeres,4,4,0,58
30 Veracruz de Ignacio de la Llave,37,037 Coahuitlán,Mujeres,0,0,0,30
30 Veracruz de Ignacio de la Llave,37,037 Coahuitlán,Mujeres,0,0,0,22
30 Veracruz de Ignacio de la Llave,37,037 Coahuitlán,Mujeres,0,0,0,19
30 Veracruz de Ignacio de la Llave,38,038 Coatepec,Total,37594,36499,1095,30144
30 Veracruz de Ignacio de la Llave,38,038 Coatepec,Total,186,171,15,4093
30 Veracruz de Ignacio de la Llave,38,038 Coatepec,Total,2180,2040,140,5598
30 Veracruz de Ignacio de la Llave,38,038 Coatepec,Total,4282,4062,220,3240
30 Veracruz de Ignacio de la Llave,38,038 Coatepec,Total,4731,4555,176,1993
30 Veracruz de Ignacio de la Llave,38,038 Coatepec,Total,4991,4887,104,1910
30 Veracruz de Ignacio de la Llave,38,038 Coatepec,Total,4911,4817,94,1749
30 Veracruz de Ignacio de la Llave,38,038 Coatepec,Total,4247,4168,79,1473
30 Veracruz de Ignacio de la Llave,38,038 Coatepec,Total,3735,3652,83,1342
30 Veracruz de Ignacio de la Llave,38,038 Coatepec,Total,3064,3013,51,1363
30 Veracruz de Ignacio de la Llave,38,038 Coatepec,Total,2126,2063,63,1324
30 Veracruz de Ignacio de la Llave,38,038 Coatepec,Total,1371,1340,31,1466
30 Veracruz de Ignacio de la Llave,38,038 Coatepec,Total,773,755,18,1240
30 Veracruz de Ignacio de la Llave,38,038 Coatepec,Total,508,497,11,1193
30 Veracruz de Ignacio de la Llave,38,038 Coatepec,Total,281,277,4,916
30 Veracruz de Ignacio de la Llave,38,038 Coatepec,Total,135,133,2,626
30 Veracruz de Ignacio de la Llave,38,038 Coatepec,Total,73,69,4,618
30 Veracruz de Ignacio de la Llave,38,038 Coatepec,Hombres,24126,23279,847,7927
30 Veracruz de Ignacio de la Llave,38,038 Coatepec,Hombres,158,146,12,2061
30 Veracruz de Ignacio de la Llave,38,038 Coatepec,Hombres,1556,1441,115,2299
30 Veracruz de Ignacio de la Llave,38,038 Coatepec,Hombres,2798,2649,149,905
30 Veracruz de Ignacio de la Llave,38,038 Coatepec,Hombres,2978,2864,114,245
30 Veracruz de Ignacio de la Llave,38,038 Coatepec,Hombres,3108,3028,80,114
30 Veracruz de Ignacio de la Llave,38,038 Coatepec,Hombres,2951,2876,75,75
30 Veracruz de Ignacio de la Llave,38,038 Coatepec,Hombres,2619,2554,65,100
30 Veracruz de Ignacio de la Llave,38,038 Coatepec,Hombres,2293,2224,69,113
30 Veracruz de Ignacio de la Llave,38,038 Coatepec,Hombres,1943,1897,46,142
30 Veracruz de Ignacio de la Llave,38,038 Coatepec,Hombres,1418,1361,57,203
30 Veracruz de Ignacio de la Llave,38,038 Coatepec,Hombres,968,939,29,350
30 Veracruz de Ignacio de la Llave,38,038 Coatepec,Hombres,567,551,16,323
30 Veracruz de Ignacio de la Llave,38,038 Coatepec,Hombres,387,376,11,365
30 Veracruz de Ignacio de la Llave,38,038 Coatepec,Hombres,216,212,4,255
30 Veracruz de Ignacio de la Llave,38,038 Coatepec,Hombres,103,102,1,192
30 Veracruz de Ignacio de la Llave,38,038 Coatepec,Hombres,63,59,4,185
30 Veracruz de Ignacio de la Llave,38,038 Coatepec,Mujeres,13468,13220,248,22217
30 Veracruz de Ignacio de la Llave,38,038 Coatepec,Mujeres,28,25,3,2032
30 Veracruz de Ignacio de la Llave,38,038 Coatepec,Mujeres,624,599,25,3299
30 Veracruz de Ignacio de la Llave,38,038 Coatepec,Mujeres,1484,1413,71,2335
30 Veracruz de Ignacio de la Llave,38,038 Coatepec,Mujeres,1753,1691,62,1748
30 Veracruz de Ignacio de la Llave,38,038 Coatepec,Mujeres,1883,1859,24,1796
30 Veracruz de Ignacio de la Llave,38,038 Coatepec,Mujeres,1960,1941,19,1674
30 Veracruz de Ignacio de la Llave,38,038 Coatepec,Mujeres,1628,1614,14,1373
30 Veracruz de Ignacio de la Llave,38,038 Coatepec,Mujeres,1442,1428,14,1229
30 Veracruz de Ignacio de la Llave,38,038 Coatepec,Mujeres,1121,1116,5,1221
30 Veracruz de Ignacio de la Llave,38,038 Coatepec,Mujeres,708,702,6,1121
30 Veracruz de Ignacio de la Llave,38,038 Coatepec,Mujeres,403,401,2,1116
30 Veracruz de Ignacio de la Llave,38,038 Coatepec,Mujeres,206,204,2,917
30 Veracruz de Ignacio de la Llave,38,038 Coatepec,Mujeres,121,121,0,828
30 Veracruz de Ignacio de la Llave,38,038 Coatepec,Mujeres,65,65,0,661
30 Veracruz de Ignacio de la Llave,38,038 Coatepec,Mujeres,32,31,1,434
30 Veracruz de Ignacio de la Llave,38,038 Coatepec,Mujeres,10,10,0,433
30 Veracruz de Ignacio de la Llave,39,039 Coatzacoalcos,Total,134791,129311,5480,106419
30 Veracruz de Ignacio de la Llave,39,039 Coatzacoalcos,Total,462,424,38,15012
30 Veracruz de Ignacio de la Llave,39,039 Coatzacoalcos,Total,6918,6243,675,21790
30 Veracruz de Ignacio de la Llave,39,039 Coatzacoalcos,Total,16288,15140,1148,11476
30 Veracruz de Ignacio de la Llave,39,039 Coatzacoalcos,Total,18910,18047,863,6876
30 Veracruz de Ignacio de la Llave,39,039 Coatzacoalcos,Total,17733,17185,548,6345
30 Veracruz de Ignacio de la Llave,39,039 Coatzacoalcos,Total,18183,17752,431,6299
30 Veracruz de Ignacio de la Llave,39,039 Coatzacoalcos,Total,16055,15688,367,5851
30 Veracruz de Ignacio de la Llave,39,039 Coatzacoalcos,Total,14201,13830,371,5712
30 Veracruz de Ignacio de la Llave,39,039 Coatzacoalcos,Total,11137,10777,360,5576
30 Veracruz de Ignacio de la Llave,39,039 Coatzacoalcos,Total,7134,6858,276,5061
30 Veracruz de Ignacio de la Llave,39,039 Coatzacoalcos,Total,3880,3704,176,4779
30 Veracruz de Ignacio de la Llave,39,039 Coatzacoalcos,Total,1940,1834,106,3660
30 Veracruz de Ignacio de la Llave,39,039 Coatzacoalcos,Total,1103,1043,60,3132
30 Veracruz de Ignacio de la Llave,39,039 Coatzacoalcos,Total,514,477,37,2182
30 Veracruz de Ignacio de la Llave,39,039 Coatzacoalcos,Total,221,202,19,1407
30 Veracruz de Ignacio de la Llave,39,039 Coatzacoalcos,Total,112,107,5,1261
30 Veracruz de Ignacio de la Llave,39,039 Coatzacoalcos,Hombres,86162,82028,4134,29125
30 Veracruz de Ignacio de la Llave,39,039 Coatzacoalcos,Hombres,324,294,30,7601
30 Veracruz de Ignacio de la Llave,39,039 Coatzacoalcos,Hombres,4802,4296,506,9693
30 Veracruz de Ignacio de la Llave,39,039 Coatzacoalcos,Hombres,10257,9503,754,3372
30 Veracruz de Ignacio de la Llave,39,039 Coatzacoalcos,Hombres,11479,10916,563,628
30 Veracruz de Ignacio de la Llave,39,039 Coatzacoalcos,Hombres,10638,10264,374,245
30 Veracruz de Ignacio de la Llave,39,039 Coatzacoalcos,Hombres,10994,10664,330,217
30 Veracruz de Ignacio de la Llave,39,039 Coatzacoalcos,Hombres,9968,9663,305,219
30 Veracruz de Ignacio de la Llave,39,039 Coatzacoalcos,Hombres,9198,8886,312,279
30 Veracruz de Ignacio de la Llave,39,039 Coatzacoalcos,Hombres,7613,7293,320,524
30 Veracruz de Ignacio de la Llave,39,039 Coatzacoalcos,Hombres,5102,4843,259,985
30 Veracruz de Ignacio de la Llave,39,039 Coatzacoalcos,Hombres,2809,2645,164,1350
30 Veracruz de Ignacio de la Llave,39,039 Coatzacoalcos,Hombres,1452,1351,101,1183
30 Veracruz de Ignacio de la Llave,39,039 Coatzacoalcos,Hombres,855,797,58,1094
30 Veracruz de Ignacio de la Llave,39,039 Coatzacoalcos,Hombres,404,368,36,799
30 Veracruz de Ignacio de la Llave,39,039 Coatzacoalcos,Hombres,176,159,17,494
30 Veracruz de Ignacio de la Llave,39,039 Coatzacoalcos,Hombres,91,86,5,442
30 Veracruz de Ignacio de la Llave,39,039 Coatzacoalcos,Mujeres,48629,47283,1346,77294
30 Veracruz de Ignacio de la Llave,39,039 Coatzacoalcos,Mujeres,138,130,8,7411
30 Veracruz de Ignacio de la Llave,39,039 Coatzacoalcos,Mujeres,2116,1947,169,12097
30 Veracruz de Ignacio de la Llave,39,039 Coatzacoalcos,Mujeres,6031,5637,394,8104
30 Veracruz de Ignacio de la Llave,39,039 Coatzacoalcos,Mujeres,7431,7131,300,6248
30 Veracruz de Ignacio de la Llave,39,039 Coatzacoalcos,Mujeres,7095,6921,174,6100
30 Veracruz de Ignacio de la Llave,39,039 Coatzacoalcos,Mujeres,7189,7088,101,6082
30 Veracruz de Ignacio de la Llave,39,039 Coatzacoalcos,Mujeres,6087,6025,62,5632
30 Veracruz de Ignacio de la Llave,39,039 Coatzacoalcos,Mujeres,5003,4944,59,5433
30 Veracruz de Ignacio de la Llave,39,039 Coatzacoalcos,Mujeres,3524,3484,40,5052
30 Veracruz de Ignacio de la Llave,39,039 Coatzacoalcos,Mujeres,2032,2015,17,4076
30 Veracruz de Ignacio de la Llave,39,039 Coatzacoalcos,Mujeres,1071,1059,12,3429
30 Veracruz de Ignacio de la Llave,39,039 Coatzacoalcos,Mujeres,488,483,5,2477
30 Veracruz de Ignacio de la Llave,39,039 Coatzacoalcos,Mujeres,248,246,2,2038
30 Veracruz de Ignacio de la Llave,39,039 Coatzacoalcos,Mujeres,110,109,1,1383
30 Veracruz de Ignacio de la Llave,39,039 Coatzacoalcos,Mujeres,45,43,2,913
30 Veracruz de Ignacio de la Llave,39,039 Coatzacoalcos,Mujeres,21,21,0,819
30 Veracruz de Ignacio de la Llave,40,040 Coatzintla,Total,18674,18201,473,18620
30 Veracruz de Ignacio de la Llave,40,040 Coatzintla,Total,35,31,4,2678
30 Veracruz de Ignacio de la Llave,40,040 Coatzintla,Total,864,789,75,3732
30 Veracruz de Ignacio de la Llave,40,040 Coatzintla,Total,2219,2100,119,1796
30 Veracruz de Ignacio de la Llave,40,040 Coatzintla,Total,2586,2500,86,1313
30 Veracruz de Ignacio de la Llave,40,040 Coatzintla,Total,2337,2291,46,1136
30 Veracruz de Ignacio de la Llave,40,040 Coatzintla,Total,2499,2468,31,1155
30 Veracruz de Ignacio de la Llave,40,040 Coatzintla,Total,2315,2285,30,1056
30 Veracruz de Ignacio de la Llave,40,040 Coatzintla,Total,1945,1922,23,884
30 Veracruz de Ignacio de la Llave,40,040 Coatzintla,Total,1462,1445,17,926
30 Veracruz de Ignacio de la Llave,40,040 Coatzintla,Total,961,951,10,838
30 Veracruz de Ignacio de la Llave,40,040 Coatzintla,Total,629,616,13,816
30 Veracruz de Ignacio de la Llave,40,040 Coatzintla,Total,345,338,7,692
30 Veracruz de Ignacio de la Llave,40,040 Coatzintla,Total,269,262,7,637
30 Veracruz de Ignacio de la Llave,40,040 Coatzintla,Total,117,113,4,435
30 Veracruz de Ignacio de la Llave,40,040 Coatzintla,Total,54,53,1,276
30 Veracruz de Ignacio de la Llave,40,040 Coatzintla,Total,37,37,0,250
30 Veracruz de Ignacio de la Llave,40,040 Coatzintla,Hombres,12888,12503,385,4802
30 Veracruz de Ignacio de la Llave,40,040 Coatzintla,Hombres,31,27,4,1379
30 Veracruz de Ignacio de la Llave,40,040 Coatzintla,Hombres,635,575,60,1660
30 Veracruz de Ignacio de la Llave,40,040 Coatzintla,Hombres,1525,1435,90,458
30 Veracruz de Ignacio de la Llave,40,040 Coatzintla,Hombres,1738,1678,60,70
30 Veracruz de Ignacio de la Llave,40,040 Coatzintla,Hombres,1578,1537,41,31
30 Veracruz de Ignacio de la Llave,40,040 Coatzintla,Hombres,1641,1613,28,28
30 Veracruz de Ignacio de la Llave,40,040 Coatzintla,Hombres,1522,1498,24,37
30 Veracruz de Ignacio de la Llave,40,040 Coatzintla,Hombres,1327,1305,22,44
30 Veracruz de Ignacio de la Llave,40,040 Coatzintla,Hombres,1046,1030,16,99
30 Veracruz de Ignacio de la Llave,40,040 Coatzintla,Hombres,693,683,10,132
30 Veracruz de Ignacio de la Llave,40,040 Coatzintla,Hombres,474,462,12,175
30 Veracruz de Ignacio de la Llave,40,040 Coatzintla,Hombres,271,264,7,201
30 Veracruz de Ignacio de la Llave,40,040 Coatzintla,Hombres,225,219,6,151
30 Veracruz de Ignacio de la Llave,40,040 Coatzintla,Hombres,99,95,4,136
30 Veracruz de Ignacio de la Llave,40,040 Coatzintla,Hombres,48,47,1,112
30 Veracruz de Ignacio de la Llave,40,040 Coatzintla,Hombres,35,35,0,89
30 Veracruz de Ignacio de la Llave,40,040 Coatzintla,Mujeres,5786,5698,88,13818
30 Veracruz de Ignacio de la Llave,40,040 Coatzintla,Mujeres,4,4,0,1299
30 Veracruz de Ignacio de la Llave,40,040 Coatzintla,Mujeres,229,214,15,2072
30 Veracruz de Ignacio de la Llave,40,040 Coatzintla,Mujeres,694,665,29,1338
30 Veracruz de Ignacio de la Llave,40,040 Coatzintla,Mujeres,848,822,26,1243
30 Veracruz de Ignacio de la Llave,40,040 Coatzintla,Mujeres,759,754,5,1105
30 Veracruz de Ignacio de la Llave,40,040 Coatzintla,Mujeres,858,855,3,1127
30 Veracruz de Ignacio de la Llave,40,040 Coatzintla,Mujeres,793,787,6,1019
30 Veracruz de Ignacio de la Llave,40,040 Coatzintla,Mujeres,618,617,1,840
30 Veracruz de Ignacio de la Llave,40,040 Coatzintla,Mujeres,416,415,1,827
30 Veracruz de Ignacio de la Llave,40,040 Coatzintla,Mujeres,268,268,0,706
30 Veracruz de Ignacio de la Llave,40,040 Coatzintla,Mujeres,155,154,1,641
30 Veracruz de Ignacio de la Llave,40,040 Coatzintla,Mujeres,74,74,0,491
30 Veracruz de Ignacio de la Llave,40,040 Coatzintla,Mujeres,44,43,1,486
30 Veracruz de Ignacio de la Llave,40,040 Coatzintla,Mujeres,18,18,0,299
30 Veracruz de Ignacio de la Llave,40,040 Coatzintla,Mujeres,6,6,0,164
30 Veracruz de Ignacio de la Llave,40,040 Coatzintla,Mujeres,2,2,0,161
30 Veracruz de Ignacio de la Llave,41,041 Coetzala,Total,703,687,16,871
30 Veracruz de Ignacio de la Llave,41,041 Coetzala,Total,6,6,0,137
30 Veracruz de Ignacio de la Llave,41,041 Coetzala,Total,36,34,2,164
30 Veracruz de Ignacio de la Llave,41,041 Coetzala,Total,103,100,3,83
30 Veracruz de Ignacio de la Llave,41,041 Coetzala,Total,88,84,4,74
30 Veracruz de Ignacio de la Llave,41,041 Coetzala,Total,99,97,2,60
30 Veracruz de Ignacio de la Llave,41,041 Coetzala,Total,79,78,1,63
30 Veracruz de Ignacio de la Llave,41,041 Coetzala,Total,80,80,0,41
30 Veracruz de Ignacio de la Llave,41,041 Coetzala,Total,46,45,1,42
30 Veracruz de Ignacio de la Llave,41,041 Coetzala,Total,35,35,0,38
30 Veracruz de Ignacio de la Llave,41,041 Coetzala,Total,35,34,1,35
30 Veracruz de Ignacio de la Llave,41,041 Coetzala,Total,31,31,0,33
30 Veracruz de Ignacio de la Llave,41,041 Coetzala,Total,29,28,1,31
30 Veracruz de Ignacio de la Llave,41,041 Coetzala,Total,23,22,1,31
30 Veracruz de Ignacio de la Llave,41,041 Coetzala,Total,7,7,0,16
30 Veracruz de Ignacio de la Llave,41,041 Coetzala,Total,5,5,0,12
30 Veracruz de Ignacio de la Llave,41,041 Coetzala,Total,1,1,0,11
30 Veracruz de Ignacio de la Llave,41,041 Coetzala,Hombres,543,528,15,211
30 Veracruz de Ignacio de la Llave,41,041 Coetzala,Hombres,3,3,0,66
30 Veracruz de Ignacio de la Llave,41,041 Coetzala,Hombres,29,27,2,63
30 Veracruz de Ignacio de la Llave,41,041 Coetzala,Hombres,73,71,2,12
30 Veracruz de Ignacio de la Llave,41,041 Coetzala,Hombres,68,64,4,11
30 Veracruz de Ignacio de la Llave,41,041 Coetzala,Hombres,69,67,2,13
30 Veracruz de Ignacio de la Llave,41,041 Coetzala,Hombres,57,56,1,3
30 Veracruz de Ignacio de la Llave,41,041 Coetzala,Hombres,63,63,0,2
30 Veracruz de Ignacio de la Llave,41,041 Coetzala,Hombres,36,35,1,4
30 Veracruz de Ignacio de la Llave,41,041 Coetzala,Hombres,28,28,0,3
30 Veracruz de Ignacio de la Llave,41,041 Coetzala,Hombres,31,30,1,5
30 Veracruz de Ignacio de la Llave,41,041 Coetzala,Hombres,25,25,0,5
30 Veracruz de Ignacio de la Llave,41,041 Coetzala,Hombres,26,25,1,6
30 Veracruz de Ignacio de la Llave,41,041 Coetzala,Hombres,23,22,1,4
30 Veracruz de Ignacio de la Llave,41,041 Coetzala,Hombres,6,6,0,2
30 Veracruz de Ignacio de la Llave,41,041 Coetzala,Hombres,5,5,0,7
30 Veracruz de Ignacio de la Llave,41,041 Coetzala,Hombres,1,1,0,5
30 Veracruz de Ignacio de la Llave,41,041 Coetzala,Mujeres,160,159,1,660
30 Veracruz de Ignacio de la Llave,41,041 Coetzala,Mujeres,3,3,0,71
30 Veracruz de Ignacio de la Llave,41,041 Coetzala,Mujeres,7,7,0,101
30 Veracruz de Ignacio de la Llave,41,041 Coetzala,Mujeres,30,29,1,71
30 Veracruz de Ignacio de la Llave,41,041 Coetzala,Mujeres,20,20,0,63
30 Veracruz de Ignacio de la Llave,41,041 Coetzala,Mujeres,30,30,0,47
30 Veracruz de Ignacio de la Llave,41,041 Coetzala,Mujeres,22,22,0,60
30 Veracruz de Ignacio de la Llave,41,041 Coetzala,Mujeres,17,17,0,39
30 Veracruz de Ignacio de la Llave,41,041 Coetzala,Mujeres,10,10,0,38
30 Veracruz de Ignacio de la Llave,41,041 Coetzala,Mujeres,7,7,0,35
30 Veracruz de Ignacio de la Llave,41,041 Coetzala,Mujeres,4,4,0,30
30 Veracruz de Ignacio de la Llave,41,041 Coetzala,Mujeres,6,6,0,28
30 Veracruz de Ignacio de la Llave,41,041 Coetzala,Mujeres,3,3,0,25
30 Veracruz de Ignacio de la Llave,41,041 Coetzala,Mujeres,0,0,0,27
30 Veracruz de Ignacio de la Llave,41,041 Coetzala,Mujeres,1,1,0,14
30 Veracruz de Ignacio de la Llave,41,041 Coetzala,Mujeres,0,0,0,5
30 Veracruz de Ignacio de la Llave,41,041 Coetzala,Mujeres,0,0,0,6
30 Veracruz de Ignacio de la Llave,42,042 Colipa,Total,1809,1732,77,2544
30 Veracruz de Ignacio de la Llave,42,042 Colipa,Total,32,29,3,369
30 Veracruz de Ignacio de la Llave,42,042 Colipa,Total,164,156,8,458
30 Veracruz de Ignacio de la Llave,42,042 Colipa,Total,187,180,7,218
30 Veracruz de Ignacio de la Llave,42,042 Colipa,Total,158,153,5,154
30 Veracruz de Ignacio de la Llave,42,042 Colipa,Total,152,146,6,140
30 Veracruz de Ignacio de la Llave,42,042 Colipa,Total,194,183,11,173
30 Veracruz de Ignacio de la Llave,42,042 Colipa,Total,178,172,6,147
30 Veracruz de Ignacio de la Llave,42,042 Colipa,Total,147,143,4,137
30 Veracruz de Ignacio de la Llave,42,042 Colipa,Total,143,136,7,133
30 Veracruz de Ignacio de la Llave,42,042 Colipa,Total,140,133,7,116
30 Veracruz de Ignacio de la Llave,42,042 Colipa,Total,100,98,2,112
30 Veracruz de Ignacio de la Llave,42,042 Colipa,Total,84,81,3,88
30 Veracruz de Ignacio de la Llave,42,042 Colipa,Total,69,66,3,109
30 Veracruz de Ignacio de la Llave,42,042 Colipa,Total,37,33,4,85
30 Veracruz de Ignacio de la Llave,42,042 Colipa,Total,16,15,1,45
30 Veracruz de Ignacio de la Llave,42,042 Colipa,Total,8,8,0,60
30 Veracruz de Ignacio de la Llave,42,042 Colipa,Hombres,1522,1448,74,595
30 Veracruz de Ignacio de la Llave,42,042 Colipa,Hombres,32,29,3,171
30 Veracruz de Ignacio de la Llave,42,042 Colipa,Hombres,140,133,7,180
30 Veracruz de Ignacio de la Llave,42,042 Colipa,Hombres,151,146,5,41
30 Veracruz de Ignacio de la Llave,42,042 Colipa,Hombres,123,118,5,11
30 Veracruz de Ignacio de la Llave,42,042 Colipa,Hombres,123,117,6,5
30 Veracruz de Ignacio de la Llave,42,042 Colipa,Hombres,161,150,11,11
30 Veracruz de Ignacio de la Llave,42,042 Colipa,Hombres,148,142,6,13
30 Veracruz de Ignacio de la Llave,42,042 Colipa,Hombres,120,116,4,11
30 Veracruz de Ignacio de la Llave,42,042 Colipa,Hombres,113,106,7,10
30 Veracruz de Ignacio de la Llave,42,042 Colipa,Hombres,123,116,7,15
30 Veracruz de Ignacio de la Llave,42,042 Colipa,Hombres,85,83,2,11
30 Veracruz de Ignacio de la Llave,42,042 Colipa,Hombres,78,75,3,19
30 Veracruz de Ignacio de la Llave,42,042 Colipa,Hombres,67,64,3,18
30 Veracruz de Ignacio de la Llave,42,042 Colipa,Hombres,34,30,4,31
30 Veracruz de Ignacio de la Llave,42,042 Colipa,Hombres,16,15,1,17
30 Veracruz de Ignacio de la Llave,42,042 Colipa,Hombres,8,8,0,31
30 Veracruz de Ignacio de la Llave,42,042 Colipa,Mujeres,287,284,3,1949
30 Veracruz de Ignacio de la Llave,42,042 Colipa,Mujeres,0,0,0,198
30 Veracruz de Ignacio de la Llave,42,042 Colipa,Mujeres,24,23,1,278
30 Veracruz de Ignacio de la Llave,42,042 Colipa,Mujeres,36,34,2,177
30 Veracruz de Ignacio de la Llave,42,042 Colipa,Mujeres,35,35,0,143
30 Veracruz de Ignacio de la Llave,42,042 Colipa,Mujeres,29,29,0,135
30 Veracruz de Ignacio de la Llave,42,042 Colipa,Mujeres,33,33,0,162
30 Veracruz de Ignacio de la Llave,42,042 Colipa,Mujeres,30,30,0,134
30 Veracruz de Ignacio de la Llave,42,042 Colipa,Mujeres,27,27,0,126
30 Veracruz de Ignacio de la Llave,42,042 Colipa,Mujeres,30,30,0,123
30 Veracruz de Ignacio de la Llave,42,042 Colipa,Mujeres,17,17,0,101
30 Veracruz de Ignacio de la Llave,42,042 Colipa,Mujeres,15,15,0,101
30 Veracruz de Ignacio de la Llave,42,042 Colipa,Mujeres,6,6,0,69
30 Veracruz de Ignacio de la Llave,42,042 Colipa,Mujeres,2,2,0,91
30 Veracruz de Ignacio de la Llave,42,042 Colipa,Mujeres,3,3,0,54
30 Veracruz de Ignacio de la Llave,42,042 Colipa,Mujeres,0,0,0,28
30 Veracruz de Ignacio de la Llave,42,042 Colipa,Mujeres,0,0,0,29
30 Veracruz de Ignacio de la Llave,43,043 Comapa,Total,6604,6413,191,7689
30 Veracruz de Ignacio de la Llave,43,043 Comapa,Total,148,141,7,1184
30 Veracruz de Ignacio de la Llave,43,043 Comapa,Total,913,874,39,1299
30 Veracruz de Ignacio de la Llave,43,043 Comapa,Total,977,950,27,818
30 Veracruz de Ignacio de la Llave,43,043 Comapa,Total,711,694,17,671
30 Veracruz de Ignacio de la Llave,43,043 Comapa,Total,605,582,23,633
30 Veracruz de Ignacio de la Llave,43,043 Comapa,Total,671,655,16,562
30 Veracruz de Ignacio de la Llave,43,043 Comapa,Total,605,596,9,510
30 Veracruz de Ignacio de la Llave,43,043 Comapa,Total,484,467,17,440
30 Veracruz de Ignacio de la Llave,43,043 Comapa,Total,378,364,14,345
30 Veracruz de Ignacio de la Llave,43,043 Comapa,Total,337,334,3,274
30 Veracruz de Ignacio de la Llave,43,043 Comapa,Total,253,246,7,221
30 Veracruz de Ignacio de la Llave,43,043 Comapa,Total,196,193,3,201
30 Veracruz de Ignacio de la Llave,43,043 Comapa,Total,168,163,5,174
30 Veracruz de Ignacio de la Llave,43,043 Comapa,Total,87,85,2,140
30 Veracruz de Ignacio de la Llave,43,043 Comapa,Total,43,42,1,93
30 Veracruz de Ignacio de la Llave,43,043 Comapa,Total,28,27,1,124
30 Veracruz de Ignacio de la Llave,43,043 Comapa,Hombres,5942,5755,187,1315
30 Veracruz de Ignacio de la Llave,43,043 Comapa,Hombres,135,128,7,546
30 Veracruz de Ignacio de la Llave,43,043 Comapa,Hombres,764,725,39,372
30 Veracruz de Ignacio de la Llave,43,043 Comapa,Hombres,809,784,25,69
30 Veracruz de Ignacio de la Llave,43,043 Comapa,Hombres,631,615,16,30
30 Veracruz de Ignacio de la Llave,43,043 Comapa,Hombres,548,525,23,31
30 Veracruz de Ignacio de la Llave,43,043 Comapa,Hombres,605,589,16,22
30 Veracruz de Ignacio de la Llave,43,043 Comapa,Hombres,576,567,9,28
30 Veracruz de Ignacio de la Llave,43,043 Comapa,Hombres,457,440,17,26
30 Veracruz de Ignacio de la Llave,43,043 Comapa,Hombres,352,338,14,14
30 Veracruz de Ignacio de la Llave,43,043 Comapa,Hombres,324,321,3,24
30 Veracruz de Ignacio de la Llave,43,043 Comapa,Hombres,242,235,7,15
30 Veracruz de Ignacio de la Llave,43,043 Comapa,Hombres,182,179,3,24
30 Veracruz de Ignacio de la Llave,43,043 Comapa,Hombres,161,157,4,34
30 Veracruz de Ignacio de la Llave,43,043 Comapa,Hombres,86,84,2,24
30 Veracruz de Ignacio de la Llave,43,043 Comapa,Hombres,42,41,1,18
30 Veracruz de Ignacio de la Llave,43,043 Comapa,Hombres,28,27,1,38
30 Veracruz de Ignacio de la Llave,43,043 Comapa,Mujeres,662,658,4,6374
30 Veracruz de Ignacio de la Llave,43,043 Comapa,Mujeres,13,13,0,638
30 Veracruz de Ignacio de la Llave,43,043 Comapa,Mujeres,149,149,0,927
30 Veracruz de Ignacio de la Llave,43,043 Comapa,Mujeres,168,166,2,749
30 Veracruz de Ignacio de la Llave,43,043 Comapa,Mujeres,80,79,1,641
30 Veracruz de Ignacio de la Llave,43,043 Comapa,Mujeres,57,57,0,602
30 Veracruz de Ignacio de la Llave,43,043 Comapa,Mujeres,66,66,0,540
30 Veracruz de Ignacio de la Llave,43,043 Comapa,Mujeres,29,29,0,482
30 Veracruz de Ignacio de la Llave,43,043 Comapa,Mujeres,27,27,0,414
30 Veracruz de Ignacio de la Llave,43,043 Comapa,Mujeres,26,26,0,331
30 Veracruz de Ignacio de la Llave,43,043 Comapa,Mujeres,13,13,0,250
30 Veracruz de Ignacio de la Llave,43,043 Comapa,Mujeres,11,11,0,206
30 Veracruz de Ignacio de la Llave,43,043 Comapa,Mujeres,14,14,0,177
30 Veracruz de Ignacio de la Llave,43,043 Comapa,Mujeres,7,6,1,140
30 Veracruz de Ignacio de la Llave,43,043 Comapa,Mujeres,1,1,0,116
30 Veracruz de Ignacio de la Llave,43,043 Comapa,Mujeres,1,1,0,75
30 Veracruz de Ignacio de la Llave,43,043 Comapa,Mujeres,0,0,0,86
30 Veracruz de Ignacio de la Llave,44,044 Córdoba,Total,85004,81577,3427,68124
30 Veracruz de Ignacio de la Llave,44,044 Córdoba,Total,384,327,57,9761
30 Veracruz de Ignacio de la Llave,44,044 Córdoba,Total,4964,4446,518,13192
30 Veracruz de Ignacio de la Llave,44,044 Córdoba,Total,10474,9785,689,7112
30 Veracruz de Ignacio de la Llave,44,044 Córdoba,Total,11406,10897,509,4199
30 Veracruz de Ignacio de la Llave,44,044 Córdoba,Total,10859,10536,323,3790
30 Veracruz de Ignacio de la Llave,44,044 Córdoba,Total,11232,10944,288,3843
30 Veracruz de Ignacio de la Llave,44,044 Córdoba,Total,9825,9597,228,3420
30 Veracruz de Ignacio de la Llave,44,044 Córdoba,Total,8110,7919,191,3105
30 Veracruz de Ignacio de la Llave,44,044 Córdoba,Total,6680,6493,187,3191
30 Veracruz de Ignacio de la Llave,44,044 Córdoba,Total,4757,4575,182,2986
30 Veracruz de Ignacio de la Llave,44,044 Córdoba,Total,2766,2672,94,3319
30 Veracruz de Ignacio de la Llave,44,044 Córdoba,Total,1609,1543,66,2803
30 Veracruz de Ignacio de la Llave,44,044 Córdoba,Total,971,921,50,2692
30 Veracruz de Ignacio de la Llave,44,044 Córdoba,Total,535,507,28,1985
30 Veracruz de Ignacio de la Llave,44,044 Córdoba,Total,273,266,7,1445
30 Veracruz de Ignacio de la Llave,44,044 Córdoba,Total,159,149,10,1281
30 Veracruz de Ignacio de la Llave,44,044 Córdoba,Hombres,52250,49757,2493,17695
30 Veracruz de Ignacio de la Llave,44,044 Córdoba,Hombres,312,267,45,4859
30 Veracruz de Ignacio de la Llave,44,044 Córdoba,Hombres,3467,3082,385,5592
30 Veracruz de Ignacio de la Llave,44,044 Córdoba,Hombres,6336,5900,436,1941
30 Veracruz de Ignacio de la Llave,44,044 Córdoba,Hombres,6698,6381,317,360
30 Veracruz de Ignacio de la Llave,44,044 Córdoba,Hombres,6381,6166,215,133
30 Veracruz de Ignacio de la Llave,44,044 Córdoba,Hombres,6630,6412,218,141
30 Veracruz de Ignacio de la Llave,44,044 Córdoba,Hombres,5723,5553,170,155
30 Veracruz de Ignacio de la Llave,44,044 Córdoba,Hombres,4977,4824,153,153
30 Veracruz de Ignacio de la Llave,44,044 Córdoba,Hombres,4152,3991,161,274
30 Veracruz de Ignacio de la Llave,44,044 Córdoba,Hombres,3159,2998,161,380
30 Veracruz de Ignacio de la Llave,44,044 Córdoba,Hombres,1895,1805,90,764
30 Veracruz de Ignacio de la Llave,44,044 Córdoba,Hombres,1110,1050,60,744
30 Veracruz de Ignacio de la Llave,44,044 Córdoba,Hombres,686,641,45,767
30 Veracruz de Ignacio de la Llave,44,044 Córdoba,Hombres,399,377,22,619
30 Veracruz de Ignacio de la Llave,44,044 Córdoba,Hombres,210,204,6,441
30 Veracruz de Ignacio de la Llave,44,044 Córdoba,Hombres,115,106,9,372
30 Veracruz de Ignacio de la Llave,44,044 Córdoba,Mujeres,32754,31820,934,50429
30 Veracruz de Ignacio de la Llave,44,044 Córdoba,Mujeres,72,60,12,4902
30 Veracruz de Ignacio de la Llave,44,044 Córdoba,Mujeres,1497,1364,133,7600
30 Veracruz de Ignacio de la Llave,44,044 Córdoba,Mujeres,4138,3885,253,5171
30 Veracruz de Ignacio de la Llave,44,044 Córdoba,Mujeres,4708,4516,192,3839
30 Veracruz de Ignacio de la Llave,44,044 Córdoba,Mujeres,4478,4370,108,3657
30 Veracruz de Ignacio de la Llave,44,044 Córdoba,Mujeres,4602,4532,70,3702
30 Veracruz de Ignacio de la Llave,44,044 Córdoba,Mujeres,4102,4044,58,3265
30 Veracruz de Ignacio de la Llave,44,044 Córdoba,Mujeres,3133,3095,38,2952
30 Veracruz de Ignacio de la Llave,44,044 Córdoba,Mujeres,2528,2502,26,2917
30 Veracruz de Ignacio de la Llave,44,044 Córdoba,Mujeres,1598,1577,21,2606
30 Veracruz de Ignacio de la Llave,44,044 Córdoba,Mujeres,871,867,4,2555
30 Veracruz de Ignacio de la Llave,44,044 Córdoba,Mujeres,499,493,6,2059
30 Veracruz de Ignacio de la Llave,44,044 Córdoba,Mujeres,285,280,5,1925
30 Veracruz de Ignacio de la Llave,44,044 Córdoba,Mujeres,136,130,6,1366
30 Veracruz de Ignacio de la Llave,44,044 Córdoba,Mujeres,63,62,1,1004
30 Veracruz de Ignacio de la Llave,44,044 Córdoba,Mujeres,44,43,1,909
30 Veracruz de Ignacio de la Llave,45,045 Cosamaloapan de Carpio,Total,23254,21960,1294,22323
30 Veracruz de Ignacio de la Llave,45,045 Cosamaloapan de Carpio,Total,205,187,18,2760
30 Veracruz de Ignacio de la Llave,45,045 Cosamaloapan de Carpio,Total,1421,1289,132,3607
30 Veracruz de Ignacio de la Llave,45,045 Cosamaloapan de Carpio,Total,2628,2418,210,1902
30 Veracruz de Ignacio de la Llave,45,045 Cosamaloapan de Carpio,Total,2747,2579,168,1355
30 Veracruz de Ignacio de la Llave,45,045 Cosamaloapan de Carpio,Total,2721,2601,120,1293
30 Veracruz de Ignacio de la Llave,45,045 Cosamaloapan de Carpio,Total,2992,2840,152,1283
30 Veracruz de Ignacio de la Llave,45,045 Cosamaloapan de Carpio,Total,2794,2674,120,1230
30 Veracruz de Ignacio de la Llave,45,045 Cosamaloapan de Carpio,Total,2438,2333,105,1160
30 Veracruz de Ignacio de la Llave,45,045 Cosamaloapan de Carpio,Total,1888,1802,86,1301
30 Veracruz de Ignacio de la Llave,45,045 Cosamaloapan de Carpio,Total,1421,1358,63,1198
30 Veracruz de Ignacio de la Llave,45,045 Cosamaloapan de Carpio,Total,831,788,43,1297
30 Veracruz de Ignacio de la Llave,45,045 Cosamaloapan de Carpio,Total,508,475,33,1102
30 Veracruz de Ignacio de la Llave,45,045 Cosamaloapan de Carpio,Total,366,350,16,1088
30 Veracruz de Ignacio de la Llave,45,045 Cosamaloapan de Carpio,Total,176,155,21,766
30 Veracruz de Ignacio de la Llave,45,045 Cosamaloapan de Carpio,Total,81,77,4,513
30 Veracruz de Ignacio de la Llave,45,045 Cosamaloapan de Carpio,Total,37,34,3,468
30 Veracruz de Ignacio de la Llave,45,045 Cosamaloapan de Carpio,Hombres,15736,14663,1073,5863
30 Veracruz de Ignacio de la Llave,45,045 Cosamaloapan de Carpio,Hombres,160,144,16,1343
30 Veracruz de Ignacio de la Llave,45,045 Cosamaloapan de Carpio,Hombres,1079,970,109,1511
30 Veracruz de Ignacio de la Llave,45,045 Cosamaloapan de Carpio,Hombres,1788,1653,135,412
30 Veracruz de Ignacio de la Llave,45,045 Cosamaloapan de Carpio,Hombres,1782,1646,136,115
30 Veracruz de Ignacio de la Llave,45,045 Cosamaloapan de Carpio,Hombres,1770,1673,97,74
30 Veracruz de Ignacio de la Llave,45,045 Cosamaloapan de Carpio,Hombres,1873,1747,126,72
30 Veracruz de Ignacio de la Llave,45,045 Cosamaloapan de Carpio,Hombres,1801,1699,102,76
30 Veracruz de Ignacio de la Llave,45,045 Cosamaloapan de Carpio,Hombres,1618,1520,98,66
30 Veracruz de Ignacio de la Llave,45,045 Cosamaloapan de Carpio,Hombres,1292,1213,79,147
30 Veracruz de Ignacio de la Llave,45,045 Cosamaloapan de Carpio,Hombres,1056,995,61,164
30 Veracruz de Ignacio de la Llave,45,045 Cosamaloapan de Carpio,Hombres,632,591,41,399
30 Veracruz de Ignacio de la Llave,45,045 Cosamaloapan de Carpio,Hombres,371,341,30,363
30 Veracruz de Ignacio de la Llave,45,045 Cosamaloapan de Carpio,Hombres,276,260,16,370
30 Veracruz de Ignacio de la Llave,45,045 Cosamaloapan de Carpio,Hombres,143,122,21,318
30 Veracruz de Ignacio de la Llave,45,045 Cosamaloapan de Carpio,Hombres,65,62,3,226
30 Veracruz de Ignacio de la Llave,45,045 Cosamaloapan de Carpio,Hombres,30,27,3,207
30 Veracruz de Ignacio de la Llave,45,045 Cosamaloapan de Carpio,Mujeres,7518,7297,221,16460
30 Veracruz de Ignacio de la Llave,45,045 Cosamaloapan de Carpio,Mujeres,45,43,2,1417
30 Veracruz de Ignacio de la Llave,45,045 Cosamaloapan de Carpio,Mujeres,342,319,23,2096
30 Veracruz de Ignacio de la Llave,45,045 Cosamaloapan de Carpio,Mujeres,840,765,75,1490
30 Veracruz de Ignacio de la Llave,45,045 Cosamaloapan de Carpio,Mujeres,965,933,32,1240
30 Veracruz de Ignacio de la Llave,45,045 Cosamaloapan de Carpio,Mujeres,951,928,23,1219
30 Veracruz de Ignacio de la Llave,45,045 Cosamaloapan de Carpio,Mujeres,1119,1093,26,1211
30 Veracruz de Ignacio de la Llave,45,045 Cosamaloapan de Carpio,Mujeres,993,975,18,1154
30 Veracruz de Ignacio de la Llave,45,045 Cosamaloapan de Carpio,Mujeres,820,813,7,1094
30 Veracruz de Ignacio de la Llave,45,045 Cosamaloapan de Carpio,Mujeres,596,589,7,1154
30 Veracruz de Ignacio de la Llave,45,045 Cosamaloapan de Carpio,Mujeres,365,363,2,1034
30 Veracruz de Ignacio de la Llave,45,045 Cosamaloapan de Carpio,Mujeres,199,197,2,898
30 Veracruz de Ignacio de la Llave,45,045 Cosamaloapan de Carpio,Mujeres,137,134,3,739
30 Veracruz de Ignacio de la Llave,45,045 Cosamaloapan de Carpio,Mujeres,90,90,0,718
30 Veracruz de Ignacio de la Llave,45,045 Cosamaloapan de Carpio,Mujeres,33,33,0,448
30 Veracruz de Ignacio de la Llave,45,045 Cosamaloapan de Carpio,Mujeres,16,15,1,287
30 Veracruz de Ignacio de la Llave,45,045 Cosamaloapan de Carpio,Mujeres,7,7,0,261
30 Veracruz de Ignacio de la Llave,46,046 Cosautlán de Carvajal,Total,5626,5486,140,6106
30 Veracruz de Ignacio de la Llave,46,046 Cosautlán de Carvajal,Total,53,51,2,900
30 Veracruz de Ignacio de la Llave,46,046 Cosautlán de Carvajal,Total,556,534,22,930
30 Veracruz de Ignacio de la Llave,46,046 Cosautlán de Carvajal,Total,819,789,30,600
30 Veracruz de Ignacio de la Llave,46,046 Cosautlán de Carvajal,Total,676,656,20,557
30 Veracruz de Ignacio de la Llave,46,046 Cosautlán de Carvajal,Total,718,704,14,538
30 Veracruz de Ignacio de la Llave,46,046 Cosautlán de Carvajal,Total,580,564,16,430
30 Veracruz de Ignacio de la Llave,46,046 Cosautlán de Carvajal,Total,505,498,7,403
30 Veracruz de Ignacio de la Llave,46,046 Cosautlán de Carvajal,Total,440,431,9,309
30 Veracruz de Ignacio de la Llave,46,046 Cosautlán de Carvajal,Total,354,347,7,272
30 Veracruz de Ignacio de la Llave,46,046 Cosautlán de Carvajal,Total,318,314,4,267
30 Veracruz de Ignacio de la Llave,46,046 Cosautlán de Carvajal,Total,216,212,4,225
30 Veracruz de Ignacio de la Llave,46,046 Cosautlán de Carvajal,Total,177,174,3,145
30 Veracruz de Ignacio de la Llave,46,046 Cosautlán de Carvajal,Total,98,98,0,198
30 Veracruz de Ignacio de la Llave,46,046 Cosautlán de Carvajal,Total,69,68,1,139
30 Veracruz de Ignacio de la Llave,46,046 Cosautlán de Carvajal,Total,30,29,1,103
30 Veracruz de Ignacio de la Llave,46,046 Cosautlán de Carvajal,Total,17,17,0,90
30 Veracruz de Ignacio de la Llave,46,046 Cosautlán de Carvajal,Hombres,4695,4565,130,1047
30 Veracruz de Ignacio de la Llave,46,046 Cosautlán de Carvajal,Hombres,46,44,2,411
30 Veracruz de Ignacio de la Llave,46,046 Cosautlán de Carvajal,Hombres,465,446,19,273
30 Veracruz de Ignacio de la Llave,46,046 Cosautlán de Carvajal,Hombres,651,624,27,77
30 Veracruz de Ignacio de la Llave,46,046 Cosautlán de Carvajal,Hombres,551,533,18,17
30 Veracruz de Ignacio de la Llave,46,046 Cosautlán de Carvajal,Hombres,600,586,14,25
30 Veracruz de Ignacio de la Llave,46,046 Cosautlán de Carvajal,Hombres,481,465,16,17
30 Veracruz de Ignacio de la Llave,46,046 Cosautlán de Carvajal,Hombres,409,402,7,16
30 Veracruz de Ignacio de la Llave,46,046 Cosautlán de Carvajal,Hombres,367,358,9,16
30 Veracruz de Ignacio de la Llave,46,046 Cosautlán de Carvajal,Hombres,303,297,6,12
30 Veracruz de Ignacio de la Llave,46,046 Cosautlán de Carvajal,Hombres,279,276,3,22
30 Veracruz de Ignacio de la Llave,46,046 Cosautlán de Carvajal,Hombres,197,193,4,25
30 Veracruz de Ignacio de la Llave,46,046 Cosautlán de Carvajal,Hombres,152,149,3,15
30 Veracruz de Ignacio de la Llave,46,046 Cosautlán de Carvajal,Hombres,90,90,0,35
30 Veracruz de Ignacio de la Llave,46,046 Cosautlán de Carvajal,Hombres,61,60,1,29
30 Veracruz de Ignacio de la Llave,46,046 Cosautlán de Carvajal,Hombres,26,25,1,36
30 Veracruz de Ignacio de la Llave,46,046 Cosautlán de Carvajal,Hombres,17,17,0,21
30 Veracruz de Ignacio de la Llave,46,046 Cosautlán de Carvajal,Mujeres,931,921,10,5059
30 Veracruz de Ignacio de la Llave,46,046 Cosautlán de Carvajal,Mujeres,7,7,0,489
30 Veracruz de Ignacio de la Llave,46,046 Cosautlán de Carvajal,Mujeres,91,88,3,657
30 Veracruz de Ignacio de la Llave,46,046 Cosautlán de Carvajal,Mujeres,168,165,3,523
30 Veracruz de Ignacio de la Llave,46,046 Cosautlán de Carvajal,Mujeres,125,123,2,540
30 Veracruz de Ignacio de la Llave,46,046 Cosautlán de Carvajal,Mujeres,118,118,0,513
30 Veracruz de Ignacio de la Llave,46,046 Cosautlán de Carvajal,Mujeres,99,99,0,413
30 Veracruz de Ignacio de la Llave,46,046 Cosautlán de Carvajal,Mujeres,96,96,0,387
30 Veracruz de Ignacio de la Llave,46,046 Cosautlán de Carvajal,Mujeres,73,73,0,293
30 Veracruz de Ignacio de la Llave,46,046 Cosautlán de Carvajal,Mujeres,51,50,1,260
30 Veracruz de Ignacio de la Llave,46,046 Cosautlán de Carvajal,Mujeres,39,38,1,245
30 Veracruz de Ignacio de la Llave,46,046 Cosautlán de Carvajal,Mujeres,19,19,0,200
30 Veracruz de Ignacio de la Llave,46,046 Cosautlán de Carvajal,Mujeres,25,25,0,130
30 Veracruz de Ignacio de la Llave,46,046 Cosautlán de Carvajal,Mujeres,8,8,0,163
30 Veracruz de Ignacio de la Llave,46,046 Cosautlán de Carvajal,Mujeres,8,8,0,110
30 Veracruz de Ignacio de la Llave,46,046 Cosautlán de Carvajal,Mujeres,4,4,0,67
30 Veracruz de Ignacio de la Llave,46,046 Cosautlán de Carvajal,Mujeres,0,0,0,69
30 Veracruz de Ignacio de la Llave,47,047 Coscomatepec,Total,17618,17005,613,17983
30 Veracruz de Ignacio de la Llave,47,047 Coscomatepec,Total,500,487,13,3203
30 Veracruz de Ignacio de la Llave,47,047 Coscomatepec,Total,2383,2291,92,3500
30 Veracruz de Ignacio de la Llave,47,047 Coscomatepec,Total,2387,2286,101,2105
30 Veracruz de Ignacio de la Llave,47,047 Coscomatepec,Total,2248,2173,75,1543
30 Veracruz de Ignacio de la Llave,47,047 Coscomatepec,Total,1996,1916,80,1404
30 Veracruz de Ignacio de la Llave,47,047 Coscomatepec,Total,1801,1746,55,1178
30 Veracruz de Ignacio de la Llave,47,047 Coscomatepec,Total,1533,1477,56,899
30 Veracruz de Ignacio de la Llave,47,047 Coscomatepec,Total,1289,1238,51,779
30 Veracruz de Ignacio de la Llave,47,047 Coscomatepec,Total,984,964,20,678
30 Veracruz de Ignacio de la Llave,47,047 Coscomatepec,Total,813,788,25,652
30 Veracruz de Ignacio de la Llave,47,047 Coscomatepec,Total,609,593,16,511
30 Veracruz de Ignacio de la Llave,47,047 Coscomatepec,Total,443,431,12,466
30 Veracruz de Ignacio de la Llave,47,047 Coscomatepec,Total,328,320,8,408
30 Veracruz de Ignacio de la Llave,47,047 Coscomatepec,Total,174,170,4,267
30 Veracruz de Ignacio de la Llave,47,047 Coscomatepec,Total,79,75,4,166
30 Veracruz de Ignacio de la Llave,47,047 Coscomatepec,Total,51,50,1,224
30 Veracruz de Ignacio de la Llave,47,047 Coscomatepec,Hombres,13810,13257,553,3214
30 Veracruz de Ignacio de la Llave,47,047 Coscomatepec,Hombres,463,450,13,1390
30 Veracruz de Ignacio de la Llave,47,047 Coscomatepec,Hombres,2002,1925,77,876
30 Veracruz de Ignacio de la Llave,47,047 Coscomatepec,Hombres,1855,1768,87,234
30 Veracruz de Ignacio de la Llave,47,047 Coscomatepec,Hombres,1689,1624,65,71
30 Veracruz de Ignacio de la Llave,47,047 Coscomatepec,Hombres,1514,1444,70,48
30 Veracruz de Ignacio de la Llave,47,047 Coscomatepec,Hombres,1344,1290,54,34
30 Veracruz de Ignacio de la Llave,47,047 Coscomatepec,Hombres,1165,1113,52,40
30 Veracruz de Ignacio de la Llave,47,047 Coscomatepec,Hombres,970,925,45,34
30 Veracruz de Ignacio de la Llave,47,047 Coscomatepec,Hombres,753,733,20,41
30 Veracruz de Ignacio de la Llave,47,047 Coscomatepec,Hombres,648,623,25,67
30 Veracruz de Ignacio de la Llave,47,047 Coscomatepec,Hombres,501,485,16,54
30 Veracruz de Ignacio de la Llave,47,047 Coscomatepec,Hombres,374,362,12,52
30 Veracruz de Ignacio de la Llave,47,047 Coscomatepec,Hombres,270,262,8,84
30 Veracruz de Ignacio de la Llave,47,047 Coscomatepec,Hombres,146,142,4,72
30 Veracruz de Ignacio de la Llave,47,047 Coscomatepec,Hombres,67,63,4,44
30 Veracruz de Ignacio de la Llave,47,047 Coscomatepec,Hombres,49,48,1,73
30 Veracruz de Ignacio de la Llave,47,047 Coscomatepec,Mujeres,3808,3748,60,14769
30 Veracruz de Ignacio de la Llave,47,047 Coscomatepec,Mujeres,37,37,0,1813
30 Veracruz de Ignacio de la Llave,47,047 Coscomatepec,Mujeres,381,366,15,2624
30 Veracruz de Ignacio de la Llave,47,047 Coscomatepec,Mujeres,532,518,14,1871
30 Veracruz de Ignacio de la Llave,47,047 Coscomatepec,Mujeres,559,549,10,1472
30 Veracruz de Ignacio de la Llave,47,047 Coscomatepec,Mujeres,482,472,10,1356
30 Veracruz de Ignacio de la Llave,47,047 Coscomatepec,Mujeres,457,456,1,1144
30 Veracruz de Ignacio de la Llave,47,047 Coscomatepec,Mujeres,368,364,4,859
30 Veracruz de Ignacio de la Llave,47,047 Coscomatepec,Mujeres,319,313,6,745
30 Veracruz de Ignacio de la Llave,47,047 Coscomatepec,Mujeres,231,231,0,637
30 Veracruz de Ignacio de la Llave,47,047 Coscomatepec,Mujeres,165,165,0,585
30 Veracruz de Ignacio de la Llave,47,047 Coscomatepec,Mujeres,108,108,0,457
30 Veracruz de Ignacio de la Llave,47,047 Coscomatepec,Mujeres,69,69,0,414
30 Veracruz de Ignacio de la Llave,47,047 Coscomatepec,Mujeres,58,58,0,324
30 Veracruz de Ignacio de la Llave,47,047 Coscomatepec,Mujeres,28,28,0,195
30 Veracruz de Ignacio de la Llave,47,047 Coscomatepec,Mujeres,12,12,0,122
30 Veracruz de Ignacio de la Llave,47,047 Coscomatepec,Mujeres,2,2,0,151
30 Veracruz de Ignacio de la Llave,48,048 Cosoleacaque,Total,47744,45766,1978,43005
30 Veracruz de Ignacio de la Llave,48,048 Cosoleacaque,Total,241,226,15,6414
30 Veracruz de Ignacio de la Llave,48,048 Cosoleacaque,Total,2862,2610,252,8969
30 Veracruz de Ignacio de la Llave,48,048 Cosoleacaque,Total,6042,5652,390,4920
30 Veracruz de Ignacio de la Llave,48,048 Cosoleacaque,Total,6684,6383,301,3201
30 Veracruz de Ignacio de la Llave,48,048 Cosoleacaque,Total,6186,5969,217,2898
30 Veracruz de Ignacio de la Llave,48,048 Cosoleacaque,Total,6225,6066,159,2776
30 Veracruz de Ignacio de la Llave,48,048 Cosoleacaque,Total,5495,5354,141,2456
30 Veracruz de Ignacio de la Llave,48,048 Cosoleacaque,Total,4702,4573,129,2139
30 Veracruz de Ignacio de la Llave,48,048 Cosoleacaque,Total,3635,3500,135,2016
30 Veracruz de Ignacio de la Llave,48,048 Cosoleacaque,Total,2538,2433,105,1784
30 Veracruz de Ignacio de la Llave,48,048 Cosoleacaque,Total,1391,1335,56,1601
30 Veracruz de Ignacio de la Llave,48,048 Cosoleacaque,Total,785,747,38,1221
30 Veracruz de Ignacio de la Llave,48,048 Cosoleacaque,Total,543,520,23,1126
30 Veracruz de Ignacio de la Llave,48,048 Cosoleacaque,Total,274,260,14,677
30 Veracruz de Ignacio de la Llave,48,048 Cosoleacaque,Total,88,85,3,430
30 Veracruz de Ignacio de la Llave,48,048 Cosoleacaque,Total,53,53,0,377
30 Veracruz de Ignacio de la Llave,48,048 Cosoleacaque,Hombres,32093,30477,1616,11092
30 Veracruz de Ignacio de la Llave,48,048 Cosoleacaque,Hombres,181,167,14,3181
30 Veracruz de Ignacio de la Llave,48,048 Cosoleacaque,Hombres,2065,1848,217,3889
30 Veracruz de Ignacio de la Llave,48,048 Cosoleacaque,Hombres,4007,3735,272,1185
30 Veracruz de Ignacio de la Llave,48,048 Cosoleacaque,Hombres,4347,4124,223,203
30 Veracruz de Ignacio de la Llave,48,048 Cosoleacaque,Hombres,3976,3812,164,100
30 Veracruz de Ignacio de la Llave,48,048 Cosoleacaque,Hombres,4016,3890,126,91
30 Veracruz de Ignacio de la Llave,48,048 Cosoleacaque,Hombres,3532,3411,121,115
30 Veracruz de Ignacio de la Llave,48,048 Cosoleacaque,Hombres,3167,3048,119,108
30 Veracruz de Ignacio de la Llave,48,048 Cosoleacaque,Hombres,2530,2405,125,203
30 Veracruz de Ignacio de la Llave,48,048 Cosoleacaque,Hombres,1849,1748,101,284
30 Veracruz de Ignacio de la Llave,48,048 Cosoleacaque,Hombres,1048,992,56,394
30 Veracruz de Ignacio de la Llave,48,048 Cosoleacaque,Hombres,597,559,38,367
30 Veracruz de Ignacio de la Llave,48,048 Cosoleacaque,Hombres,433,410,23,379
30 Veracruz de Ignacio de la Llave,48,048 Cosoleacaque,Hombres,223,209,14,267
30 Veracruz de Ignacio de la Llave,48,048 Cosoleacaque,Hombres,78,75,3,175
30 Veracruz de Ignacio de la Llave,48,048 Cosoleacaque,Hombres,44,44,0,151
30 Veracruz de Ignacio de la Llave,48,048 Cosoleacaque,Mujeres,15651,15289,362,31913
30 Veracruz de Ignacio de la Llave,48,048 Cosoleacaque,Mujeres,60,59,1,3233
30 Veracruz de Ignacio de la Llave,48,048 Cosoleacaque,Mujeres,797,762,35,5080
30 Veracruz de Ignacio de la Llave,48,048 Cosoleacaque,Mujeres,2035,1917,118,3735
30 Veracruz de Ignacio de la Llave,48,048 Cosoleacaque,Mujeres,2337,2259,78,2998
30 Veracruz de Ignacio de la Llave,48,048 Cosoleacaque,Mujeres,2210,2157,53,2798
30 Veracruz de Ignacio de la Llave,48,048 Cosoleacaque,Mujeres,2209,2176,33,2685
30 Veracruz de Ignacio de la Llave,48,048 Cosoleacaque,Mujeres,1963,1943,20,2341
30 Veracruz de Ignacio de la Llave,48,048 Cosoleacaque,Mujeres,1535,1525,10,2031
30 Veracruz de Ignacio de la Llave,48,048 Cosoleacaque,Mujeres,1105,1095,10,1813
30 Veracruz de Ignacio de la Llave,48,048 Cosoleacaque,Mujeres,689,685,4,1500
30 Veracruz de Ignacio de la Llave,48,048 Cosoleacaque,Mujeres,343,343,0,1207
30 Veracruz de Ignacio de la Llave,48,048 Cosoleacaque,Mujeres,188,188,0,854
30 Veracruz de Ignacio de la Llave,48,048 Cosoleacaque,Mujeres,110,110,0,747
30 Veracruz de Ignacio de la Llave,48,048 Cosoleacaque,Mujeres,51,51,0,410
30 Veracruz de Ignacio de la Llave,48,048 Cosoleacaque,Mujeres,10,10,0,255
30 Veracruz de Ignacio de la Llave,48,048 Cosoleacaque,Mujeres,9,9,0,226
30 Veracruz de Ignacio de la Llave,49,049 Cotaxtla,Total,6889,6657,232,8611
30 Veracruz de Ignacio de la Llave,49,049 Cotaxtla,Total,51,50,1,1162
30 Veracruz de Ignacio de la Llave,49,049 Cotaxtla,Total,612,575,37,1356
30 Veracruz de Ignacio de la Llave,49,049 Cotaxtla,Total,869,831,38,772
30 Veracruz de Ignacio de la Llave,49,049 Cotaxtla,Total,750,726,24,639
30 Veracruz de Ignacio de la Llave,49,049 Cotaxtla,Total,788,765,23,639
30 Veracruz de Ignacio de la Llave,49,049 Cotaxtla,Total,867,842,25,682
30 Veracruz de Ignacio de la Llave,49,049 Cotaxtla,Total,737,712,25,600
30 Veracruz de Ignacio de la Llave,49,049 Cotaxtla,Total,625,609,16,503
30 Veracruz de Ignacio de la Llave,49,049 Cotaxtla,Total,507,493,14,426
30 Veracruz de Ignacio de la Llave,49,049 Cotaxtla,Total,374,362,12,366
30 Veracruz de Ignacio de la Llave,49,049 Cotaxtla,Total,249,242,7,361
30 Veracruz de Ignacio de la Llave,49,049 Cotaxtla,Total,190,186,4,304
30 Veracruz de Ignacio de la Llave,49,049 Cotaxtla,Total,125,121,4,309
30 Veracruz de Ignacio de la Llave,49,049 Cotaxtla,Total,92,91,1,214
30 Veracruz de Ignacio de la Llave,49,049 Cotaxtla,Total,31,30,1,124
30 Veracruz de Ignacio de la Llave,49,049 Cotaxtla,Total,22,22,0,154
30 Veracruz de Ignacio de la Llave,49,049 Cotaxtla,Hombres,5923,5704,219,1675
30 Veracruz de Ignacio de la Llave,49,049 Cotaxtla,Hombres,50,49,1,577
30 Veracruz de Ignacio de la Llave,49,049 Cotaxtla,Hombres,519,486,33,461
30 Veracruz de Ignacio de la Llave,49,049 Cotaxtla,Hombres,704,668,36,99
30 Veracruz de Ignacio de la Llave,49,049 Cotaxtla,Hombres,621,601,20,25
30 Veracruz de Ignacio de la Llave,49,049 Cotaxtla,Hombres,659,639,20,32
30 Veracruz de Ignacio de la Llave,49,049 Cotaxtla,Hombres,708,683,25,28
30 Veracruz de Ignacio de la Llave,49,049 Cotaxtla,Hombres,648,623,25,22
30 Veracruz de Ignacio de la Llave,49,049 Cotaxtla,Hombres,536,520,16,33
30 Veracruz de Ignacio de la Llave,49,049 Cotaxtla,Hombres,452,438,14,28
30 Veracruz de Ignacio de la Llave,49,049 Cotaxtla,Hombres,346,334,12,31
30 Veracruz de Ignacio de la Llave,49,049 Cotaxtla,Hombres,238,231,7,54
30 Veracruz de Ignacio de la Llave,49,049 Cotaxtla,Hombres,183,179,4,61
30 Veracruz de Ignacio de la Llave,49,049 Cotaxtla,Hombres,116,112,4,82
30 Veracruz de Ignacio de la Llave,49,049 Cotaxtla,Hombres,90,89,1,48
30 Veracruz de Ignacio de la Llave,49,049 Cotaxtla,Hombres,31,30,1,40
30 Veracruz de Ignacio de la Llave,49,049 Cotaxtla,Hombres,22,22,0,54
30 Veracruz de Ignacio de la Llave,49,049 Cotaxtla,Mujeres,966,953,13,6936
30 Veracruz de Ignacio de la Llave,49,049 Cotaxtla,Mujeres,1,1,0,585
30 Veracruz de Ignacio de la Llave,49,049 Cotaxtla,Mujeres,93,89,4,895
30 Veracruz de Ignacio de la Llave,49,049 Cotaxtla,Mujeres,165,163,2,673
30 Veracruz de Ignacio de la Llave,49,049 Cotaxtla,Mujeres,129,125,4,614
30 Veracruz de Ignacio de la Llave,49,049 Cotaxtla,Mujeres,129,126,3,607
30 Veracruz de Ignacio de la Llave,49,049 Cotaxtla,Mujeres,159,159,0,654
30 Veracruz de Ignacio de la Llave,49,049 Cotaxtla,Mujeres,89,89,0,578
30 Veracruz de Ignacio de la Llave,49,049 Cotaxtla,Mujeres,89,89,0,470
30 Veracruz de Ignacio de la Llave,49,049 Cotaxtla,Mujeres,55,55,0,398
30 Veracruz de Ignacio de la Llave,49,049 Cotaxtla,Mujeres,28,28,0,335
30 Veracruz de Ignacio de la Llave,49,049 Cotaxtla,Mujeres,11,11,0,307
30 Veracruz de Ignacio de la Llave,49,049 Cotaxtla,Mujeres,7,7,0,243
30 Veracruz de Ignacio de la Llave,49,049 Cotaxtla,Mujeres,9,9,0,227
30 Veracruz de Ignacio de la Llave,49,049 Cotaxtla,Mujeres,2,2,0,166
30 Veracruz de Ignacio de la Llave,49,049 Cotaxtla,Mujeres,0,0,0,84
30 Veracruz de Ignacio de la Llave,49,049 Cotaxtla,Mujeres,0,0,0,100
30 Veracruz de Ignacio de la Llave,50,050 Coxquihui,Total,4834,4765,69,6505
30 Veracruz de Ignacio de la Llave,50,050 Coxquihui,Total,71,69,2,1038
30 Veracruz de Ignacio de la Llave,50,050 Coxquihui,Total,417,404,13,1320
30 Veracruz de Ignacio de la Llave,50,050 Coxquihui,Total,557,547,10,506
30 Veracruz de Ignacio de la Llave,50,050 Coxquihui,Total,476,472,4,425
30 Veracruz de Ignacio de la Llave,50,050 Coxquihui,Total,519,510,9,415
30 Veracruz de Ignacio de la Llave,50,050 Coxquihui,Total,484,478,6,419
30 Veracruz de Ignacio de la Llave,50,050 Coxquihui,Total,430,427,3,409
30 Veracruz de Ignacio de la Llave,50,050 Coxquihui,Total,412,405,7,342
30 Veracruz de Ignacio de la Llave,50,050 Coxquihui,Total,361,358,3,373
30 Veracruz de Ignacio de la Llave,50,050 Coxquihui,Total,345,344,1,339
30 Veracruz de Ignacio de la Llave,50,050 Coxquihui,Total,282,278,4,257
30 Veracruz de Ignacio de la Llave,50,050 Coxquihui,Total,206,203,3,216
30 Veracruz de Ignacio de la Llave,50,050 Coxquihui,Total,150,147,3,183
30 Veracruz de Ignacio de la Llave,50,050 Coxquihui,Total,65,65,0,113
30 Veracruz de Ignacio de la Llave,50,050 Coxquihui,Total,42,41,1,68
30 Veracruz de Ignacio de la Llave,50,050 Coxquihui,Total,17,17,0,82
30 Veracruz de Ignacio de la Llave,50,050 Coxquihui,Hombres,4117,4054,63,1341
30 Veracruz de Ignacio de la Llave,50,050 Coxquihui,Hombres,62,60,2,507
30 Veracruz de Ignacio de la Llave,50,050 Coxquihui,Hombres,358,346,12,522
30 Veracruz de Ignacio de la Llave,50,050 Coxquihui,Hombres,425,416,9,56
30 Veracruz de Ignacio de la Llave,50,050 Coxquihui,Hombres,377,375,2,18
30 Veracruz de Ignacio de la Llave,50,050 Coxquihui,Hombres,429,420,9,5
30 Veracruz de Ignacio de la Llave,50,050 Coxquihui,Hombres,425,419,6,12
30 Veracruz de Ignacio de la Llave,50,050 Coxquihui,Hombres,353,351,2,11
30 Veracruz de Ignacio de la Llave,50,050 Coxquihui,Hombres,344,338,6,7
30 Veracruz de Ignacio de la Llave,50,050 Coxquihui,Hombres,318,315,3,22
30 Veracruz de Ignacio de la Llave,50,050 Coxquihui,Hombres,315,314,1,22
30 Veracruz de Ignacio de la Llave,50,050 Coxquihui,Hombres,259,255,4,21
30 Veracruz de Ignacio de la Llave,50,050 Coxquihui,Hombres,194,191,3,28
30 Veracruz de Ignacio de la Llave,50,050 Coxquihui,Hombres,142,139,3,33
30 Veracruz de Ignacio de la Llave,50,050 Coxquihui,Hombres,63,63,0,24
30 Veracruz de Ignacio de la Llave,50,050 Coxquihui,Hombres,38,37,1,23
30 Veracruz de Ignacio de la Llave,50,050 Coxquihui,Hombres,15,15,0,30
30 Veracruz de Ignacio de la Llave,50,050 Coxquihui,Mujeres,717,711,6,5164
30 Veracruz de Ignacio de la Llave,50,050 Coxquihui,Mujeres,9,9,0,531
30 Veracruz de Ignacio de la Llave,50,050 Coxquihui,Mujeres,59,58,1,798
30 Veracruz de Ignacio de la Llave,50,050 Coxquihui,Mujeres,132,131,1,450
30 Veracruz de Ignacio de la Llave,50,050 Coxquihui,Mujeres,99,97,2,407
30 Veracruz de Ignacio de la Llave,50,050 Coxquihui,Mujeres,90,90,0,410
30 Veracruz de Ignacio de la Llave,50,050 Coxquihui,Mujeres,59,59,0,407
30 Veracruz de Ignacio de la Llave,50,050 Coxquihui,Mujeres,77,76,1,398
30 Veracruz de Ignacio de la Llave,50,050 Coxquihui,Mujeres,68,67,1,335
30 Veracruz de Ignacio de la Llave,50,050 Coxquihui,Mujeres,43,43,0,351
30 Veracruz de Ignacio de la Llave,50,050 Coxquihui,Mujeres,30,30,0,317
30 Veracruz de Ignacio de la Llave,50,050 Coxquihui,Mujeres,23,23,0,236
30 Veracruz de Ignacio de la Llave,50,050 Coxquihui,Mujeres,12,12,0,188
30 Veracruz de Ignacio de la Llave,50,050 Coxquihui,Mujeres,8,8,0,150
30 Veracruz de Ignacio de la Llave,50,050 Coxquihui,Mujeres,2,2,0,89
30 Veracruz de Ignacio de la Llave,50,050 Coxquihui,Mujeres,4,4,0,45
30 Veracruz de Ignacio de la Llave,50,050 Coxquihui,Mujeres,2,2,0,52
30 Veracruz de Ignacio de la Llave,51,051 Coyutla,Total,6932,6782,150,9450
30 Veracruz de Ignacio de la Llave,51,051 Coyutla,Total,66,63,3,1500
30 Veracruz de Ignacio de la Llave,51,051 Coyutla,Total,639,623,16,1865
30 Veracruz de Ignacio de la Llave,51,051 Coyutla,Total,828,799,29,760
30 Veracruz de Ignacio de la Llave,51,051 Coyutla,Total,752,739,13,643
30 Veracruz de Ignacio de la Llave,51,051 Coyutla,Total,706,694,12,646
30 Veracruz de Ignacio de la Llave,51,051 Coyutla,Total,713,701,12,681
30 Veracruz de Ignacio de la Llave,51,051 Coyutla,Total,673,659,14,561
30 Veracruz de Ignacio de la Llave,51,051 Coyutla,Total,665,652,13,531
30 Veracruz de Ignacio de la Llave,51,051 Coyutla,Total,529,517,12,470
30 Veracruz de Ignacio de la Llave,51,051 Coyutla,Total,499,495,4,449
30 Veracruz de Ignacio de la Llave,51,051 Coyutla,Total,343,334,9,349
30 Veracruz de Ignacio de la Llave,51,051 Coyutla,Total,210,205,5,278
30 Veracruz de Ignacio de la Llave,51,051 Coyutla,Total,158,154,4,268
30 Veracruz de Ignacio de la Llave,51,051 Coyutla,Total,83,81,2,181
30 Veracruz de Ignacio de la Llave,51,051 Coyutla,Total,46,45,1,127
30 Veracruz de Ignacio de la Llave,51,051 Coyutla,Total,22,21,1,141
30 Veracruz de Ignacio de la Llave,51,051 Coyutla,Hombres,5677,5543,134,2053
30 Veracruz de Ignacio de la Llave,51,051 Coyutla,Hombres,50,47,3,755
30 Veracruz de Ignacio de la Llave,51,051 Coyutla,Hombres,508,499,9,716
30 Veracruz de Ignacio de la Llave,51,051 Coyutla,Hombres,636,611,25,91
30 Veracruz de Ignacio de la Llave,51,051 Coyutla,Hombres,575,565,10,32
30 Veracruz de Ignacio de la Llave,51,051 Coyutla,Hombres,562,550,12,31
30 Veracruz de Ignacio de la Llave,51,051 Coyutla,Hombres,569,557,12,39
30 Veracruz de Ignacio de la Llave,51,051 Coyutla,Hombres,559,545,14,29
30 Veracruz de Ignacio de la Llave,51,051 Coyutla,Hombres,549,536,13,27
30 Veracruz de Ignacio de la Llave,51,051 Coyutla,Hombres,454,442,12,20
30 Veracruz de Ignacio de la Llave,51,051 Coyutla,Hombres,435,431,4,34
30 Veracruz de Ignacio de la Llave,51,051 Coyutla,Hombres,304,296,8,41
30 Veracruz de Ignacio de la Llave,51,051 Coyutla,Hombres,189,185,4,39
30 Veracruz de Ignacio de la Llave,51,051 Coyutla,Hombres,148,144,4,54
30 Veracruz de Ignacio de la Llave,51,051 Coyutla,Hombres,76,74,2,45
30 Veracruz de Ignacio de la Llave,51,051 Coyutla,Hombres,42,41,1,41
30 Veracruz de Ignacio de la Llave,51,051 Coyutla,Hombres,21,20,1,59
30 Veracruz de Ignacio de la Llave,51,051 Coyutla,Mujeres,1255,1239,16,7397
30 Veracruz de Ignacio de la Llave,51,051 Coyutla,Mujeres,16,16,0,745
30 Veracruz de Ignacio de la Llave,51,051 Coyutla,Mujeres,131,124,7,1149
30 Veracruz de Ignacio de la Llave,51,051 Coyutla,Mujeres,192,188,4,669
30 Veracruz de Ignacio de la Llave,51,051 Coyutla,Mujeres,177,174,3,611
30 Veracruz de Ignacio de la Llave,51,051 Coyutla,Mujeres,144,144,0,615
30 Veracruz de Ignacio de la Llave,51,051 Coyutla,Mujeres,144,144,0,642
30 Veracruz de Ignacio de la Llave,51,051 Coyutla,Mujeres,114,114,0,532
30 Veracruz de Ignacio de la Llave,51,051 Coyutla,Mujeres,116,116,0,504
30 Veracruz de Ignacio de la Llave,51,051 Coyutla,Mujeres,75,75,0,450
30 Veracruz de Ignacio de la Llave,51,051 Coyutla,Mujeres,64,64,0,415
30 Veracruz de Ignacio de la Llave,51,051 Coyutla,Mujeres,39,38,1,308
30 Veracruz de Ignacio de la Llave,51,051 Coyutla,Mujeres,21,20,1,239
30 Veracruz de Ignacio de la Llave,51,051 Coyutla,Mujeres,10,10,0,214
30 Veracruz de Ignacio de la Llave,51,051 Coyutla,Mujeres,7,7,0,136
30 Veracruz de Ignacio de la Llave,51,051 Coyutla,Mujeres,4,4,0,86
30 Veracruz de Ignacio de la Llave,51,051 Coyutla,Mujeres,1,1,0,82
30 Veracruz de Ignacio de la Llave,52,052 Cuichapa,Total,3904,3546,358,5047
30 Veracruz de Ignacio de la Llave,52,052 Cuichapa,Total,40,28,12,666
30 Veracruz de Ignacio de la Llave,52,052 Cuichapa,Total,357,308,49,950
30 Veracruz de Ignacio de la Llave,52,052 Cuichapa,Total,557,491,66,450
30 Veracruz de Ignacio de la Llave,52,052 Cuichapa,Total,471,411,60,353
30 Veracruz de Ignacio de la Llave,52,052 Cuichapa,Total,409,370,39,334
30 Veracruz de Ignacio de la Llave,52,052 Cuichapa,Total,469,423,46,328
30 Veracruz de Ignacio de la Llave,52,052 Cuichapa,Total,432,410,22,295
30 Veracruz de Ignacio de la Llave,52,052 Cuichapa,Total,364,345,19,273
30 Veracruz de Ignacio de la Llave,52,052 Cuichapa,Total,274,249,25,268
30 Veracruz de Ignacio de la Llave,52,052 Cuichapa,Total,242,235,7,220
30 Veracruz de Ignacio de la Llave,52,052 Cuichapa,Total,118,113,5,218
30 Veracruz de Ignacio de la Llave,52,052 Cuichapa,Total,81,76,5,216
30 Veracruz de Ignacio de la Llave,52,052 Cuichapa,Total,43,41,2,165
30 Veracruz de Ignacio de la Llave,52,052 Cuichapa,Total,22,22,0,137
30 Veracruz de Ignacio de la Llave,52,052 Cuichapa,Total,16,15,1,86
30 Veracruz de Ignacio de la Llave,52,052 Cuichapa,Total,9,9,0,88
30 Veracruz de Ignacio de la Llave,52,052 Cuichapa,Hombres,2977,2675,302,1210
30 Veracruz de Ignacio de la Llave,52,052 Cuichapa,Hombres,32,21,11,321
30 Veracruz de Ignacio de la Llave,52,052 Cuichapa,Hombres,285,240,45,382
30 Veracruz de Ignacio de la Llave,52,052 Cuichapa,Hombres,403,348,55,82
30 Veracruz de Ignacio de la Llave,52,052 Cuichapa,Hombres,336,293,43,20
30 Veracruz de Ignacio de la Llave,52,052 Cuichapa,Hombres,289,257,32,8
30 Veracruz de Ignacio de la Llave,52,052 Cuichapa,Hombres,354,316,38,19
30 Veracruz de Ignacio de la Llave,52,052 Cuichapa,Hombres,331,314,17,23
30 Veracruz de Ignacio de la Llave,52,052 Cuichapa,Hombres,284,266,18,16
30 Veracruz de Ignacio de la Llave,52,052 Cuichapa,Hombres,214,191,23,24
30 Veracruz de Ignacio de la Llave,52,052 Cuichapa,Hombres,198,191,7,24
30 Veracruz de Ignacio de la Llave,52,052 Cuichapa,Hombres,101,96,5,60
30 Veracruz de Ignacio de la Llave,52,052 Cuichapa,Hombres,70,65,5,62
30 Veracruz de Ignacio de la Llave,52,052 Cuichapa,Hombres,35,33,2,53
30 Veracruz de Ignacio de la Llave,52,052 Cuichapa,Hombres,22,22,0,51
30 Veracruz de Ignacio de la Llave,52,052 Cuichapa,Hombres,16,15,1,35
30 Veracruz de Ignacio de la Llave,52,052 Cuichapa,Hombres,7,7,0,30
30 Veracruz de Ignacio de la Llave,52,052 Cuichapa,Mujeres,927,871,56,3837
30 Veracruz de Ignacio de la Llave,52,052 Cuichapa,Mujeres,8,7,1,345
30 Veracruz de Ignacio de la Llave,52,052 Cuichapa,Mujeres,72,68,4,568
30 Veracruz de Ignacio de la Llave,52,052 Cuichapa,Mujeres,154,143,11,368
30 Veracruz de Ignacio de la Llave,52,052 Cuichapa,Mujeres,135,118,17,333
30 Veracruz de Ignacio de la Llave,52,052 Cuichapa,Mujeres,120,113,7,326
30 Veracruz de Ignacio de la Llave,52,052 Cuichapa,Mujeres,115,107,8,309
30 Veracruz de Ignacio de la Llave,52,052 Cuichapa,Mujeres,101,96,5,272
30 Veracruz de Ignacio de la Llave,52,052 Cuichapa,Mujeres,80,79,1,257
30 Veracruz de Ignacio de la Llave,52,052 Cuichapa,Mujeres,60,58,2,244
30 Veracruz de Ignacio de la Llave,52,052 Cuichapa,Mujeres,44,44,0,196
30 Veracruz de Ignacio de la Llave,52,052 Cuichapa,Mujeres,17,17,0,158
30 Veracruz de Ignacio de la Llave,52,052 Cuichapa,Mujeres,11,11,0,154
30 Veracruz de Ignacio de la Llave,52,052 Cuichapa,Mujeres,8,8,0,112
30 Veracruz de Ignacio de la Llave,52,052 Cuichapa,Mujeres,0,0,0,86
30 Veracruz de Ignacio de la Llave,52,052 Cuichapa,Mujeres,0,0,0,51
30 Veracruz de Ignacio de la Llave,52,052 Cuichapa,Mujeres,2,2,0,58
30 Veracruz de Ignacio de la Llave,53,053 Cuitláhuac,Total,10190,9673,517,9967
30 Veracruz de Ignacio de la Llave,53,053 Cuitláhuac,Total,107,95,12,1341
30 Veracruz de Ignacio de la Llave,53,053 Cuitláhuac,Total,1056,958,98,1736
30 Veracruz de Ignacio de la Llave,53,053 Cuitláhuac,Total,1421,1339,82,1000
30 Veracruz de Ignacio de la Llave,53,053 Cuitláhuac,Total,1205,1142,63,680
30 Veracruz de Ignacio de la Llave,53,053 Cuitláhuac,Total,1125,1083,42,621
30 Veracruz de Ignacio de la Llave,53,053 Cuitláhuac,Total,1188,1139,49,650
30 Veracruz de Ignacio de la Llave,53,053 Cuitláhuac,Total,1031,1006,25,611
30 Veracruz de Ignacio de la Llave,53,053 Cuitláhuac,Total,910,867,43,567
30 Veracruz de Ignacio de la Llave,53,053 Cuitláhuac,Total,770,734,36,495
30 Veracruz de Ignacio de la Llave,53,053 Cuitláhuac,Total,545,525,20,446
30 Veracruz de Ignacio de la Llave,53,053 Cuitláhuac,Total,345,326,19,434
30 Veracruz de Ignacio de la Llave,53,053 Cuitláhuac,Total,216,206,10,361
30 Veracruz de Ignacio de la Llave,53,053 Cuitláhuac,Total,140,131,9,365
30 Veracruz de Ignacio de la Llave,53,053 Cuitláhuac,Total,87,80,7,278
30 Veracruz de Ignacio de la Llave,53,053 Cuitláhuac,Total,31,30,1,198
30 Veracruz de Ignacio de la Llave,53,053 Cuitláhuac,Total,13,12,1,184
30 Veracruz de Ignacio de la Llave,53,053 Cuitláhuac,Hombres,7136,6702,434,2181
30 Veracruz de Ignacio de la Llave,53,053 Cuitláhuac,Hombres,86,75,11,630
30 Veracruz de Ignacio de la Llave,53,053 Cuitláhuac,Hombres,767,683,84,619
30 Veracruz de Ignacio de la Llave,53,053 Cuitláhuac,Hombres,944,883,61,169
30 Veracruz de Ignacio de la Llave,53,053 Cuitláhuac,Hombres,781,738,43,46
30 Veracruz de Ignacio de la Llave,53,053 Cuitláhuac,Hombres,743,715,28,27
30 Veracruz de Ignacio de la Llave,53,053 Cuitláhuac,Hombres,807,761,46,22
30 Veracruz de Ignacio de la Llave,53,053 Cuitláhuac,Hombres,688,665,23,26
30 Veracruz de Ignacio de la Llave,53,053 Cuitláhuac,Hombres,655,614,41,41
30 Veracruz de Ignacio de la Llave,53,053 Cuitláhuac,Hombres,563,530,33,35
30 Veracruz de Ignacio de la Llave,53,053 Cuitláhuac,Hombres,421,403,18,38
30 Veracruz de Ignacio de la Llave,53,053 Cuitláhuac,Hombres,265,247,18,87
30 Veracruz de Ignacio de la Llave,53,053 Cuitláhuac,Hombres,177,167,10,102
30 Veracruz de Ignacio de la Llave,53,053 Cuitláhuac,Hombres,122,113,9,107
30 Veracruz de Ignacio de la Llave,53,053 Cuitláhuac,Hombres,77,70,7,91
30 Veracruz de Ignacio de la Llave,53,053 Cuitláhuac,Hombres,27,26,1,65
30 Veracruz de Ignacio de la Llave,53,053 Cuitláhuac,Hombres,13,12,1,76
30 Veracruz de Ignacio de la Llave,53,053 Cuitláhuac,Mujeres,3054,2971,83,7786
30 Veracruz de Ignacio de la Llave,53,053 Cuitláhuac,Mujeres,21,20,1,711
30 Veracruz de Ignacio de la Llave,53,053 Cuitláhuac,Mujeres,289,275,14,1117
30 Veracruz de Ignacio de la Llave,53,053 Cuitláhuac,Mujeres,477,456,21,831
30 Veracruz de Ignacio de la Llave,53,053 Cuitláhuac,Mujeres,424,404,20,634
30 Veracruz de Ignacio de la Llave,53,053 Cuitláhuac,Mujeres,382,368,14,594
30 Veracruz de Ignacio de la Llave,53,053 Cuitláhuac,Mujeres,381,378,3,628
30 Veracruz de Ignacio de la Llave,53,053 Cuitláhuac,Mujeres,343,341,2,585
30 Veracruz de Ignacio de la Llave,53,053 Cuitláhuac,Mujeres,255,253,2,526
30 Veracruz de Ignacio de la Llave,53,053 Cuitláhuac,Mujeres,207,204,3,460
30 Veracruz de Ignacio de la Llave,53,053 Cuitláhuac,Mujeres,124,122,2,408
30 Veracruz de Ignacio de la Llave,53,053 Cuitláhuac,Mujeres,80,79,1,347
30 Veracruz de Ignacio de la Llave,53,053 Cuitláhuac,Mujeres,39,39,0,259
30 Veracruz de Ignacio de la Llave,53,053 Cuitláhuac,Mujeres,18,18,0,258
30 Veracruz de Ignacio de la Llave,53,053 Cuitláhuac,Mujeres,10,10,0,187
30 Veracruz de Ignacio de la Llave,53,053 Cuitláhuac,Mujeres,4,4,0,133
30 Veracruz de Ignacio de la Llave,53,053 Cuitláhuac,Mujeres,0,0,0,108
30 Veracruz de Ignacio de la Llave,205,205 El Higo,Total,6303,5866,437,8758
30 Veracruz de Ignacio de la Llave,205,205 El Higo,Total,16,15,1,1128
30 Veracruz de Ignacio de la Llave,205,205 El Higo,Total,334,286,48,1526
30 Veracruz de Ignacio de la Llave,205,205 El Higo,Total,688,627,61,754
30 Veracruz de Ignacio de la Llave,205,205 El Higo,Total,638,596,42,468
30 Veracruz de Ignacio de la Llave,205,205 El Higo,Total,711,660,51,558
30 Veracruz de Ignacio de la Llave,205,205 El Higo,Total,871,818,53,595
30 Veracruz de Ignacio de la Llave,205,205 El Higo,Total,786,746,40,576
30 Veracruz de Ignacio de la Llave,205,205 El Higo,Total,658,616,42,504
30 Veracruz de Ignacio de la Llave,205,205 El Higo,Total,588,556,32,470
30 Veracruz de Ignacio de la Llave,205,205 El Higo,Total,431,406,25,371
30 Veracruz de Ignacio de la Llave,205,205 El Higo,Total,241,226,15,472
30 Veracruz de Ignacio de la Llave,205,205 El Higo,Total,142,132,10,376
30 Veracruz de Ignacio de la Llave,205,205 El Higo,Total,103,98,5,352
30 Veracruz de Ignacio de la Llave,205,205 El Higo,Total,53,45,8,279
30 Veracruz de Ignacio de la Llave,205,205 El Higo,Total,29,27,2,164
30 Veracruz de Ignacio de la Llave,205,205 El Higo,Total,14,12,2,165
30 Veracruz de Ignacio de la Llave,205,205 El Higo,Hombres,5043,4631,412,2369
30 Veracruz de Ignacio de la Llave,205,205 El Higo,Hombres,14,13,1,571
30 Veracruz de Ignacio de la Llave,205,205 El Higo,Hombres,275,231,44,676
30 Veracruz de Ignacio de la Llave,205,205 El Higo,Hombres,530,474,56,190
30 Veracruz de Ignacio de la Llave,205,205 El Higo,Hombres,478,441,37,43
30 Veracruz de Ignacio de la Llave,205,205 El Higo,Hombres,558,513,45,26
30 Veracruz de Ignacio de la Llave,205,205 El Higo,Hombres,688,637,51,28
30 Veracruz de Ignacio de la Llave,205,205 El Higo,Hombres,605,565,40,32
30 Veracruz de Ignacio de la Llave,205,205 El Higo,Hombres,526,485,41,28
30 Veracruz de Ignacio de la Llave,205,205 El Higo,Hombres,481,450,31,50
30 Veracruz de Ignacio de la Llave,205,205 El Higo,Hombres,370,345,25,39
30 Veracruz de Ignacio de la Llave,205,205 El Higo,Hombres,208,193,15,130
30 Veracruz de Ignacio de la Llave,205,205 El Higo,Hombres,131,122,9,142
30 Veracruz de Ignacio de la Llave,205,205 El Higo,Hombres,88,83,5,142
30 Veracruz de Ignacio de la Llave,205,205 El Higo,Hombres,51,43,8,126
30 Veracruz de Ignacio de la Llave,205,205 El Higo,Hombres,26,24,2,72
30 Veracruz de Ignacio de la Llave,205,205 El Higo,Hombres,14,12,2,74
30 Veracruz de Ignacio de la Llave,205,205 El Higo,Mujeres,1260,1235,25,6389
30 Veracruz de Ignacio de la Llave,205,205 El Higo,Mujeres,2,2,0,557
30 Veracruz de Ignacio de la Llave,205,205 El Higo,Mujeres,59,55,4,850
30 Veracruz de Ignacio de la Llave,205,205 El Higo,Mujeres,158,153,5,564
30 Veracruz de Ignacio de la Llave,205,205 El Higo,Mujeres,160,155,5,425
30 Veracruz de Ignacio de la Llave,205,205 El Higo,Mujeres,153,147,6,532
30 Veracruz de Ignacio de la Llave,205,205 El Higo,Mujeres,183,181,2,567
30 Veracruz de Ignacio de la Llave,205,205 El Higo,Mujeres,181,181,0,544
30 Veracruz de Ignacio de la Llave,205,205 El Higo,Mujeres,132,131,1,476
30 Veracruz de Ignacio de la Llave,205,205 El Higo,Mujeres,107,106,1,420
30 Veracruz de Ignacio de la Llave,205,205 El Higo,Mujeres,61,61,0,332
30 Veracruz de Ignacio de la Llave,205,205 El Higo,Mujeres,33,33,0,342
30 Veracruz de Ignacio de la Llave,205,205 El Higo,Mujeres,11,10,1,234
30 Veracruz de Ignacio de la Llave,205,205 El Higo,Mujeres,15,15,0,210
30 Veracruz de Ignacio de la Llave,205,205 El Higo,Mujeres,2,2,0,153
30 Veracruz de Ignacio de la Llave,205,205 El Higo,Mujeres,3,3,0,92
30 Veracruz de Ignacio de la Llave,205,205 El Higo,Mujeres,0,0,0,91
30 Veracruz de Ignacio de la Llave,65,065 Emiliano Zapata,Total,25596,24884,712,21672
30 Veracruz de Ignacio de la Llave,65,065 Emiliano Zapata,Total,156,143,13,3135
30 Veracruz de Ignacio de la Llave,65,065 Emiliano Zapata,Total,1582,1491,91,3968
30 Veracruz de Ignacio de la Llave,65,065 Emiliano Zapata,Total,2837,2714,123,2180
30 Veracruz de Ignacio de la Llave,65,065 Emiliano Zapata,Total,3225,3115,110,1573
30 Veracruz de Ignacio de la Llave,65,065 Emiliano Zapata,Total,3571,3514,57,1589
30 Veracruz de Ignacio de la Llave,65,065 Emiliano Zapata,Total,3526,3448,78,1446
30 Veracruz de Ignacio de la Llave,65,065 Emiliano Zapata,Total,2984,2930,54,1167
30 Veracruz de Ignacio de la Llave,65,065 Emiliano Zapata,Total,2460,2412,48,1051
30 Veracruz de Ignacio de la Llave,65,065 Emiliano Zapata,Total,1835,1796,39,1006
30 Veracruz de Ignacio de la Llave,65,065 Emiliano Zapata,Total,1257,1218,39,892
30 Veracruz de Ignacio de la Llave,65,065 Emiliano Zapata,Total,830,806,24,901
30 Veracruz de Ignacio de la Llave,65,065 Emiliano Zapata,Total,553,537,16,806
30 Veracruz de Ignacio de la Llave,65,065 Emiliano Zapata,Total,420,407,13,699
30 Veracruz de Ignacio de la Llave,65,065 Emiliano Zapata,Total,220,215,5,521
30 Veracruz de Ignacio de la Llave,65,065 Emiliano Zapata,Total,98,96,2,356
30 Veracruz de Ignacio de la Llave,65,065 Emiliano Zapata,Total,42,42,0,382
30 Veracruz de Ignacio de la Llave,65,065 Emiliano Zapata,Hombres,17697,17093,604,5223
30 Veracruz de Ignacio de la Llave,65,065 Emiliano Zapata,Hombres,129,117,12,1602
30 Veracruz de Ignacio de la Llave,65,065 Emiliano Zapata,Hombres,1188,1107,81,1610
30 Veracruz de Ignacio de la Llave,65,065 Emiliano Zapata,Hombres,1955,1868,87,487
30 Veracruz de Ignacio de la Llave,65,065 Emiliano Zapata,Hombres,2187,2101,86,118
30 Veracruz de Ignacio de la Llave,65,065 Emiliano Zapata,Hombres,2311,2264,47,53
30 Veracruz de Ignacio de la Llave,65,065 Emiliano Zapata,Hombres,2345,2283,62,59
30 Veracruz de Ignacio de la Llave,65,065 Emiliano Zapata,Hombres,1937,1885,52,41
30 Veracruz de Ignacio de la Llave,65,065 Emiliano Zapata,Hombres,1649,1604,45,55
30 Veracruz de Ignacio de la Llave,65,065 Emiliano Zapata,Hombres,1278,1241,37,87
30 Veracruz de Ignacio de la Llave,65,065 Emiliano Zapata,Hombres,914,877,37,129
30 Veracruz de Ignacio de la Llave,65,065 Emiliano Zapata,Hombres,663,640,23,169
30 Veracruz de Ignacio de la Llave,65,065 Emiliano Zapata,Hombres,462,447,15,187
30 Veracruz de Ignacio de la Llave,65,065 Emiliano Zapata,Hombres,352,339,13,206
30 Veracruz de Ignacio de la Llave,65,065 Emiliano Zapata,Hombres,198,193,5,171
30 Veracruz de Ignacio de la Llave,65,065 Emiliano Zapata,Hombres,89,87,2,117
30 Veracruz de Ignacio de la Llave,65,065 Emiliano Zapata,Hombres,40,40,0,132
30 Veracruz de Ignacio de la Llave,65,065 Emiliano Zapata,Mujeres,7899,7791,108,16449
30 Veracruz de Ignacio de la Llave,65,065 Emiliano Zapata,Mujeres,27,26,1,1533
30 Veracruz de Ignacio de la Llave,65,065 Emiliano Zapata,Mujeres,394,384,10,2358
30 Veracruz de Ignacio de la Llave,65,065 Emiliano Zapata,Mujeres,882,846,36,1693
30 Veracruz de Ignacio de la Llave,65,065 Emiliano Zapata,Mujeres,1038,1014,24,1455
30 Veracruz de Ignacio de la Llave,65,065 Emiliano Zapata,Mujeres,1260,1250,10,1536
30 Veracruz de Ignacio de la Llave,65,065 Emiliano Zapata,Mujeres,1181,1165,16,1387
30 Veracruz de Ignacio de la Llave,65,065 Emiliano Zapata,Mujeres,1047,1045,2,1126
30 Veracruz de Ignacio de la Llave,65,065 Emiliano Zapata,Mujeres,811,808,3,996
30 Veracruz de Ignacio de la Llave,65,065 Emiliano Zapata,Mujeres,557,555,2,919
30 Veracruz de Ignacio de la Llave,65,065 Emiliano Zapata,Mujeres,343,341,2,763
30 Veracruz de Ignacio de la Llave,65,065 Emiliano Zapata,Mujeres,167,166,1,732
30 Veracruz de Ignacio de la Llave,65,065 Emiliano Zapata,Mujeres,91,90,1,619
30 Veracruz de Ignacio de la Llave,65,065 Emiliano Zapata,Mujeres,68,68,0,493
30 Veracruz de Ignacio de la Llave,65,065 Emiliano Zapata,Mujeres,22,22,0,350
30 Veracruz de Ignacio de la Llave,65,065 Emiliano Zapata,Mujeres,9,9,0,239
30 Veracruz de Ignacio de la Llave,65,065 Emiliano Zapata,Mujeres,2,2,0,250
30 Veracruz de Ignacio de la Llave,66,066 Espinal,Total,8474,8265,209,10830
30 Veracruz de Ignacio de la Llave,66,066 Espinal,Total,58,57,1,1647
30 Veracruz de Ignacio de la Llave,66,066 Espinal,Total,613,594,19,2302
30 Veracruz de Ignacio de la Llave,66,066 Espinal,Total,983,949,34,1003
30 Veracruz de Ignacio de la Llave,66,066 Espinal,Total,971,936,35,708
30 Veracruz de Ignacio de la Llave,66,066 Espinal,Total,890,873,17,700
30 Veracruz de Ignacio de la Llave,66,066 Espinal,Total,933,911,22,701
30 Veracruz de Ignacio de la Llave,66,066 Espinal,Total,797,774,23,615
30 Veracruz de Ignacio de la Llave,66,066 Espinal,Total,780,767,13,539
30 Veracruz de Ignacio de la Llave,66,066 Espinal,Total,630,617,13,527
30 Veracruz de Ignacio de la Llave,66,066 Espinal,Total,584,572,12,514
30 Veracruz de Ignacio de la Llave,66,066 Espinal,Total,443,434,9,413
30 Veracruz de Ignacio de la Llave,66,066 Espinal,Total,345,339,6,334
30 Veracruz de Ignacio de la Llave,66,066 Espinal,Total,235,234,1,309
30 Veracruz de Ignacio de la Llave,66,066 Espinal,Total,110,107,3,216
30 Veracruz de Ignacio de la Llave,66,066 Espinal,Total,55,54,1,123
30 Veracruz de Ignacio de la Llave,66,066 Espinal,Total,47,47,0,179
30 Veracruz de Ignacio de la Llave,66,066 Espinal,Hombres,6875,6687,188,2371
30 Veracruz de Ignacio de la Llave,66,066 Espinal,Hombres,45,44,1,838
30 Veracruz de Ignacio de la Llave,66,066 Espinal,Hombres,521,502,19,926
30 Veracruz de Ignacio de la Llave,66,066 Espinal,Hombres,768,743,25,137
30 Veracruz de Ignacio de la Llave,66,066 Espinal,Hombres,781,750,31,33
30 Veracruz de Ignacio de la Llave,66,066 Espinal,Hombres,670,654,16,20
30 Veracruz de Ignacio de la Llave,66,066 Espinal,Hombres,722,700,22,23
30 Veracruz de Ignacio de la Llave,66,066 Espinal,Hombres,620,599,21,14
30 Veracruz de Ignacio de la Llave,66,066 Espinal,Hombres,621,610,11,12
30 Veracruz de Ignacio de la Llave,66,066 Espinal,Hombres,518,505,13,25
30 Veracruz de Ignacio de la Llave,66,066 Espinal,Hombres,491,482,9,40
30 Veracruz de Ignacio de la Llave,66,066 Espinal,Hombres,405,396,9,40
30 Veracruz de Ignacio de la Llave,66,066 Espinal,Hombres,309,303,6,39
30 Veracruz de Ignacio de la Llave,66,066 Espinal,Hombres,215,214,1,62
30 Veracruz de Ignacio de la Llave,66,066 Espinal,Hombres,97,94,3,53
30 Veracruz de Ignacio de la Llave,66,066 Espinal,Hombres,49,48,1,30
30 Veracruz de Ignacio de la Llave,66,066 Espinal,Hombres,43,43,0,79
30 Veracruz de Ignacio de la Llave,66,066 Espinal,Mujeres,1599,1578,21,8459
30 Veracruz de Ignacio de la Llave,66,066 Espinal,Mujeres,13,13,0,809
30 Veracruz de Ignacio de la Llave,66,066 Espinal,Mujeres,92,92,0,1376
30 Veracruz de Ignacio de la Llave,66,066 Espinal,Mujeres,215,206,9,866
30 Veracruz de Ignacio de la Llave,66,066 Espinal,Mujeres,190,186,4,675
30 Veracruz de Ignacio de la Llave,66,066 Espinal,Mujeres,220,219,1,680
30 Veracruz de Ignacio de la Llave,66,066 Espinal,Mujeres,211,211,0,678
30 Veracruz de Ignacio de la Llave,66,066 Espinal,Mujeres,177,175,2,601
30 Veracruz de Ignacio de la Llave,66,066 Espinal,Mujeres,159,157,2,527
30 Veracruz de Ignacio de la Llave,66,066 Espinal,Mujeres,112,112,0,502
30 Veracruz de Ignacio de la Llave,66,066 Espinal,Mujeres,93,90,3,474
30 Veracruz de Ignacio de la Llave,66,066 Espinal,Mujeres,38,38,0,373
30 Veracruz de Ignacio de la Llave,66,066 Espinal,Mujeres,36,36,0,295
30 Veracruz de Ignacio de la Llave,66,066 Espinal,Mujeres,20,20,0,247
30 Veracruz de Ignacio de la Llave,66,066 Espinal,Mujeres,13,13,0,163
30 Veracruz de Ignacio de la Llave,66,066 Espinal,Mujeres,6,6,0,93
30 Veracruz de Ignacio de la Llave,66,066 Espinal,Mujeres,4,4,0,100
30 Veracruz de Ignacio de la Llave,67,067 Filomeno Mata,Total,3805,3560,245,6380
30 Veracruz de Ignacio de la Llave,67,067 Filomeno Mata,Total,74,69,5,1274
30 Veracruz de Ignacio de la Llave,67,067 Filomeno Mata,Total,495,444,51,1198
30 Veracruz de Ignacio de la Llave,67,067 Filomeno Mata,Total,645,598,47,714
30 Veracruz de Ignacio de la Llave,67,067 Filomeno Mata,Total,539,509,30,571
30 Veracruz de Ignacio de la Llave,67,067 Filomeno Mata,Total,459,431,28,502
30 Veracruz de Ignacio de la Llave,67,067 Filomeno Mata,Total,412,389,23,382
30 Veracruz de Ignacio de la Llave,67,067 Filomeno Mata,Total,302,283,19,320
30 Veracruz de Ignacio de la Llave,67,067 Filomeno Mata,Total,255,239,16,281
30 Veracruz de Ignacio de la Llave,67,067 Filomeno Mata,Total,184,174,10,257
30 Veracruz de Ignacio de la Llave,67,067 Filomeno Mata,Total,192,183,9,239
30 Veracruz de Ignacio de la Llave,67,067 Filomeno Mata,Total,95,91,4,165
30 Veracruz de Ignacio de la Llave,67,067 Filomeno Mata,Total,90,87,3,167
30 Veracruz de Ignacio de la Llave,67,067 Filomeno Mata,Total,43,43,0,141
30 Veracruz de Ignacio de la Llave,67,067 Filomeno Mata,Total,11,11,0,76
30 Veracruz de Ignacio de la Llave,67,067 Filomeno Mata,Total,6,6,0,54
30 Veracruz de Ignacio de la Llave,67,067 Filomeno Mata,Total,3,3,0,39
30 Veracruz de Ignacio de la Llave,67,067 Filomeno Mata,Hombres,3331,3092,239,1676
30 Veracruz de Ignacio de la Llave,67,067 Filomeno Mata,Hombres,62,57,5,593
30 Veracruz de Ignacio de la Llave,67,067 Filomeno Mata,Hombres,437,386,51,433
30 Veracruz de Ignacio de la Llave,67,067 Filomeno Mata,Hombres,531,487,44,133
30 Veracruz de Ignacio de la Llave,67,067 Filomeno Mata,Hombres,468,440,28,55
30 Veracruz de Ignacio de la Llave,67,067 Filomeno Mata,Hombres,400,372,28,66
30 Veracruz de Ignacio de la Llave,67,067 Filomeno Mata,Hombres,372,349,23,42
30 Veracruz de Ignacio de la Llave,67,067 Filomeno Mata,Hombres,274,255,19,37
30 Veracruz de Ignacio de la Llave,67,067 Filomeno Mata,Hombres,223,208,15,34
30 Veracruz de Ignacio de la Llave,67,067 Filomeno Mata,Hombres,162,152,10,42
30 Veracruz de Ignacio de la Llave,67,067 Filomeno Mata,Hombres,180,171,9,49
30 Veracruz de Ignacio de la Llave,67,067 Filomeno Mata,Hombres,85,81,4,31
30 Veracruz de Ignacio de la Llave,67,067 Filomeno Mata,Hombres,84,81,3,43
30 Veracruz de Ignacio de la Llave,67,067 Filomeno Mata,Hombres,38,38,0,43
30 Veracruz de Ignacio de la Llave,67,067 Filomeno Mata,Hombres,8,8,0,32
30 Veracruz de Ignacio de la Llave,67,067 Filomeno Mata,Hombres,4,4,0,24
30 Veracruz de Ignacio de la Llave,67,067 Filomeno Mata,Hombres,3,3,0,19
30 Veracruz de Ignacio de la Llave,67,067 Filomeno Mata,Mujeres,474,468,6,4704
30 Veracruz de Ignacio de la Llave,67,067 Filomeno Mata,Mujeres,12,12,0,681
30 Veracruz de Ignacio de la Llave,67,067 Filomeno Mata,Mujeres,58,58,0,765
30 Veracruz de Ignacio de la Llave,67,067 Filomeno Mata,Mujeres,114,111,3,581
30 Veracruz de Ignacio de la Llave,67,067 Filomeno Mata,Mujeres,71,69,2,516
30 Veracruz de Ignacio de la Llave,67,067 Filomeno Mata,Mujeres,59,59,0,436
30 Veracruz de Ignacio de la Llave,67,067 Filomeno Mata,Mujeres,40,40,0,340
30 Veracruz de Ignacio de la Llave,67,067 Filomeno Mata,Mujeres,28,28,0,283
30 Veracruz de Ignacio de la Llave,67,067 Filomeno Mata,Mujeres,32,31,1,247
30 Veracruz de Ignacio de la Llave,67,067 Filomeno Mata,Mujeres,22,22,0,215
30 Veracruz de Ignacio de la Llave,67,067 Filomeno Mata,Mujeres,12,12,0,190
30 Veracruz de Ignacio de la Llave,67,067 Filomeno Mata,Mujeres,10,10,0,134
30 Veracruz de Ignacio de la Llave,67,067 Filomeno Mata,Mujeres,6,6,0,124
30 Veracruz de Ignacio de la Llave,67,067 Filomeno Mata,Mujeres,5,5,0,98
30 Veracruz de Ignacio de la Llave,67,067 Filomeno Mata,Mujeres,3,3,0,44
30 Veracruz de Ignacio de la Llave,67,067 Filomeno Mata,Mujeres,2,2,0,30
30 Veracruz de Ignacio de la Llave,67,067 Filomeno Mata,Mujeres,0,0,0,20
30 Veracruz de Ignacio de la Llave,68,068 Fortín,Total,24342,23555,787,21496
30 Veracruz de Ignacio de la Llave,68,068 Fortín,Total,87,84,3,3051
30 Veracruz de Ignacio de la Llave,68,068 Fortín,Total,1310,1196,114,4012
30 Veracruz de Ignacio de la Llave,68,068 Fortín,Total,2780,2629,151,2199
30 Veracruz de Ignacio de la Llave,68,068 Fortín,Total,3143,3023,120,1426
30 Veracruz de Ignacio de la Llave,68,068 Fortín,Total,3374,3281,93,1417
30 Veracruz de Ignacio de la Llave,68,068 Fortín,Total,3491,3415,76,1379
30 Veracruz de Ignacio de la Llave,68,068 Fortín,Total,2984,2917,67,1169
30 Veracruz de Ignacio de la Llave,68,068 Fortín,Total,2300,2263,37,984
30 Veracruz de Ignacio de la Llave,68,068 Fortín,Total,1714,1671,43,975
30 Veracruz de Ignacio de la Llave,68,068 Fortín,Total,1272,1243,29,987
30 Veracruz de Ignacio de la Llave,68,068 Fortín,Total,802,779,23,1015
30 Veracruz de Ignacio de la Llave,68,068 Fortín,Total,463,453,10,831
30 Veracruz de Ignacio de la Llave,68,068 Fortín,Total,314,306,8,780
30 Veracruz de Ignacio de la Llave,68,068 Fortín,Total,180,168,12,567
30 Veracruz de Ignacio de la Llave,68,068 Fortín,Total,73,73,0,384
30 Veracruz de Ignacio de la Llave,68,068 Fortín,Total,55,54,1,320
30 Veracruz de Ignacio de la Llave,68,068 Fortín,Hombres,15722,15144,578,5470
30 Veracruz de Ignacio de la Llave,68,068 Fortín,Hombres,75,72,3,1540
30 Veracruz de Ignacio de la Llave,68,068 Fortín,Hombres,945,859,86,1709
30 Veracruz de Ignacio de la Llave,68,068 Fortín,Hombres,1766,1674,92,621
30 Veracruz de Ignacio de la Llave,68,068 Fortín,Hombres,1884,1813,71,110
30 Veracruz de Ignacio de la Llave,68,068 Fortín,Hombres,2075,2009,66,59
30 Veracruz de Ignacio de la Llave,68,068 Fortín,Hombres,2112,2055,57,63
30 Veracruz de Ignacio de la Llave,68,068 Fortín,Hombres,1927,1870,57,55
30 Veracruz de Ignacio de la Llave,68,068 Fortín,Hombres,1466,1436,30,61
30 Veracruz de Ignacio de la Llave,68,068 Fortín,Hombres,1140,1102,38,73
30 Veracruz de Ignacio de la Llave,68,068 Fortín,Hombres,908,881,27,129
30 Veracruz de Ignacio de la Llave,68,068 Fortín,Hombres,584,563,21,228
30 Veracruz de Ignacio de la Llave,68,068 Fortín,Hombres,344,334,10,214
30 Veracruz de Ignacio de la Llave,68,068 Fortín,Hombres,245,238,7,211
30 Veracruz de Ignacio de la Llave,68,068 Fortín,Hombres,148,136,12,166
30 Veracruz de Ignacio de la Llave,68,068 Fortín,Hombres,55,55,0,132
30 Veracruz de Ignacio de la Llave,68,068 Fortín,Hombres,48,47,1,99
30 Veracruz de Ignacio de la Llave,68,068 Fortín,Mujeres,8620,8411,209,16026
30 Veracruz de Ignacio de la Llave,68,068 Fortín,Mujeres,12,12,0,1511
30 Veracruz de Ignacio de la Llave,68,068 Fortín,Mujeres,365,337,28,2303
30 Veracruz de Ignacio de la Llave,68,068 Fortín,Mujeres,1014,955,59,1578
30 Veracruz de Ignacio de la Llave,68,068 Fortín,Mujeres,1259,1210,49,1316
30 Veracruz de Ignacio de la Llave,68,068 Fortín,Mujeres,1299,1272,27,1358
30 Veracruz de Ignacio de la Llave,68,068 Fortín,Mujeres,1379,1360,19,1316
30 Veracruz de Ignacio de la Llave,68,068 Fortín,Mujeres,1057,1047,10,1114
30 Veracruz de Ignacio de la Llave,68,068 Fortín,Mujeres,834,827,7,923
30 Veracruz de Ignacio de la Llave,68,068 Fortín,Mujeres,574,569,5,902
30 Veracruz de Ignacio de la Llave,68,068 Fortín,Mujeres,364,362,2,858
30 Veracruz de Ignacio de la Llave,68,068 Fortín,Mujeres,218,216,2,787
30 Veracruz de Ignacio de la Llave,68,068 Fortín,Mujeres,119,119,0,617
30 Veracruz de Ignacio de la Llave,68,068 Fortín,Mujeres,69,68,1,569
30 Veracruz de Ignacio de la Llave,68,068 Fortín,Mujeres,32,32,0,401
30 Veracruz de Ignacio de la Llave,68,068 Fortín,Mujeres,18,18,0,252
30 Veracruz de Ignacio de la Llave,68,068 Fortín,Mujeres,7,7,0,221
30 Veracruz de Ignacio de la Llave,69,069 Gutiérrez Zamora,Total,9869,9562,307,9531
30 Veracruz de Ignacio de la Llave,69,069 Gutiérrez Zamora,Total,56,52,4,1281
30 Veracruz de Ignacio de la Llave,69,069 Gutiérrez Zamora,Total,641,609,32,1801
30 Veracruz de Ignacio de la Llave,69,069 Gutiérrez Zamora,Total,946,889,57,771
30 Veracruz de Ignacio de la Llave,69,069 Gutiérrez Zamora,Total,918,882,36,480
30 Veracruz de Ignacio de la Llave,69,069 Gutiérrez Zamora,Total,969,952,17,541
30 Veracruz de Ignacio de la Llave,69,069 Gutiérrez Zamora,Total,1143,1118,25,523
30 Veracruz de Ignacio de la Llave,69,069 Gutiérrez Zamora,Total,1138,1107,31,523
30 Veracruz de Ignacio de la Llave,69,069 Gutiérrez Zamora,Total,1050,1028,22,528
30 Veracruz de Ignacio de la Llave,69,069 Gutiérrez Zamora,Total,815,798,17,470
30 Veracruz de Ignacio de la Llave,69,069 Gutiérrez Zamora,Total,650,625,25,486
30 Veracruz de Ignacio de la Llave,69,069 Gutiérrez Zamora,Total,556,543,13,468
30 Veracruz de Ignacio de la Llave,69,069 Gutiérrez Zamora,Total,399,387,12,467
30 Veracruz de Ignacio de la Llave,69,069 Gutiérrez Zamora,Total,321,312,9,434
30 Veracruz de Ignacio de la Llave,69,069 Gutiérrez Zamora,Total,161,156,5,292
30 Veracruz de Ignacio de la Llave,69,069 Gutiérrez Zamora,Total,68,67,1,230
30 Veracruz de Ignacio de la Llave,69,069 Gutiérrez Zamora,Total,38,37,1,236
30 Veracruz de Ignacio de la Llave,69,069 Gutiérrez Zamora,Hombres,6694,6437,257,2258
30 Veracruz de Ignacio de la Llave,69,069 Gutiérrez Zamora,Hombres,44,40,4,643
30 Veracruz de Ignacio de la Llave,69,069 Gutiérrez Zamora,Hombres,478,452,26,737
30 Veracruz de Ignacio de la Llave,69,069 Gutiérrez Zamora,Hombres,623,582,41,161
30 Veracruz de Ignacio de la Llave,69,069 Gutiérrez Zamora,Hombres,594,568,26,37
30 Veracruz de Ignacio de la Llave,69,069 Gutiérrez Zamora,Hombres,598,584,14,24
30 Veracruz de Ignacio de la Llave,69,069 Gutiérrez Zamora,Hombres,702,680,22,27
30 Veracruz de Ignacio de la Llave,69,069 Gutiérrez Zamora,Hombres,712,684,28,24
30 Veracruz de Ignacio de la Llave,69,069 Gutiérrez Zamora,Hombres,685,664,21,21
30 Veracruz de Ignacio de la Llave,69,069 Gutiérrez Zamora,Hombres,542,526,16,34
30 Veracruz de Ignacio de la Llave,69,069 Gutiérrez Zamora,Hombres,462,442,20,63
30 Veracruz de Ignacio de la Llave,69,069 Gutiérrez Zamora,Hombres,438,425,13,62
30 Veracruz de Ignacio de la Llave,69,069 Gutiérrez Zamora,Hombres,314,302,12,76
30 Veracruz de Ignacio de la Llave,69,069 Gutiérrez Zamora,Hombres,267,260,7,118
30 Veracruz de Ignacio de la Llave,69,069 Gutiérrez Zamora,Hombres,139,134,5,68
30 Veracruz de Ignacio de la Llave,69,069 Gutiérrez Zamora,Hombres,59,58,1,75
30 Veracruz de Ignacio de la Llave,69,069 Gutiérrez Zamora,Hombres,37,36,1,88
30 Veracruz de Ignacio de la Llave,69,069 Gutiérrez Zamora,Mujeres,3175,3125,50,7273
30 Veracruz de Ignacio de la Llave,69,069 Gutiérrez Zamora,Mujeres,12,12,0,638
30 Veracruz de Ignacio de la Llave,69,069 Gutiérrez Zamora,Mujeres,163,157,6,1064
30 Veracruz de Ignacio de la Llave,69,069 Gutiérrez Zamora,Mujeres,323,307,16,610
30 Veracruz de Ignacio de la Llave,69,069 Gutiérrez Zamora,Mujeres,324,314,10,443
30 Veracruz de Ignacio de la Llave,69,069 Gutiérrez Zamora,Mujeres,371,368,3,517
30 Veracruz de Ignacio de la Llave,69,069 Gutiérrez Zamora,Mujeres,441,438,3,496
30 Veracruz de Ignacio de la Llave,69,069 Gutiérrez Zamora,Mujeres,426,423,3,499
30 Veracruz de Ignacio de la Llave,69,069 Gutiérrez Zamora,Mujeres,365,364,1,507
30 Veracruz de Ignacio de la Llave,69,069 Gutiérrez Zamora,Mujeres,273,272,1,436
30 Veracruz de Ignacio de la Llave,69,069 Gutiérrez Zamora,Mujeres,188,183,5,423
30 Veracruz de Ignacio de la Llave,69,069 Gutiérrez Zamora,Mujeres,118,118,0,406
30 Veracruz de Ignacio de la Llave,69,069 Gutiérrez Zamora,Mujeres,85,85,0,391
30 Veracruz de Ignacio de la Llave,69,069 Gutiérrez Zamora,Mujeres,54,52,2,316
30 Veracruz de Ignacio de la Llave,69,069 Gutiérrez Zamora,Mujeres,22,22,0,224
30 Veracruz de Ignacio de la Llave,69,069 Gutiérrez Zamora,Mujeres,9,9,0,155
30 Veracruz de Ignacio de la Llave,69,069 Gutiérrez Zamora,Mujeres,1,1,0,148
30 Veracruz de Ignacio de la Llave,70,070 Hidalgotitlán,Total,6054,5967,87,7726
30 Veracruz de Ignacio de la Llave,70,070 Hidalgotitlán,Total,105,105,0,1301
30 Veracruz de Ignacio de la Llave,70,070 Hidalgotitlán,Total,697,686,11,1677
30 Veracruz de Ignacio de la Llave,70,070 Hidalgotitlán,Total,740,722,18,699
30 Veracruz de Ignacio de la Llave,70,070 Hidalgotitlán,Total,631,617,14,535
30 Veracruz de Ignacio de la Llave,70,070 Hidalgotitlán,Total,623,608,15,579
30 Veracruz de Ignacio de la Llave,70,070 Hidalgotitlán,Total,667,658,9,558
30 Veracruz de Ignacio de la Llave,70,070 Hidalgotitlán,Total,610,605,5,450
30 Veracruz de Ignacio de la Llave,70,070 Hidalgotitlán,Total,473,468,5,383
30 Veracruz de Ignacio de la Llave,70,070 Hidalgotitlán,Total,380,378,2,349
30 Veracruz de Ignacio de la Llave,70,070 Hidalgotitlán,Total,312,310,2,272
30 Veracruz de Ignacio de la Llave,70,070 Hidalgotitlán,Total,276,273,3,228
30 Veracruz de Ignacio de la Llave,70,070 Hidalgotitlán,Total,199,198,1,227
30 Veracruz de Ignacio de la Llave,70,070 Hidalgotitlán,Total,179,179,0,162
30 Veracruz de Ignacio de la Llave,70,070 Hidalgotitlán,Total,94,93,1,137
30 Veracruz de Ignacio de la Llave,70,070 Hidalgotitlán,Total,39,38,1,68
30 Veracruz de Ignacio de la Llave,70,070 Hidalgotitlán,Total,29,29,0,101
30 Veracruz de Ignacio de la Llave,70,070 Hidalgotitlán,Hombres,5343,5263,80,1544
30 Veracruz de Ignacio de la Llave,70,070 Hidalgotitlán,Hombres,95,95,0,642
30 Veracruz de Ignacio de la Llave,70,070 Hidalgotitlán,Hombres,610,600,10,594
30 Veracruz de Ignacio de la Llave,70,070 Hidalgotitlán,Hombres,611,595,16,52
30 Veracruz de Ignacio de la Llave,70,070 Hidalgotitlán,Hombres,541,530,11,13
30 Veracruz de Ignacio de la Llave,70,070 Hidalgotitlán,Hombres,535,520,15,13
30 Veracruz de Ignacio de la Llave,70,070 Hidalgotitlán,Hombres,589,581,8,15
30 Veracruz de Ignacio de la Llave,70,070 Hidalgotitlán,Hombres,529,524,5,7
30 Veracruz de Ignacio de la Llave,70,070 Hidalgotitlán,Hombres,413,408,5,8
30 Veracruz de Ignacio de la Llave,70,070 Hidalgotitlán,Hombres,350,348,2,15
30 Veracruz de Ignacio de la Llave,70,070 Hidalgotitlán,Hombres,292,290,2,13
30 Veracruz de Ignacio de la Llave,70,070 Hidalgotitlán,Hombres,259,256,3,14
30 Veracruz de Ignacio de la Llave,70,070 Hidalgotitlán,Hombres,187,186,1,17
30 Veracruz de Ignacio de la Llave,70,070 Hidalgotitlán,Hombres,173,173,0,25
30 Veracruz de Ignacio de la Llave,70,070 Hidalgotitlán,Hombres,92,91,1,46
30 Veracruz de Ignacio de la Llave,70,070 Hidalgotitlán,Hombres,39,38,1,25
30 Veracruz de Ignacio de la Llave,70,070 Hidalgotitlán,Hombres,28,28,0,45
30 Veracruz de Ignacio de la Llave,70,070 Hidalgotitlán,Mujeres,711,704,7,6182
30 Veracruz de Ignacio de la Llave,70,070 Hidalgotitlán,Mujeres,10,10,0,659
30 Veracruz de Ignacio de la Llave,70,070 Hidalgotitlán,Mujeres,87,86,1,1083
30 Veracruz de Ignacio de la Llave,70,070 Hidalgotitlán,Mujeres,129,127,2,647
30 Veracruz de Ignacio de la Llave,70,070 Hidalgotitlán,Mujeres,90,87,3,522
30 Veracruz de Ignacio de la Llave,70,070 Hidalgotitlán,Mujeres,88,88,0,566
30 Veracruz de Ignacio de la Llave,70,070 Hidalgotitlán,Mujeres,78,77,1,543
30 Veracruz de Ignacio de la Llave,70,070 Hidalgotitlán,Mujeres,81,81,0,443
30 Veracruz de Ignacio de la Llave,70,070 Hidalgotitlán,Mujeres,60,60,0,375
30 Veracruz de Ignacio de la Llave,70,070 Hidalgotitlán,Mujeres,30,30,0,334
30 Veracruz de Ignacio de la Llave,70,070 Hidalgotitlán,Mujeres,20,20,0,259
30 Veracruz de Ignacio de la Llave,70,070 Hidalgotitlán,Mujeres,17,17,0,214
30 Veracruz de Ignacio de la Llave,70,070 Hidalgotitlán,Mujeres,12,12,0,210
30 Veracruz de Ignacio de la Llave,70,070 Hidalgotitlán,Mujeres,6,6,0,137
30 Veracruz de Ignacio de la Llave,70,070 Hidalgotitlán,Mujeres,2,2,0,91
30 Veracruz de Ignacio de la Llave,70,070 Hidalgotitlán,Mujeres,0,0,0,43
30 Veracruz de Ignacio de la Llave,70,070 Hidalgotitlán,Mujeres,1,1,0,56
30 Veracruz de Ignacio de la Llave,71,071 Huatusco,Total,21591,20966,625,19111
30 Veracruz de Ignacio de la Llave,71,071 Huatusco,Total,352,338,14,3196
30 Veracruz de Ignacio de la Llave,71,071 Huatusco,Total,2072,2000,72,3657
30 Veracruz de Ignacio de la Llave,71,071 Huatusco,Total,2930,2820,110,2215
30 Veracruz de Ignacio de la Llave,71,071 Huatusco,Total,2812,2726,86,1442
30 Veracruz de Ignacio de la Llave,71,071 Huatusco,Total,2696,2626,70,1357
30 Veracruz de Ignacio de la Llave,71,071 Huatusco,Total,2510,2455,55,1184
30 Veracruz de Ignacio de la Llave,71,071 Huatusco,Total,2096,2036,60,985
30 Veracruz de Ignacio de la Llave,71,071 Huatusco,Total,1768,1730,38,871
30 Veracruz de Ignacio de la Llave,71,071 Huatusco,Total,1426,1381,45,772
30 Veracruz de Ignacio de la Llave,71,071 Huatusco,Total,1056,1024,32,733
30 Veracruz de Ignacio de la Llave,71,071 Huatusco,Total,699,688,11,609
30 Veracruz de Ignacio de la Llave,71,071 Huatusco,Total,442,428,14,542
30 Veracruz de Ignacio de la Llave,71,071 Huatusco,Total,364,352,12,546
30 Veracruz de Ignacio de la Llave,71,071 Huatusco,Total,198,196,2,429
30 Veracruz de Ignacio de la Llave,71,071 Huatusco,Total,98,96,2,288
30 Veracruz de Ignacio de la Llave,71,071 Huatusco,Total,72,70,2,285
30 Veracruz de Ignacio de la Llave,71,071 Huatusco,Hombres,15028,14494,534,4006
30 Veracruz de Ignacio de la Llave,71,071 Huatusco,Hombres,301,288,13,1482
30 Veracruz de Ignacio de la Llave,71,071 Huatusco,Hombres,1565,1511,54,1314
30 Veracruz de Ignacio de la Llave,71,071 Huatusco,Hombres,1993,1908,85,403
30 Veracruz de Ignacio de la Llave,71,071 Huatusco,Hombres,1862,1794,68,79
30 Veracruz de Ignacio de la Llave,71,071 Huatusco,Hombres,1818,1759,59,38
30 Veracruz de Ignacio de la Llave,71,071 Huatusco,Hombres,1660,1609,51,37
30 Veracruz de Ignacio de la Llave,71,071 Huatusco,Hombres,1385,1331,54,30
30 Veracruz de Ignacio de la Llave,71,071 Huatusco,Hombres,1199,1163,36,42
30 Veracruz de Ignacio de la Llave,71,071 Huatusco,Hombres,1014,971,43,36
30 Veracruz de Ignacio de la Llave,71,071 Huatusco,Hombres,773,744,29,73
30 Veracruz de Ignacio de la Llave,71,071 Huatusco,Hombres,530,519,11,70
30 Veracruz de Ignacio de la Llave,71,071 Huatusco,Hombres,333,319,14,82
30 Veracruz de Ignacio de la Llave,71,071 Huatusco,Hombres,289,277,12,95
30 Veracruz de Ignacio de la Llave,71,071 Huatusco,Hombres,161,160,1,89
30 Veracruz de Ignacio de la Llave,71,071 Huatusco,Hombres,85,83,2,75
30 Veracruz de Ignacio de la Llave,71,071 Huatusco,Hombres,60,58,2,61
30 Veracruz de Ignacio de la Llave,71,071 Huatusco,Mujeres,6563,6472,91,15105
30 Veracruz de Ignacio de la Llave,71,071 Huatusco,Mujeres,51,50,1,1714
30 Veracruz de Ignacio de la Llave,71,071 Huatusco,Mujeres,507,489,18,2343
30 Veracruz de Ignacio de la Llave,71,071 Huatusco,Mujeres,937,912,25,1812
30 Veracruz de Ignacio de la Llave,71,071 Huatusco,Mujeres,950,932,18,1363
30 Veracruz de Ignacio de la Llave,71,071 Huatusco,Mujeres,878,867,11,1319
30 Veracruz de Ignacio de la Llave,71,071 Huatusco,Mujeres,850,846,4,1147
30 Veracruz de Ignacio de la Llave,71,071 Huatusco,Mujeres,711,705,6,955
30 Veracruz de Ignacio de la Llave,71,071 Huatusco,Mujeres,569,567,2,829
30 Veracruz de Ignacio de la Llave,71,071 Huatusco,Mujeres,412,410,2,736
30 Veracruz de Ignacio de la Llave,71,071 Huatusco,Mujeres,283,280,3,660
30 Veracruz de Ignacio de la Llave,71,071 Huatusco,Mujeres,169,169,0,539
30 Veracruz de Ignacio de la Llave,71,071 Huatusco,Mujeres,109,109,0,460
30 Veracruz de Ignacio de la Llave,71,071 Huatusco,Mujeres,75,75,0,451
30 Veracruz de Ignacio de la Llave,71,071 Huatusco,Mujeres,37,36,1,340
30 Veracruz de Ignacio de la Llave,71,071 Huatusco,Mujeres,13,13,0,213
30 Veracruz de Ignacio de la Llave,71,071 Huatusco,Mujeres,12,12,0,224
30 Veracruz de Ignacio de la Llave,72,072 Huayacocotla,Total,6899,6675,224,8127
30 Veracruz de Ignacio de la Llave,72,072 Huayacocotla,Total,81,75,6,1304
30 Veracruz de Ignacio de la Llave,72,072 Huayacocotla,Total,682,650,32,1539
30 Veracruz de Ignacio de la Llave,72,072 Huayacocotla,Total,783,756,27,713
30 Veracruz de Ignacio de la Llave,72,072 Huayacocotla,Total,837,813,24,630
30 Veracruz de Ignacio de la Llave,72,072 Huayacocotla,Total,833,815,18,550
30 Veracruz de Ignacio de la Llave,72,072 Huayacocotla,Total,788,755,33,525
30 Veracruz de Ignacio de la Llave,72,072 Huayacocotla,Total,647,627,20,448
30 Veracruz de Ignacio de la Llave,72,072 Huayacocotla,Total,596,578,18,359
30 Veracruz de Ignacio de la Llave,72,072 Huayacocotla,Total,459,445,14,341
30 Veracruz de Ignacio de la Llave,72,072 Huayacocotla,Total,358,345,13,312
30 Veracruz de Ignacio de la Llave,72,072 Huayacocotla,Total,264,256,8,328
30 Veracruz de Ignacio de la Llave,72,072 Huayacocotla,Total,249,245,4,279
30 Veracruz de Ignacio de la Llave,72,072 Huayacocotla,Total,177,174,3,263
30 Veracruz de Ignacio de la Llave,72,072 Huayacocotla,Total,84,82,2,214
30 Veracruz de Ignacio de la Llave,72,072 Huayacocotla,Total,37,35,2,140
30 Veracruz de Ignacio de la Llave,72,072 Huayacocotla,Total,24,24,0,182
30 Veracruz de Ignacio de la Llave,72,072 Huayacocotla,Hombres,5316,5114,202,1789
30 Veracruz de Ignacio de la Llave,72,072 Huayacocotla,Hombres,69,64,5,639
30 Veracruz de Ignacio de la Llave,72,072 Huayacocotla,Hombres,539,509,30,536
30 Veracruz de Ignacio de la Llave,72,072 Huayacocotla,Hombres,573,553,20,80
30 Veracruz de Ignacio de la Llave,72,072 Huayacocotla,Hombres,622,601,21,36
30 Veracruz de Ignacio de la Llave,72,072 Huayacocotla,Hombres,642,626,16,29
30 Veracruz de Ignacio de la Llave,72,072 Huayacocotla,Hombres,588,557,31,34
30 Veracruz de Ignacio de la Llave,72,072 Huayacocotla,Hombres,469,450,19,24
30 Veracruz de Ignacio de la Llave,72,072 Huayacocotla,Hombres,463,446,17,30
30 Veracruz de Ignacio de la Llave,72,072 Huayacocotla,Hombres,362,348,14,34
30 Veracruz de Ignacio de la Llave,72,072 Huayacocotla,Hombres,284,271,13,35
30 Veracruz de Ignacio de la Llave,72,072 Huayacocotla,Hombres,222,217,5,45
30 Veracruz de Ignacio de la Llave,72,072 Huayacocotla,Hombres,212,208,4,54
30 Veracruz de Ignacio de la Llave,72,072 Huayacocotla,Hombres,150,147,3,59
30 Veracruz de Ignacio de la Llave,72,072 Huayacocotla,Hombres,67,65,2,61
30 Veracruz de Ignacio de la Llave,72,072 Huayacocotla,Hombres,32,30,2,36
30 Veracruz de Ignacio de la Llave,72,072 Huayacocotla,Hombres,22,22,0,57
30 Veracruz de Ignacio de la Llave,72,072 Huayacocotla,Mujeres,1583,1561,22,6338
30 Veracruz de Ignacio de la Llave,72,072 Huayacocotla,Mujeres,12,11,1,665
30 Veracruz de Ignacio de la Llave,72,072 Huayacocotla,Mujeres,143,141,2,1003
30 Veracruz de Ignacio de la Llave,72,072 Huayacocotla,Mujeres,210,203,7,633
30 Veracruz de Ignacio de la Llave,72,072 Huayacocotla,Mujeres,215,212,3,594
30 Veracruz de Ignacio de la Llave,72,072 Huayacocotla,Mujeres,191,189,2,521
30 Veracruz de Ignacio de la Llave,72,072 Huayacocotla,Mujeres,200,198,2,491
30 Veracruz de Ignacio de la Llave,72,072 Huayacocotla,Mujeres,178,177,1,424
30 Veracruz de Ignacio de la Llave,72,072 Huayacocotla,Mujeres,133,132,1,329
30 Veracruz de Ignacio de la Llave,72,072 Huayacocotla,Mujeres,97,97,0,307
30 Veracruz de Ignacio de la Llave,72,072 Huayacocotla,Mujeres,74,74,0,277
30 Veracruz de Ignacio de la Llave,72,072 Huayacocotla,Mujeres,42,39,3,283
30 Veracruz de Ignacio de la Llave,72,072 Huayacocotla,Mujeres,37,37,0,225
30 Veracruz de Ignacio de la Llave,72,072 Huayacocotla,Mujeres,27,27,0,204
30 Veracruz de Ignacio de la Llave,72,072 Huayacocotla,Mujeres,17,17,0,153
30 Veracruz de Ignacio de la Llave,72,072 Huayacocotla,Mujeres,5,5,0,104
30 Veracruz de Ignacio de la Llave,72,072 Huayacocotla,Mujeres,2,2,0,125
30 Veracruz de Ignacio de la Llave,73,073 Hueyapan de Ocampo,Total,12707,12151,556,18696
30 Veracruz de Ignacio de la Llave,73,073 Hueyapan de Ocampo,Total,86,79,7,2747
30 Veracruz de Ignacio de la Llave,73,073 Hueyapan de Ocampo,Total,919,848,71,3442
30 Veracruz de Ignacio de la Llave,73,073 Hueyapan de Ocampo,Total,1420,1317,103,1566
30 Veracruz de Ignacio de la Llave,73,073 Hueyapan de Ocampo,Total,1431,1361,70,1305
30 Veracruz de Ignacio de la Llave,73,073 Hueyapan de Ocampo,Total,1446,1402,44,1348
30 Veracruz de Ignacio de la Llave,73,073 Hueyapan de Ocampo,Total,1518,1458,60,1256
30 Veracruz de Ignacio de la Llave,73,073 Hueyapan de Ocampo,Total,1348,1297,51,1067
30 Veracruz de Ignacio de la Llave,73,073 Hueyapan de Ocampo,Total,1267,1224,43,1054
30 Veracruz de Ignacio de la Llave,73,073 Hueyapan de Ocampo,Total,1090,1050,40,903
30 Veracruz de Ignacio de la Llave,73,073 Hueyapan de Ocampo,Total,875,843,32,882
30 Veracruz de Ignacio de la Llave,73,073 Hueyapan de Ocampo,Total,484,472,12,745
30 Veracruz de Ignacio de la Llave,73,073 Hueyapan de Ocampo,Total,372,362,10,697
30 Veracruz de Ignacio de la Llave,73,073 Hueyapan de Ocampo,Total,239,233,6,629
30 Veracruz de Ignacio de la Llave,73,073 Hueyapan de Ocampo,Total,138,134,4,454
30 Veracruz de Ignacio de la Llave,73,073 Hueyapan de Ocampo,Total,38,38,0,301
30 Veracruz de Ignacio de la Llave,73,073 Hueyapan de Ocampo,Total,36,33,3,300
30 Veracruz de Ignacio de la Llave,73,073 Hueyapan de Ocampo,Hombres,10670,10176,494,4380
30 Veracruz de Ignacio de la Llave,73,073 Hueyapan de Ocampo,Hombres,80,74,6,1360
30 Veracruz de Ignacio de la Llave,73,073 Hueyapan de Ocampo,Hombres,803,742,61,1342
30 Veracruz de Ignacio de la Llave,73,073 Hueyapan de Ocampo,Hombres,1178,1089,89,200
30 Veracruz de Ignacio de la Llave,73,073 Hueyapan de Ocampo,Hombres,1159,1104,55,63
30 Veracruz de Ignacio de la Llave,73,073 Hueyapan de Ocampo,Hombres,1178,1141,37,64
30 Veracruz de Ignacio de la Llave,73,073 Hueyapan de Ocampo,Hombres,1236,1181,55,63
30 Veracruz de Ignacio de la Llave,73,073 Hueyapan de Ocampo,Hombres,1103,1054,49,76
30 Veracruz de Ignacio de la Llave,73,073 Hueyapan de Ocampo,Hombres,1044,1003,41,63
30 Veracruz de Ignacio de la Llave,73,073 Hueyapan de Ocampo,Hombres,944,907,37,73
30 Veracruz de Ignacio de la Llave,73,073 Hueyapan de Ocampo,Hombres,765,735,30,86
30 Veracruz de Ignacio de la Llave,73,073 Hueyapan de Ocampo,Hombres,427,415,12,175
30 Veracruz de Ignacio de la Llave,73,073 Hueyapan de Ocampo,Hombres,340,330,10,193
30 Veracruz de Ignacio de la Llave,73,073 Hueyapan de Ocampo,Hombres,217,212,5,221
30 Veracruz de Ignacio de la Llave,73,073 Hueyapan de Ocampo,Hombres,130,126,4,162
30 Veracruz de Ignacio de la Llave,73,073 Hueyapan de Ocampo,Hombres,33,33,0,117
30 Veracruz de Ignacio de la Llave,73,073 Hueyapan de Ocampo,Hombres,33,30,3,122
30 Veracruz de Ignacio de la Llave,73,073 Hueyapan de Ocampo,Mujeres,2037,1975,62,14316
30 Veracruz de Ignacio de la Llave,73,073 Hueyapan de Ocampo,Mujeres,6,5,1,1387
30 Veracruz de Ignacio de la Llave,73,073 Hueyapan de Ocampo,Mujeres,116,106,10,2100
30 Veracruz de Ignacio de la Llave,73,073 Hueyapan de Ocampo,Mujeres,242,228,14,1366
30 Veracruz de Ignacio de la Llave,73,073 Hueyapan de Ocampo,Mujeres,272,257,15,1242
30 Veracruz de Ignacio de la Llave,73,073 Hueyapan de Ocampo,Mujeres,268,261,7,1284
30 Veracruz de Ignacio de la Llave,73,073 Hueyapan de Ocampo,Mujeres,282,277,5,1193
30 Veracruz de Ignacio de la Llave,73,073 Hueyapan de Ocampo,Mujeres,245,243,2,991
30 Veracruz de Ignacio de la Llave,73,073 Hueyapan de Ocampo,Mujeres,223,221,2,991
30 Veracruz de Ignacio de la Llave,73,073 Hueyapan de Ocampo,Mujeres,146,143,3,830
30 Veracruz de Ignacio de la Llave,73,073 Hueyapan de Ocampo,Mujeres,110,108,2,796
30 Veracruz de Ignacio de la Llave,73,073 Hueyapan de Ocampo,Mujeres,57,57,0,570
30 Veracruz de Ignacio de la Llave,73,073 Hueyapan de Ocampo,Mujeres,32,32,0,504
30 Veracruz de Ignacio de la Llave,73,073 Hueyapan de Ocampo,Mujeres,22,21,1,408
30 Veracruz de Ignacio de la Llave,73,073 Hueyapan de Ocampo,Mujeres,8,8,0,292
30 Veracruz de Ignacio de la Llave,73,073 Hueyapan de Ocampo,Mujeres,5,5,0,184
30 Veracruz de Ignacio de la Llave,73,073 Hueyapan de Ocampo,Mujeres,3,3,0,178
30 Veracruz de Ignacio de la Llave,74,074 Huiloapan de Cuauhtémoc,Total,2557,2387,170,2575
30 Veracruz de Ignacio de la Llave,74,074 Huiloapan de Cuauhtémoc,Total,10,9,1,336
30 Veracruz de Ignacio de la Llave,74,074 Huiloapan de Cuauhtémoc,Total,150,130,20,493
30 Veracruz de Ignacio de la Llave,74,074 Huiloapan de Cuauhtémoc,Total,283,259,24,286
30 Veracruz de Ignacio de la Llave,74,074 Huiloapan de Cuauhtémoc,Total,366,337,29,179
30 Veracruz de Ignacio de la Llave,74,074 Huiloapan de Cuauhtémoc,Total,321,311,10,177
30 Veracruz de Ignacio de la Llave,74,074 Huiloapan de Cuauhtémoc,Total,371,357,14,170
30 Veracruz de Ignacio de la Llave,74,074 Huiloapan de Cuauhtémoc,Total,295,281,14,136
30 Veracruz de Ignacio de la Llave,74,074 Huiloapan de Cuauhtémoc,Total,218,204,14,101
30 Veracruz de Ignacio de la Llave,74,074 Huiloapan de Cuauhtémoc,Total,209,198,11,132
30 Veracruz de Ignacio de la Llave,74,074 Huiloapan de Cuauhtémoc,Total,144,128,16,106
30 Veracruz de Ignacio de la Llave,74,074 Huiloapan de Cuauhtémoc,Total,90,81,9,109
30 Veracruz de Ignacio de la Llave,74,074 Huiloapan de Cuauhtémoc,Total,41,41,0,95
30 Veracruz de Ignacio de la Llave,74,074 Huiloapan de Cuauhtémoc,Total,38,33,5,89
30 Veracruz de Ignacio de la Llave,74,074 Huiloapan de Cuauhtémoc,Total,17,15,2,71
30 Veracruz de Ignacio de la Llave,74,074 Huiloapan de Cuauhtémoc,Total,2,1,1,41
30 Veracruz de Ignacio de la Llave,74,074 Huiloapan de Cuauhtémoc,Total,2,2,0,54
30 Veracruz de Ignacio de la Llave,74,074 Huiloapan de Cuauhtémoc,Hombres,1729,1590,139,689
30 Veracruz de Ignacio de la Llave,74,074 Huiloapan de Cuauhtémoc,Hombres,8,7,1,162
30 Veracruz de Ignacio de la Llave,74,074 Huiloapan de Cuauhtémoc,Hombres,111,93,18,222
30 Veracruz de Ignacio de la Llave,74,074 Huiloapan de Cuauhtémoc,Hombres,202,185,17,67
30 Veracruz de Ignacio de la Llave,74,074 Huiloapan de Cuauhtémoc,Hombres,247,226,21,18
30 Veracruz de Ignacio de la Llave,74,074 Huiloapan de Cuauhtémoc,Hombres,195,190,5,12
30 Veracruz de Ignacio de la Llave,74,074 Huiloapan de Cuauhtémoc,Hombres,241,230,11,9
30 Veracruz de Ignacio de la Llave,74,074 Huiloapan de Cuauhtémoc,Hombres,209,196,13,6
30 Veracruz de Ignacio de la Llave,74,074 Huiloapan de Cuauhtémoc,Hombres,143,131,12,12
30 Veracruz de Ignacio de la Llave,74,074 Huiloapan de Cuauhtémoc,Hombres,142,131,11,13
30 Veracruz de Ignacio de la Llave,74,074 Huiloapan de Cuauhtémoc,Hombres,104,88,16,21
30 Veracruz de Ignacio de la Llave,74,074 Huiloapan de Cuauhtémoc,Hombres,63,56,7,27
30 Veracruz de Ignacio de la Llave,74,074 Huiloapan de Cuauhtémoc,Hombres,28,28,0,25
30 Veracruz de Ignacio de la Llave,74,074 Huiloapan de Cuauhtémoc,Hombres,24,19,5,30
30 Veracruz de Ignacio de la Llave,74,074 Huiloapan de Cuauhtémoc,Hombres,9,8,1,22
30 Veracruz de Ignacio de la Llave,74,074 Huiloapan de Cuauhtémoc,Hombres,1,0,1,18
30 Veracruz de Ignacio de la Llave,74,074 Huiloapan de Cuauhtémoc,Hombres,2,2,0,25
30 Veracruz de Ignacio de la Llave,74,074 Huiloapan de Cuauhtémoc,Mujeres,828,797,31,1886
30 Veracruz de Ignacio de la Llave,74,074 Huiloapan de Cuauhtémoc,Mujeres,2,2,0,174
30 Veracruz de Ignacio de la Llave,74,074 Huiloapan de Cuauhtémoc,Mujeres,39,37,2,271
30 Veracruz de Ignacio de la Llave,74,074 Huiloapan de Cuauhtémoc,Mujeres,81,74,7,219
30 Veracruz de Ignacio de la Llave,74,074 Huiloapan de Cuauhtémoc,Mujeres,119,111,8,161
30 Veracruz de Ignacio de la Llave,74,074 Huiloapan de Cuauhtémoc,Mujeres,126,121,5,165
30 Veracruz de Ignacio de la Llave,74,074 Huiloapan de Cuauhtémoc,Mujeres,130,127,3,161
30 Veracruz de Ignacio de la Llave,74,074 Huiloapan de Cuauhtémoc,Mujeres,86,85,1,130
30 Veracruz de Ignacio de la Llave,74,074 Huiloapan de Cuauhtémoc,Mujeres,75,73,2,89
30 Veracruz de Ignacio de la Llave,74,074 Huiloapan de Cuauhtémoc,Mujeres,67,67,0,119
30 Veracruz de Ignacio de la Llave,74,074 Huiloapan de Cuauhtémoc,Mujeres,40,40,0,85
30 Veracruz de Ignacio de la Llave,74,074 Huiloapan de Cuauhtémoc,Mujeres,27,25,2,82
30 Veracruz de Ignacio de la Llave,74,074 Huiloapan de Cuauhtémoc,Mujeres,13,13,0,70
30 Veracruz de Ignacio de la Llave,74,074 Huiloapan de Cuauhtémoc,Mujeres,14,14,0,59
30 Veracruz de Ignacio de la Llave,74,074 Huiloapan de Cuauhtémoc,Mujeres,8,7,1,49
30 Veracruz de Ignacio de la Llave,74,074 Huiloapan de Cuauhtémoc,Mujeres,1,1,0,23
30 Veracruz de Ignacio de la Llave,74,074 Huiloapan de Cuauhtémoc,Mujeres,0,0,0,29
30 Veracruz de Ignacio de la Llave,75,075 Ignacio de la Llave,Total,5819,5435,384,7708
30 Veracruz de Ignacio de la Llave,75,075 Ignacio de la Llave,Total,41,40,1,1020
30 Veracruz de Ignacio de la Llave,75,075 Ignacio de la Llave,Total,372,340,32,1305
30 Veracruz de Ignacio de la Llave,75,075 Ignacio de la Llave,Total,617,553,64,563
30 Veracruz de Ignacio de la Llave,75,075 Ignacio de la Llave,Total,545,502,43,432
30 Veracruz de Ignacio de la Llave,75,075 Ignacio de la Llave,Total,599,559,40,460
30 Veracruz de Ignacio de la Llave,75,075 Ignacio de la Llave,Total,664,624,40,511
30 Veracruz de Ignacio de la Llave,75,075 Ignacio de la Llave,Total,580,548,32,500
30 Veracruz de Ignacio de la Llave,75,075 Ignacio de la Llave,Total,554,531,23,424
30 Veracruz de Ignacio de la Llave,75,075 Ignacio de la Llave,Total,480,452,28,416
30 Veracruz de Ignacio de la Llave,75,075 Ignacio de la Llave,Total,424,392,32,438
30 Veracruz de Ignacio de la Llave,75,075 Ignacio de la Llave,Total,353,334,19,377
30 Veracruz de Ignacio de la Llave,75,075 Ignacio de la Llave,Total,266,246,20,314
30 Veracruz de Ignacio de la Llave,75,075 Ignacio de la Llave,Total,174,167,7,315
30 Veracruz de Ignacio de la Llave,75,075 Ignacio de la Llave,Total,88,86,2,259
30 Veracruz de Ignacio de la Llave,75,075 Ignacio de la Llave,Total,36,36,0,169
30 Veracruz de Ignacio de la Llave,75,075 Ignacio de la Llave,Total,26,25,1,205
30 Veracruz de Ignacio de la Llave,75,075 Ignacio de la Llave,Hombres,4657,4302,355,1808
30 Veracruz de Ignacio de la Llave,75,075 Ignacio de la Llave,Hombres,35,35,0,487
30 Veracruz de Ignacio de la Llave,75,075 Ignacio de la Llave,Hombres,307,277,30,558
30 Veracruz de Ignacio de la Llave,75,075 Ignacio de la Llave,Hombres,479,425,54,91
30 Veracruz de Ignacio de la Llave,75,075 Ignacio de la Llave,Hombres,397,358,39,40
30 Veracruz de Ignacio de la Llave,75,075 Ignacio de la Llave,Hombres,459,421,38,29
30 Veracruz de Ignacio de la Llave,75,075 Ignacio de la Llave,Hombres,505,468,37,42
30 Veracruz de Ignacio de la Llave,75,075 Ignacio de la Llave,Hombres,440,410,30,44
30 Veracruz de Ignacio de la Llave,75,075 Ignacio de la Llave,Hombres,429,407,22,48
30 Veracruz de Ignacio de la Llave,75,075 Ignacio de la Llave,Hombres,379,353,26,49
30 Veracruz de Ignacio de la Llave,75,075 Ignacio de la Llave,Hombres,371,339,32,55
30 Veracruz de Ignacio de la Llave,75,075 Ignacio de la Llave,Hombres,318,299,19,52
30 Veracruz de Ignacio de la Llave,75,075 Ignacio de la Llave,Hombres,240,222,18,61
30 Veracruz de Ignacio de la Llave,75,075 Ignacio de la Llave,Hombres,159,152,7,70
30 Veracruz de Ignacio de la Llave,75,075 Ignacio de la Llave,Hombres,82,80,2,59
30 Veracruz de Ignacio de la Llave,75,075 Ignacio de la Llave,Hombres,32,32,0,53
30 Veracruz de Ignacio de la Llave,75,075 Ignacio de la Llave,Hombres,25,24,1,70
30 Veracruz de Ignacio de la Llave,75,075 Ignacio de la Llave,Mujeres,1162,1133,29,5900
30 Veracruz de Ignacio de la Llave,75,075 Ignacio de la Llave,Mujeres,6,5,1,533
30 Veracruz de Ignacio de la Llave,75,075 Ignacio de la Llave,Mujeres,65,63,2,747
30 Veracruz de Ignacio de la Llave,75,075 Ignacio de la Llave,Mujeres,138,128,10,472
30 Veracruz de Ignacio de la Llave,75,075 Ignacio de la Llave,Mujeres,148,144,4,392
30 Veracruz de Ignacio de la Llave,75,075 Ignacio de la Llave,Mujeres,140,138,2,431
30 Veracruz de Ignacio de la Llave,75,075 Ignacio de la Llave,Mujeres,159,156,3,469
30 Veracruz de Ignacio de la Llave,75,075 Ignacio de la Llave,Mujeres,140,138,2,456
30 Veracruz de Ignacio de la Llave,75,075 Ignacio de la Llave,Mujeres,125,124,1,376
30 Veracruz de Ignacio de la Llave,75,075 Ignacio de la Llave,Mujeres,101,99,2,367
30 Veracruz de Ignacio de la Llave,75,075 Ignacio de la Llave,Mujeres,53,53,0,383
30 Veracruz de Ignacio de la Llave,75,075 Ignacio de la Llave,Mujeres,35,35,0,325
30 Veracruz de Ignacio de la Llave,75,075 Ignacio de la Llave,Mujeres,26,24,2,253
30 Veracruz de Ignacio de la Llave,75,075 Ignacio de la Llave,Mujeres,15,15,0,245
30 Veracruz de Ignacio de la Llave,75,075 Ignacio de la Llave,Mujeres,6,6,0,200
30 Veracruz de Ignacio de la Llave,75,075 Ignacio de la Llave,Mujeres,4,4,0,116
30 Veracruz de Ignacio de la Llave,75,075 Ignacio de la Llave,Mujeres,1,1,0,135
30 Veracruz de Ignacio de la Llave,76,076 Ilamatlán,Total,3584,3276,308,6017
30 Veracruz de Ignacio de la Llave,76,076 Ilamatlán,Total,57,51,6,1025
30 Veracruz de Ignacio de la Llave,76,076 Ilamatlán,Total,383,316,67,1143
30 Veracruz de Ignacio de la Llave,76,076 Ilamatlán,Total,386,356,30,496
30 Veracruz de Ignacio de la Llave,76,076 Ilamatlán,Total,372,330,42,434
30 Veracruz de Ignacio de la Llave,76,076 Ilamatlán,Total,380,352,28,381
30 Veracruz de Ignacio de la Llave,76,076 Ilamatlán,Total,374,343,31,403
30 Veracruz de Ignacio de la Llave,76,076 Ilamatlán,Total,297,285,12,286
30 Veracruz de Ignacio de la Llave,76,076 Ilamatlán,Total,296,280,16,304
30 Veracruz de Ignacio de la Llave,76,076 Ilamatlán,Total,216,201,15,238
30 Veracruz de Ignacio de la Llave,76,076 Ilamatlán,Total,222,208,14,268
30 Veracruz de Ignacio de la Llave,76,076 Ilamatlán,Total,204,190,14,229
30 Veracruz de Ignacio de la Llave,76,076 Ilamatlán,Total,139,129,10,190
30 Veracruz de Ignacio de la Llave,76,076 Ilamatlán,Total,163,150,13,304
30 Veracruz de Ignacio de la Llave,76,076 Ilamatlán,Total,56,52,4,148
30 Veracruz de Ignacio de la Llave,76,076 Ilamatlán,Total,23,19,4,84
30 Veracruz de Ignacio de la Llave,76,076 Ilamatlán,Total,16,14,2,84
30 Veracruz de Ignacio de la Llave,76,076 Ilamatlán,Hombres,3041,2754,287,1410
30 Veracruz de Ignacio de la Llave,76,076 Ilamatlán,Hombres,51,45,6,472
30 Veracruz de Ignacio de la Llave,76,076 Ilamatlán,Hombres,336,278,58,415
30 Veracruz de Ignacio de la Llave,76,076 Ilamatlán,Hombres,318,290,28,84
30 Veracruz de Ignacio de la Llave,76,076 Ilamatlán,Hombres,315,275,40,44
30 Veracruz de Ignacio de la Llave,76,076 Ilamatlán,Hombres,323,298,25,35
30 Veracruz de Ignacio de la Llave,76,076 Ilamatlán,Hombres,306,277,29,47
30 Veracruz de Ignacio de la Llave,76,076 Ilamatlán,Hombres,237,225,12,22
30 Veracruz de Ignacio de la Llave,76,076 Ilamatlán,Hombres,242,227,15,28
30 Veracruz de Ignacio de la Llave,76,076 Ilamatlán,Hombres,188,173,15,31
30 Veracruz de Ignacio de la Llave,76,076 Ilamatlán,Hombres,190,176,14,25
30 Veracruz de Ignacio de la Llave,76,076 Ilamatlán,Hombres,176,163,13,31
30 Veracruz de Ignacio de la Llave,76,076 Ilamatlán,Hombres,126,116,10,33
30 Veracruz de Ignacio de la Llave,76,076 Ilamatlán,Hombres,147,135,12,61
30 Veracruz de Ignacio de la Llave,76,076 Ilamatlán,Hombres,51,47,4,35
30 Veracruz de Ignacio de la Llave,76,076 Ilamatlán,Hombres,20,16,4,20
30 Veracruz de Ignacio de la Llave,76,076 Ilamatlán,Hombres,15,13,2,27
30 Veracruz de Ignacio de la Llave,76,076 Ilamatlán,Mujeres,543,522,21,4607
30 Veracruz de Ignacio de la Llave,76,076 Ilamatlán,Mujeres,6,6,0,553
30 Veracruz de Ignacio de la Llave,76,076 Ilamatlán,Mujeres,47,38,9,728
30 Veracruz de Ignacio de la Llave,76,076 Ilamatlán,Mujeres,68,66,2,412
30 Veracruz de Ignacio de la Llave,76,076 Ilamatlán,Mujeres,57,55,2,390
30 Veracruz de Ignacio de la Llave,76,076 Ilamatlán,Mujeres,57,54,3,346
30 Veracruz de Ignacio de la Llave,76,076 Ilamatlán,Mujeres,68,66,2,356
30 Veracruz de Ignacio de la Llave,76,076 Ilamatlán,Mujeres,60,60,0,264
30 Veracruz de Ignacio de la Llave,76,076 Ilamatlán,Mujeres,54,53,1,276
30 Veracruz de Ignacio de la Llave,76,076 Ilamatlán,Mujeres,28,28,0,207
30 Veracruz de Ignacio de la Llave,76,076 Ilamatlán,Mujeres,32,32,0,243
30 Veracruz de Ignacio de la Llave,76,076 Ilamatlán,Mujeres,28,27,1,198
30 Veracruz de Ignacio de la Llave,76,076 Ilamatlán,Mujeres,13,13,0,157
30 Veracruz de Ignacio de la Llave,76,076 Ilamatlán,Mujeres,16,15,1,243
30 Veracruz de Ignacio de la Llave,76,076 Ilamatlán,Mujeres,5,5,0,113
30 Veracruz de Ignacio de la Llave,76,076 Ilamatlán,Mujeres,3,3,0,64
30 Veracruz de Ignacio de la Llave,76,076 Ilamatlán,Mujeres,1,1,0,57
30 Veracruz de Ignacio de la Llave,77,077 Isla,Total,16794,16352,442,15565
30 Veracruz de Ignacio de la Llave,77,077 Isla,Total,230,225,5,2267
30 Veracruz de Ignacio de la Llave,77,077 Isla,Total,1621,1555,66,2932
30 Veracruz de Ignacio de la Llave,77,077 Isla,Total,2226,2150,76,1488
30 Veracruz de Ignacio de la Llave,77,077 Isla,Total,1915,1867,48,1141
30 Veracruz de Ignacio de la Llave,77,077 Isla,Total,1935,1902,33,1135
30 Veracruz de Ignacio de la Llave,77,077 Isla,Total,2020,1986,34,1140
30 Veracruz de Ignacio de la Llave,77,077 Isla,Total,1703,1668,35,1006
30 Veracruz de Ignacio de la Llave,77,077 Isla,Total,1455,1419,36,819
30 Veracruz de Ignacio de la Llave,77,077 Isla,Total,1195,1158,37,783
30 Veracruz de Ignacio de la Llave,77,077 Isla,Total,891,869,22,646
30 Veracruz de Ignacio de la Llave,77,077 Isla,Total,632,608,24,531
30 Veracruz de Ignacio de la Llave,77,077 Isla,Total,454,440,14,459
30 Veracruz de Ignacio de la Llave,77,077 Isla,Total,282,274,8,483
30 Veracruz de Ignacio de la Llave,77,077 Isla,Total,151,149,2,320
30 Veracruz de Ignacio de la Llave,77,077 Isla,Total,51,49,2,176
30 Veracruz de Ignacio de la Llave,77,077 Isla,Total,33,33,0,239
30 Veracruz de Ignacio de la Llave,77,077 Isla,Hombres,12579,12212,367,2945
30 Veracruz de Ignacio de la Llave,77,077 Isla,Hombres,200,195,5,1032
30 Veracruz de Ignacio de la Llave,77,077 Isla,Hombres,1273,1221,52,1004
30 Veracruz de Ignacio de la Llave,77,077 Isla,Hombres,1613,1559,54,152
30 Veracruz de Ignacio de la Llave,77,077 Isla,Hombres,1367,1333,34,44
30 Veracruz de Ignacio de la Llave,77,077 Isla,Hombres,1365,1341,24,37
30 Veracruz de Ignacio de la Llave,77,077 Isla,Hombres,1402,1370,32,36
30 Veracruz de Ignacio de la Llave,77,077 Isla,Hombres,1254,1222,32,31
30 Veracruz de Ignacio de la Llave,77,077 Isla,Hombres,1079,1049,30,28
30 Veracruz de Ignacio de la Llave,77,077 Isla,Hombres,935,898,37,44
30 Veracruz de Ignacio de la Llave,77,077 Isla,Hombres,699,679,20,46
30 Veracruz de Ignacio de la Llave,77,077 Isla,Hombres,520,499,21,58
30 Veracruz de Ignacio de la Llave,77,077 Isla,Hombres,402,388,14,75
30 Veracruz de Ignacio de la Llave,77,077 Isla,Hombres,255,247,8,113
30 Veracruz de Ignacio de la Llave,77,077 Isla,Hombres,136,134,2,90
30 Veracruz de Ignacio de la Llave,77,077 Isla,Hombres,47,45,2,68
30 Veracruz de Ignacio de la Llave,77,077 Isla,Hombres,32,32,0,87
30 Veracruz de Ignacio de la Llave,77,077 Isla,Mujeres,4215,4140,75,12620
30 Veracruz de Ignacio de la Llave,77,077 Isla,Mujeres,30,30,0,1235
30 Veracruz de Ignacio de la Llave,77,077 Isla,Mujeres,348,334,14,1928
30 Veracruz de Ignacio de la Llave,77,077 Isla,Mujeres,613,591,22,1336
30 Veracruz de Ignacio de la Llave,77,077 Isla,Mujeres,548,534,14,1097
30 Veracruz de Ignacio de la Llave,77,077 Isla,Mujeres,570,561,9,1098
30 Veracruz de Ignacio de la Llave,77,077 Isla,Mujeres,618,616,2,1104
30 Veracruz de Ignacio de la Llave,77,077 Isla,Mujeres,449,446,3,975
30 Veracruz de Ignacio de la Llave,77,077 Isla,Mujeres,376,370,6,791
30 Veracruz de Ignacio de la Llave,77,077 Isla,Mujeres,260,260,0,739
30 Veracruz de Ignacio de la Llave,77,077 Isla,Mujeres,192,190,2,600
30 Veracruz de Ignacio de la Llave,77,077 Isla,Mujeres,112,109,3,473
30 Veracruz de Ignacio de la Llave,77,077 Isla,Mujeres,52,52,0,384
30 Veracruz de Ignacio de la Llave,77,077 Isla,Mujeres,27,27,0,370
30 Veracruz de Ignacio de la Llave,77,077 Isla,Mujeres,15,15,0,230
30 Veracruz de Ignacio de la Llave,77,077 Isla,Mujeres,4,4,0,108
30 Veracruz de Ignacio de la Llave,77,077 Isla,Mujeres,1,1,0,152
30 Veracruz de Ignacio de la Llave,78,078 Ixcatepec,Total,4298,4248,50,5615
30 Veracruz de Ignacio de la Llave,78,078 Ixcatepec,Total,43,41,2,958
30 Veracruz de Ignacio de la Llave,78,078 Ixcatepec,Total,358,349,9,1217
30 Veracruz de Ignacio de la Llave,78,078 Ixcatepec,Total,404,396,8,381
30 Veracruz de Ignacio de la Llave,78,078 Ixcatepec,Total,355,351,4,256
30 Veracruz de Ignacio de la Llave,78,078 Ixcatepec,Total,367,361,6,293
30 Veracruz de Ignacio de la Llave,78,078 Ixcatepec,Total,430,428,2,322
30 Veracruz de Ignacio de la Llave,78,078 Ixcatepec,Total,448,442,6,337
30 Veracruz de Ignacio de la Llave,78,078 Ixcatepec,Total,419,415,4,309
30 Veracruz de Ignacio de la Llave,78,078 Ixcatepec,Total,373,368,5,294
30 Veracruz de Ignacio de la Llave,78,078 Ixcatepec,Total,265,264,1,282
30 Veracruz de Ignacio de la Llave,78,078 Ixcatepec,Total,289,286,3,221
30 Veracruz de Ignacio de la Llave,78,078 Ixcatepec,Total,238,238,0,209
30 Veracruz de Ignacio de la Llave,78,078 Ixcatepec,Total,154,154,0,199
30 Veracruz de Ignacio de la Llave,78,078 Ixcatepec,Total,85,85,0,151
30 Veracruz de Ignacio de la Llave,78,078 Ixcatepec,Total,43,43,0,97
30 Veracruz de Ignacio de la Llave,78,078 Ixcatepec,Total,27,27,0,89
30 Veracruz de Ignacio de la Llave,78,078 Ixcatepec,Hombres,3556,3519,37,1321
30 Veracruz de Ignacio de la Llave,78,078 Ixcatepec,Hombres,37,35,2,485
30 Veracruz de Ignacio de la Llave,78,078 Ixcatepec,Hombres,280,273,7,504
30 Veracruz de Ignacio de la Llave,78,078 Ixcatepec,Hombres,304,302,2,70
30 Veracruz de Ignacio de la Llave,78,078 Ixcatepec,Hombres,288,285,3,20
30 Veracruz de Ignacio de la Llave,78,078 Ixcatepec,Hombres,305,301,4,9
30 Veracruz de Ignacio de la Llave,78,078 Ixcatepec,Hombres,342,340,2,12
30 Veracruz de Ignacio de la Llave,78,078 Ixcatepec,Hombres,345,340,5,19
30 Veracruz de Ignacio de la Llave,78,078 Ixcatepec,Hombres,348,345,3,18
30 Veracruz de Ignacio de la Llave,78,078 Ixcatepec,Hombres,323,318,5,10
30 Veracruz de Ignacio de la Llave,78,078 Ixcatepec,Hombres,236,235,1,20
30 Veracruz de Ignacio de la Llave,78,078 Ixcatepec,Hombres,251,248,3,11
30 Veracruz de Ignacio de la Llave,78,078 Ixcatepec,Hombres,212,212,0,17
30 Veracruz de Ignacio de la Llave,78,078 Ixcatepec,Hombres,142,142,0,32
30 Veracruz de Ignacio de la Llave,78,078 Ixcatepec,Hombres,75,75,0,33
30 Veracruz de Ignacio de la Llave,78,078 Ixcatepec,Hombres,41,41,0,21
30 Veracruz de Ignacio de la Llave,78,078 Ixcatepec,Hombres,27,27,0,40
30 Veracruz de Ignacio de la Llave,78,078 Ixcatepec,Mujeres,742,729,13,4294
30 Veracruz de Ignacio de la Llave,78,078 Ixcatepec,Mujeres,6,6,0,473
30 Veracruz de Ignacio de la Llave,78,078 Ixcatepec,Mujeres,78,76,2,713
30 Veracruz de Ignacio de la Llave,78,078 Ixcatepec,Mujeres,100,94,6,311
30 Veracruz de Ignacio de la Llave,78,078 Ixcatepec,Mujeres,67,66,1,236
30 Veracruz de Ignacio de la Llave,78,078 Ixcatepec,Mujeres,62,60,2,284
30 Veracruz de Ignacio de la Llave,78,078 Ixcatepec,Mujeres,88,88,0,310
30 Veracruz de Ignacio de la Llave,78,078 Ixcatepec,Mujeres,103,102,1,318
30 Veracruz de Ignacio de la Llave,78,078 Ixcatepec,Mujeres,71,70,1,291
30 Veracruz de Ignacio de la Llave,78,078 Ixcatepec,Mujeres,50,50,0,284
30 Veracruz de Ignacio de la Llave,78,078 Ixcatepec,Mujeres,29,29,0,262
30 Veracruz de Ignacio de la Llave,78,078 Ixcatepec,Mujeres,38,38,0,210
30 Veracruz de Ignacio de la Llave,78,078 Ixcatepec,Mujeres,26,26,0,192
30 Veracruz de Ignacio de la Llave,78,078 Ixcatepec,Mujeres,12,12,0,167
30 Veracruz de Ignacio de la Llave,78,078 Ixcatepec,Mujeres,10,10,0,118
30 Veracruz de Ignacio de la Llave,78,078 Ixcatepec,Mujeres,2,2,0,76
30 Veracruz de Ignacio de la Llave,78,078 Ixcatepec,Mujeres,0,0,0,49
30 Veracruz de Ignacio de la Llave,79,079 Ixhuacán de los Reyes,Total,3859,3708,151,4032
30 Veracruz de Ignacio de la Llave,79,079 Ixhuacán de los Reyes,Total,84,84,0,606
30 Veracruz de Ignacio de la Llave,79,079 Ixhuacán de los Reyes,Total,528,507,21,685
30 Veracruz de Ignacio de la Llave,79,079 Ixhuacán de los Reyes,Total,578,551,27,419
30 Veracruz de Ignacio de la Llave,79,079 Ixhuacán de los Reyes,Total,513,496,17,382
30 Veracruz de Ignacio de la Llave,79,079 Ixhuacán de los Reyes,Total,417,395,22,314
30 Veracruz de Ignacio de la Llave,79,079 Ixhuacán de los Reyes,Total,355,340,15,290
30 Veracruz de Ignacio de la Llave,79,079 Ixhuacán de los Reyes,Total,330,319,11,260
30 Veracruz de Ignacio de la Llave,79,079 Ixhuacán de los Reyes,Total,247,236,11,195
30 Veracruz de Ignacio de la Llave,79,079 Ixhuacán de los Reyes,Total,215,207,8,187
30 Veracruz de Ignacio de la Llave,79,079 Ixhuacán de los Reyes,Total,193,187,6,150
30 Veracruz de Ignacio de la Llave,79,079 Ixhuacán de los Reyes,Total,119,114,5,149
30 Veracruz de Ignacio de la Llave,79,079 Ixhuacán de los Reyes,Total,119,115,4,108
30 Veracruz de Ignacio de la Llave,79,079 Ixhuacán de los Reyes,Total,70,69,1,92
30 Veracruz de Ignacio de la Llave,79,079 Ixhuacán de los Reyes,Total,55,54,1,77
30 Veracruz de Ignacio de la Llave,79,079 Ixhuacán de los Reyes,Total,28,27,1,51
30 Veracruz de Ignacio de la Llave,79,079 Ixhuacán de los Reyes,Total,8,7,1,67
30 Veracruz de Ignacio de la Llave,79,079 Ixhuacán de los Reyes,Hombres,3289,3150,139,655
30 Veracruz de Ignacio de la Llave,79,079 Ixhuacán de los Reyes,Hombres,69,69,0,268
30 Veracruz de Ignacio de la Llave,79,079 Ixhuacán de los Reyes,Hombres,417,397,20,201
30 Veracruz de Ignacio de la Llave,79,079 Ixhuacán de los Reyes,Hombres,460,437,23,18
30 Veracruz de Ignacio de la Llave,79,079 Ixhuacán de los Reyes,Hombres,441,426,15,9
30 Veracruz de Ignacio de la Llave,79,079 Ixhuacán de los Reyes,Hombres,363,342,21,7
30 Veracruz de Ignacio de la Llave,79,079 Ixhuacán de los Reyes,Hombres,301,286,15,8
30 Veracruz de Ignacio de la Llave,79,079 Ixhuacán de los Reyes,Hombres,281,272,9,11
30 Veracruz de Ignacio de la Llave,79,079 Ixhuacán de los Reyes,Hombres,217,207,10,8
30 Veracruz de Ignacio de la Llave,79,079 Ixhuacán de los Reyes,Hombres,200,192,8,13
30 Veracruz de Ignacio de la Llave,79,079 Ixhuacán de los Reyes,Hombres,172,166,6,12
30 Veracruz de Ignacio de la Llave,79,079 Ixhuacán de los Reyes,Hombres,109,105,4,17
30 Veracruz de Ignacio de la Llave,79,079 Ixhuacán de los Reyes,Hombres,110,106,4,13
30 Veracruz de Ignacio de la Llave,79,079 Ixhuacán de los Reyes,Hombres,66,65,1,15
30 Veracruz de Ignacio de la Llave,79,079 Ixhuacán de los Reyes,Hombres,49,48,1,21
30 Veracruz de Ignacio de la Llave,79,079 Ixhuacán de los Reyes,Hombres,26,25,1,12
30 Veracruz de Ignacio de la Llave,79,079 Ixhuacán de los Reyes,Hombres,8,7,1,22
30 Veracruz de Ignacio de la Llave,79,079 Ixhuacán de los Reyes,Mujeres,570,558,12,3377
30 Veracruz de Ignacio de la Llave,79,079 Ixhuacán de los Reyes,Mujeres,15,15,0,338
30 Veracruz de Ignacio de la Llave,79,079 Ixhuacán de los Reyes,Mujeres,111,110,1,484
30 Veracruz de Ignacio de la Llave,79,079 Ixhuacán de los Reyes,Mujeres,118,114,4,401
30 Veracruz de Ignacio de la Llave,79,079 Ixhuacán de los Reyes,Mujeres,72,70,2,373
30 Veracruz de Ignacio de la Llave,79,079 Ixhuacán de los Reyes,Mujeres,54,53,1,307
30 Veracruz de Ignacio de la Llave,79,079 Ixhuacán de los Reyes,Mujeres,54,54,0,282
30 Veracruz de Ignacio de la Llave,79,079 Ixhuacán de los Reyes,Mujeres,49,47,2,249
30 Veracruz de Ignacio de la Llave,79,079 Ixhuacán de los Reyes,Mujeres,30,29,1,187
30 Veracruz de Ignacio de la Llave,79,079 Ixhuacán de los Reyes,Mujeres,15,15,0,174
30 Veracruz de Ignacio de la Llave,79,079 Ixhuacán de los Reyes,Mujeres,21,21,0,138
30 Veracruz de Ignacio de la Llave,79,079 Ixhuacán de los Reyes,Mujeres,10,9,1,132
30 Veracruz de Ignacio de la Llave,79,079 Ixhuacán de los Reyes,Mujeres,9,9,0,95
30 Veracruz de Ignacio de la Llave,79,079 Ixhuacán de los Reyes,Mujeres,4,4,0,77
30 Veracruz de Ignacio de la Llave,79,079 Ixhuacán de los Reyes,Mujeres,6,6,0,56
30 Veracruz de Ignacio de la Llave,79,079 Ixhuacán de los Reyes,Mujeres,2,2,0,39
30 Veracruz de Ignacio de la Llave,79,079 Ixhuacán de los Reyes,Mujeres,0,0,0,45
30 Veracruz de Ignacio de la Llave,83,083 Ixhuatlán de Madero,Total,16198,16103,95,21439
30 Veracruz de Ignacio de la Llave,83,083 Ixhuatlán de Madero,Total,236,232,4,3480
30 Veracruz de Ignacio de la Llave,83,083 Ixhuatlán de Madero,Total,1324,1302,22,4479
30 Veracruz de Ignacio de la Llave,83,083 Ixhuatlán de Madero,Total,1600,1587,13,1520
30 Veracruz de Ignacio de la Llave,83,083 Ixhuatlán de Madero,Total,1528,1517,11,1264
30 Veracruz de Ignacio de la Llave,83,083 Ixhuatlán de Madero,Total,1556,1547,9,1217
30 Veracruz de Ignacio de la Llave,83,083 Ixhuatlán de Madero,Total,1694,1687,7,1320
30 Veracruz de Ignacio de la Llave,83,083 Ixhuatlán de Madero,Total,1528,1522,6,1175
30 Veracruz de Ignacio de la Llave,83,083 Ixhuatlán de Madero,Total,1417,1410,7,1133
30 Veracruz de Ignacio de la Llave,83,083 Ixhuatlán de Madero,Total,1210,1205,5,1094
30 Veracruz de Ignacio de la Llave,83,083 Ixhuatlán de Madero,Total,1136,1131,5,1158
30 Veracruz de Ignacio de la Llave,83,083 Ixhuatlán de Madero,Total,957,955,2,974
30 Veracruz de Ignacio de la Llave,83,083 Ixhuatlán de Madero,Total,797,795,2,827
30 Veracruz de Ignacio de la Llave,83,083 Ixhuatlán de Madero,Total,612,610,2,740
30 Veracruz de Ignacio de la Llave,83,083 Ixhuatlán de Madero,Total,290,290,0,423
30 Veracruz de Ignacio de la Llave,83,083 Ixhuatlán de Madero,Total,172,172,0,302
30 Veracruz de Ignacio de la Llave,83,083 Ixhuatlán de Madero,Total,141,141,0,333
30 Veracruz de Ignacio de la Llave,83,083 Ixhuatlán de Madero,Hombres,13605,13536,69,4679
30 Veracruz de Ignacio de la Llave,83,083 Ixhuatlán de Madero,Hombres,177,175,2,1771
30 Veracruz de Ignacio de la Llave,83,083 Ixhuatlán de Madero,Hombres,1106,1091,15,1903
30 Veracruz de Ignacio de la Llave,83,083 Ixhuatlán de Madero,Hombres,1312,1303,9,241
30 Veracruz de Ignacio de la Llave,83,083 Ixhuatlán de Madero,Hombres,1212,1206,6,55
30 Veracruz de Ignacio de la Llave,83,083 Ixhuatlán de Madero,Hombres,1284,1276,8,27
30 Veracruz de Ignacio de la Llave,83,083 Ixhuatlán de Madero,Hombres,1402,1396,6,39
30 Veracruz de Ignacio de la Llave,83,083 Ixhuatlán de Madero,Hombres,1246,1240,6,28
30 Veracruz de Ignacio de la Llave,83,083 Ixhuatlán de Madero,Hombres,1191,1187,4,35
30 Veracruz de Ignacio de la Llave,83,083 Ixhuatlán de Madero,Hombres,1026,1024,2,40
30 Veracruz de Ignacio de la Llave,83,083 Ixhuatlán de Madero,Hombres,995,990,5,51
30 Veracruz de Ignacio de la Llave,83,083 Ixhuatlán de Madero,Hombres,856,854,2,71
30 Veracruz de Ignacio de la Llave,83,083 Ixhuatlán de Madero,Hombres,719,717,2,78
30 Veracruz de Ignacio de la Llave,83,083 Ixhuatlán de Madero,Hombres,555,553,2,94
30 Veracruz de Ignacio de la Llave,83,083 Ixhuatlán de Madero,Hombres,249,249,0,65
30 Veracruz de Ignacio de la Llave,83,083 Ixhuatlán de Madero,Hombres,149,149,0,81
30 Veracruz de Ignacio de la Llave,83,083 Ixhuatlán de Madero,Hombres,126,126,0,100
30 Veracruz de Ignacio de la Llave,83,083 Ixhuatlán de Madero,Mujeres,2593,2567,26,16760
30 Veracruz de Ignacio de la Llave,83,083 Ixhuatlán de Madero,Mujeres,59,57,2,1709
30 Veracruz de Ignacio de la Llave,83,083 Ixhuatlán de Madero,Mujeres,218,211,7,2576
30 Veracruz de Ignacio de la Llave,83,083 Ixhuatlán de Madero,Mujeres,288,284,4,1279
30 Veracruz de Ignacio de la Llave,83,083 Ixhuatlán de Madero,Mujeres,316,311,5,1209
30 Veracruz de Ignacio de la Llave,83,083 Ixhuatlán de Madero,Mujeres,272,271,1,1190
30 Veracruz de Ignacio de la Llave,83,083 Ixhuatlán de Madero,Mujeres,292,291,1,1281
30 Veracruz de Ignacio de la Llave,83,083 Ixhuatlán de Madero,Mujeres,282,282,0,1147
30 Veracruz de Ignacio de la Llave,83,083 Ixhuatlán de Madero,Mujeres,226,223,3,1098
30 Veracruz de Ignacio de la Llave,83,083 Ixhuatlán de Madero,Mujeres,184,181,3,1054
30 Veracruz de Ignacio de la Llave,83,083 Ixhuatlán de Madero,Mujeres,141,141,0,1107
30 Veracruz de Ignacio de la Llave,83,083 Ixhuatlán de Madero,Mujeres,101,101,0,903
30 Veracruz de Ignacio de la Llave,83,083 Ixhuatlán de Madero,Mujeres,78,78,0,749
30 Veracruz de Ignacio de la Llave,83,083 Ixhuatlán de Madero,Mujeres,57,57,0,646
30 Veracruz de Ignacio de la Llave,83,083 Ixhuatlán de Madero,Mujeres,41,41,0,358
30 Veracruz de Ignacio de la Llave,83,083 Ixhuatlán de Madero,Mujeres,23,23,0,221
30 Veracruz de Ignacio de la Llave,83,083 Ixhuatlán de Madero,Mujeres,15,15,0,233
30 Veracruz de Ignacio de la Llave,80,080 Ixhuatlán del Café,Total,7391,7053,338,8216
30 Veracruz de Ignacio de la Llave,80,080 Ixhuatlán del Café,Total,123,114,9,1358
30 Veracruz de Ignacio de la Llave,80,080 Ixhuatlán del Café,Total,792,747,45,1482
30 Veracruz de Ignacio de la Llave,80,080 Ixhuatlán del Café,Total,1069,1017,52,891
30 Veracruz de Ignacio de la Llave,80,080 Ixhuatlán del Café,Total,843,798,45,690
30 Veracruz de Ignacio de la Llave,80,080 Ixhuatlán del Café,Total,902,866,36,642
30 Veracruz de Ignacio de la Llave,80,080 Ixhuatlán del Café,Total,772,748,24,552
30 Veracruz de Ignacio de la Llave,80,080 Ixhuatlán del Café,Total,624,591,33,459
30 Veracruz de Ignacio de la Llave,80,080 Ixhuatlán del Café,Total,521,493,28,416
30 Veracruz de Ignacio de la Llave,80,080 Ixhuatlán del Café,Total,489,469,20,376
30 Veracruz de Ignacio de la Llave,80,080 Ixhuatlán del Café,Total,372,361,11,304
30 Veracruz de Ignacio de la Llave,80,080 Ixhuatlán del Café,Total,298,280,18,235
30 Veracruz de Ignacio de la Llave,80,080 Ixhuatlán del Café,Total,230,223,7,217
30 Veracruz de Ignacio de la Llave,80,080 Ixhuatlán del Café,Total,159,158,1,206
30 Veracruz de Ignacio de la Llave,80,080 Ixhuatlán del Café,Total,99,94,5,176
30 Veracruz de Ignacio de la Llave,80,080 Ixhuatlán del Café,Total,57,54,3,104
30 Veracruz de Ignacio de la Llave,80,080 Ixhuatlán del Café,Total,41,40,1,108
30 Veracruz de Ignacio de la Llave,80,080 Ixhuatlán del Café,Hombres,6041,5739,302,1578
30 Veracruz de Ignacio de la Llave,80,080 Ixhuatlán del Café,Hombres,112,104,8,633
30 Veracruz de Ignacio de la Llave,80,080 Ixhuatlán del Café,Hombres,647,609,38,521
30 Veracruz de Ignacio de la Llave,80,080 Ixhuatlán del Café,Hombres,805,765,40,108
30 Veracruz de Ignacio de la Llave,80,080 Ixhuatlán del Café,Hombres,674,634,40,35
30 Veracruz de Ignacio de la Llave,80,080 Ixhuatlán del Café,Hombres,721,689,32,22
30 Veracruz de Ignacio de la Llave,80,080 Ixhuatlán del Café,Hombres,617,594,23,16
30 Veracruz de Ignacio de la Llave,80,080 Ixhuatlán del Café,Hombres,519,489,30,11
30 Veracruz de Ignacio de la Llave,80,080 Ixhuatlán del Café,Hombres,439,413,26,15
30 Veracruz de Ignacio de la Llave,80,080 Ixhuatlán del Café,Hombres,413,393,20,22
30 Veracruz de Ignacio de la Llave,80,080 Ixhuatlán del Café,Hombres,313,303,10,20
30 Veracruz de Ignacio de la Llave,80,080 Ixhuatlán del Café,Hombres,256,238,18,22
30 Veracruz de Ignacio de la Llave,80,080 Ixhuatlán del Café,Hombres,206,199,7,29
30 Veracruz de Ignacio de la Llave,80,080 Ixhuatlán del Café,Hombres,136,135,1,26
30 Veracruz de Ignacio de la Llave,80,080 Ixhuatlán del Café,Hombres,92,87,5,44
30 Veracruz de Ignacio de la Llave,80,080 Ixhuatlán del Café,Hombres,53,50,3,26
30 Veracruz de Ignacio de la Llave,80,080 Ixhuatlán del Café,Hombres,38,37,1,28
30 Veracruz de Ignacio de la Llave,80,080 Ixhuatlán del Café,Mujeres,1350,1314,36,6638
30 Veracruz de Ignacio de la Llave,80,080 Ixhuatlán del Café,Mujeres,11,10,1,725
30 Veracruz de Ignacio de la Llave,80,080 Ixhuatlán del Café,Mujeres,145,138,7,961
30 Veracruz de Ignacio de la Llave,80,080 Ixhuatlán del Café,Mujeres,264,252,12,783
30 Veracruz de Ignacio de la Llave,80,080 Ixhuatlán del Café,Mujeres,169,164,5,655
30 Veracruz de Ignacio de la Llave,80,080 Ixhuatlán del Café,Mujeres,181,177,4,620
30 Veracruz de Ignacio de la Llave,80,080 Ixhuatlán del Café,Mujeres,155,154,1,536
30 Veracruz de Ignacio de la Llave,80,080 Ixhuatlán del Café,Mujeres,105,102,3,448
30 Veracruz de Ignacio de la Llave,80,080 Ixhuatlán del Café,Mujeres,82,80,2,401
30 Veracruz de Ignacio de la Llave,80,080 Ixhuatlán del Café,Mujeres,76,76,0,354
30 Veracruz de Ignacio de la Llave,80,080 Ixhuatlán del Café,Mujeres,59,58,1,284
30 Veracruz de Ignacio de la Llave,80,080 Ixhuatlán del Café,Mujeres,42,42,0,213
30 Veracruz de Ignacio de la Llave,80,080 Ixhuatlán del Café,Mujeres,24,24,0,188
30 Veracruz de Ignacio de la Llave,80,080 Ixhuatlán del Café,Mujeres,23,23,0,180
30 Veracruz de Ignacio de la Llave,80,080 Ixhuatlán del Café,Mujeres,7,7,0,132
30 Veracruz de Ignacio de la Llave,80,080 Ixhuatlán del Café,Mujeres,4,4,0,78
30 Veracruz de Ignacio de la Llave,80,080 Ixhuatlán del Café,Mujeres,3,3,0,80
30 Veracruz de Ignacio de la Llave,82,082 Ixhuatlán del Sureste,Total,5276,5031,245,6149
30 Veracruz de Ignacio de la Llave,82,082 Ixhuatlán del Sureste,Total,22,19,3,843
30 Veracruz de Ignacio de la Llave,82,082 Ixhuatlán del Sureste,Total,333,284,49,1208
30 Veracruz de Ignacio de la Llave,82,082 Ixhuatlán del Sureste,Total,727,665,62,686
30 Veracruz de Ignacio de la Llave,82,082 Ixhuatlán del Sureste,Total,756,718,38,463
30 Veracruz de Ignacio de la Llave,82,082 Ixhuatlán del Sureste,Total,630,619,11,458
30 Veracruz de Ignacio de la Llave,82,082 Ixhuatlán del Sureste,Total,649,622,27,398
30 Veracruz de Ignacio de la Llave,82,082 Ixhuatlán del Sureste,Total,623,609,14,385
30 Veracruz de Ignacio de la Llave,82,082 Ixhuatlán del Sureste,Total,529,517,12,333
30 Veracruz de Ignacio de la Llave,82,082 Ixhuatlán del Sureste,Total,390,384,6,341
30 Veracruz de Ignacio de la Llave,82,082 Ixhuatlán del Sureste,Total,236,226,10,274
30 Veracruz de Ignacio de la Llave,82,082 Ixhuatlán del Sureste,Total,144,139,5,242
30 Veracruz de Ignacio de la Llave,82,082 Ixhuatlán del Sureste,Total,97,95,2,165
30 Veracruz de Ignacio de la Llave,82,082 Ixhuatlán del Sureste,Total,82,79,3,142
30 Veracruz de Ignacio de la Llave,82,082 Ixhuatlán del Sureste,Total,33,31,2,103
30 Veracruz de Ignacio de la Llave,82,082 Ixhuatlán del Sureste,Total,19,18,1,64
30 Veracruz de Ignacio de la Llave,82,082 Ixhuatlán del Sureste,Total,6,6,0,44
30 Veracruz de Ignacio de la Llave,82,082 Ixhuatlán del Sureste,Hombres,4036,3830,206,1568
30 Veracruz de Ignacio de la Llave,82,082 Ixhuatlán del Sureste,Hombres,19,16,3,422
30 Veracruz de Ignacio de la Llave,82,082 Ixhuatlán del Sureste,Hombres,248,206,42,515
30 Veracruz de Ignacio de la Llave,82,082 Ixhuatlán del Sureste,Hombres,552,503,49,146
30 Veracruz de Ignacio de la Llave,82,082 Ixhuatlán del Sureste,Hombres,542,513,29,33
30 Veracruz de Ignacio de la Llave,82,082 Ixhuatlán del Sureste,Hombres,461,451,10,15
30 Veracruz de Ignacio de la Llave,82,082 Ixhuatlán del Sureste,Hombres,501,476,25,13
30 Veracruz de Ignacio de la Llave,82,082 Ixhuatlán del Sureste,Hombres,466,455,11,12
30 Veracruz de Ignacio de la Llave,82,082 Ixhuatlán del Sureste,Hombres,416,404,12,25
30 Veracruz de Ignacio de la Llave,82,082 Ixhuatlán del Sureste,Hombres,307,301,6,46
30 Veracruz de Ignacio de la Llave,82,082 Ixhuatlán del Sureste,Hombres,199,190,9,81
30 Veracruz de Ignacio de la Llave,82,082 Ixhuatlán del Sureste,Hombres,121,116,5,72
30 Veracruz de Ignacio de la Llave,82,082 Ixhuatlán del Sureste,Hombres,82,81,1,54
30 Veracruz de Ignacio de la Llave,82,082 Ixhuatlán del Sureste,Hombres,71,69,2,45
30 Veracruz de Ignacio de la Llave,82,082 Ixhuatlán del Sureste,Hombres,28,27,1,41
30 Veracruz de Ignacio de la Llave,82,082 Ixhuatlán del Sureste,Hombres,19,18,1,24
30 Veracruz de Ignacio de la Llave,82,082 Ixhuatlán del Sureste,Hombres,4,4,0,24
30 Veracruz de Ignacio de la Llave,82,082 Ixhuatlán del Sureste,Mujeres,1240,1201,39,4581
30 Veracruz de Ignacio de la Llave,82,082 Ixhuatlán del Sureste,Mujeres,3,3,0,421
30 Veracruz de Ignacio de la Llave,82,082 Ixhuatlán del Sureste,Mujeres,85,78,7,693
30 Veracruz de Ignacio de la Llave,82,082 Ixhuatlán del Sureste,Mujeres,175,162,13,540
30 Veracruz de Ignacio de la Llave,82,082 Ixhuatlán del Sureste,Mujeres,214,205,9,430
30 Veracruz de Ignacio de la Llave,82,082 Ixhuatlán del Sureste,Mujeres,169,168,1,443
30 Veracruz de Ignacio de la Llave,82,082 Ixhuatlán del Sureste,Mujeres,148,146,2,385
30 Veracruz de Ignacio de la Llave,82,082 Ixhuatlán del Sureste,Mujeres,157,154,3,373
30 Veracruz de Ignacio de la Llave,82,082 Ixhuatlán del Sureste,Mujeres,113,113,0,308
30 Veracruz de Ignacio de la Llave,82,082 Ixhuatlán del Sureste,Mujeres,83,83,0,295
30 Veracruz de Ignacio de la Llave,82,082 Ixhuatlán del Sureste,Mujeres,37,36,1,193
30 Veracruz de Ignacio de la Llave,82,082 Ixhuatlán del Sureste,Mujeres,23,23,0,170
30 Veracruz de Ignacio de la Llave,82,082 Ixhuatlán del Sureste,Mujeres,15,14,1,111
30 Veracruz de Ignacio de la Llave,82,082 Ixhuatlán del Sureste,Mujeres,11,10,1,97
30 Veracruz de Ignacio de la Llave,82,082 Ixhuatlán del Sureste,Mujeres,5,4,1,62
30 Veracruz de Ignacio de la Llave,82,082 Ixhuatlán del Sureste,Mujeres,0,0,0,40
30 Veracruz de Ignacio de la Llave,82,082 Ixhuatlán del Sureste,Mujeres,2,2,0,20
30 Veracruz de Ignacio de la Llave,81,081 Ixhuatlancillo,Total,8517,8046,471,6737
30 Veracruz de Ignacio de la Llave,81,081 Ixhuatlancillo,Total,113,108,5,1087
30 Veracruz de Ignacio de la Llave,81,081 Ixhuatlancillo,Total,649,600,49,1435
30 Veracruz de Ignacio de la Llave,81,081 Ixhuatlancillo,Total,1020,946,74,765
30 Veracruz de Ignacio de la Llave,81,081 Ixhuatlancillo,Total,1108,1027,81,542
30 Veracruz de Ignacio de la Llave,81,081 Ixhuatlancillo,Total,1191,1137,54,528
30 Veracruz de Ignacio de la Llave,81,081 Ixhuatlancillo,Total,1151,1103,48,430
30 Veracruz de Ignacio de la Llave,81,081 Ixhuatlancillo,Total,947,903,44,389
30 Veracruz de Ignacio de la Llave,81,081 Ixhuatlancillo,Total,786,745,41,273
30 Veracruz de Ignacio de la Llave,81,081 Ixhuatlancillo,Total,553,523,30,242
30 Veracruz de Ignacio de la Llave,81,081 Ixhuatlancillo,Total,382,364,18,239
30 Veracruz de Ignacio de la Llave,81,081 Ixhuatlancillo,Total,232,225,7,212
30 Veracruz de Ignacio de la Llave,81,081 Ixhuatlancillo,Total,152,144,8,172
30 Veracruz de Ignacio de la Llave,81,081 Ixhuatlancillo,Total,124,119,5,173
30 Veracruz de Ignacio de la Llave,81,081 Ixhuatlancillo,Total,57,53,4,102
30 Veracruz de Ignacio de la Llave,81,081 Ixhuatlancillo,Total,26,25,1,71
30 Veracruz de Ignacio de la Llave,81,081 Ixhuatlancillo,Total,26,24,2,77
30 Veracruz de Ignacio de la Llave,81,081 Ixhuatlancillo,Hombres,5523,5148,375,1614
30 Veracruz de Ignacio de la Llave,81,081 Ixhuatlancillo,Hombres,83,79,4,509
30 Veracruz de Ignacio de la Llave,81,081 Ixhuatlancillo,Hombres,479,437,42,543
30 Veracruz de Ignacio de la Llave,81,081 Ixhuatlancillo,Hombres,681,627,54,166
30 Veracruz de Ignacio de la Llave,81,081 Ixhuatlancillo,Hombres,704,646,58,25
30 Veracruz de Ignacio de la Llave,81,081 Ixhuatlancillo,Hombres,734,698,36,26
30 Veracruz de Ignacio de la Llave,81,081 Ixhuatlancillo,Hombres,720,682,38,17
30 Veracruz de Ignacio de la Llave,81,081 Ixhuatlancillo,Hombres,598,559,39,15
30 Veracruz de Ignacio de la Llave,81,081 Ixhuatlancillo,Hombres,474,437,37,17
30 Veracruz de Ignacio de la Llave,81,081 Ixhuatlancillo,Hombres,357,330,27,26
30 Veracruz de Ignacio de la Llave,81,081 Ixhuatlancillo,Hombres,263,246,17,30
30 Veracruz de Ignacio de la Llave,81,081 Ixhuatlancillo,Hombres,165,159,6,50
30 Veracruz de Ignacio de la Llave,81,081 Ixhuatlancillo,Hombres,106,99,7,56
30 Veracruz de Ignacio de la Llave,81,081 Ixhuatlancillo,Hombres,84,80,4,52
30 Veracruz de Ignacio de la Llave,81,081 Ixhuatlancillo,Hombres,42,39,3,32
30 Veracruz de Ignacio de la Llave,81,081 Ixhuatlancillo,Hombres,18,17,1,24
30 Veracruz de Ignacio de la Llave,81,081 Ixhuatlancillo,Hombres,15,13,2,26
30 Veracruz de Ignacio de la Llave,81,081 Ixhuatlancillo,Mujeres,2994,2898,96,5123
30 Veracruz de Ignacio de la Llave,81,081 Ixhuatlancillo,Mujeres,30,29,1,578
30 Veracruz de Ignacio de la Llave,81,081 Ixhuatlancillo,Mujeres,170,163,7,892
30 Veracruz de Ignacio de la Llave,81,081 Ixhuatlancillo,Mujeres,339,319,20,599
30 Veracruz de Ignacio de la Llave,81,081 Ixhuatlancillo,Mujeres,404,381,23,517
30 Veracruz de Ignacio de la Llave,81,081 Ixhuatlancillo,Mujeres,457,439,18,502
30 Veracruz de Ignacio de la Llave,81,081 Ixhuatlancillo,Mujeres,431,421,10,413
30 Veracruz de Ignacio de la Llave,81,081 Ixhuatlancillo,Mujeres,349,344,5,374
30 Veracruz de Ignacio de la Llave,81,081 Ixhuatlancillo,Mujeres,312,308,4,256
30 Veracruz de Ignacio de la Llave,81,081 Ixhuatlancillo,Mujeres,196,193,3,216
30 Veracruz de Ignacio de la Llave,81,081 Ixhuatlancillo,Mujeres,119,118,1,209
30 Veracruz de Ignacio de la Llave,81,081 Ixhuatlancillo,Mujeres,67,66,1,162
30 Veracruz de Ignacio de la Llave,81,081 Ixhuatlancillo,Mujeres,46,45,1,116
30 Veracruz de Ignacio de la Llave,81,081 Ixhuatlancillo,Mujeres,40,39,1,121
30 Veracruz de Ignacio de la Llave,81,081 Ixhuatlancillo,Mujeres,15,14,1,70
30 Veracruz de Ignacio de la Llave,81,081 Ixhuatlancillo,Mujeres,8,8,0,47
30 Veracruz de Ignacio de la Llave,81,081 Ixhuatlancillo,Mujeres,11,11,0,51
30 Veracruz de Ignacio de la Llave,84,084 Ixmatlahuacan,Total,2114,2050,64,2437
30 Veracruz de Ignacio de la Llave,84,084 Ixmatlahuacan,Total,24,18,6,295
30 Veracruz de Ignacio de la Llave,84,084 Ixmatlahuacan,Total,139,126,13,352
30 Veracruz de Ignacio de la Llave,84,084 Ixmatlahuacan,Total,215,207,8,189
30 Veracruz de Ignacio de la Llave,84,084 Ixmatlahuacan,Total,206,201,5,144
30 Veracruz de Ignacio de la Llave,84,084 Ixmatlahuacan,Total,241,236,5,177
30 Veracruz de Ignacio de la Llave,84,084 Ixmatlahuacan,Total,247,243,4,218
30 Veracruz de Ignacio de la Llave,84,084 Ixmatlahuacan,Total,247,243,4,171
30 Veracruz de Ignacio de la Llave,84,084 Ixmatlahuacan,Total,209,200,9,165
30 Veracruz de Ignacio de la Llave,84,084 Ixmatlahuacan,Total,196,195,1,131
30 Veracruz de Ignacio de la Llave,84,084 Ixmatlahuacan,Total,134,129,5,99
30 Veracruz de Ignacio de la Llave,84,084 Ixmatlahuacan,Total,84,82,2,102
30 Veracruz de Ignacio de la Llave,84,084 Ixmatlahuacan,Total,69,68,1,98
30 Veracruz de Ignacio de la Llave,84,084 Ixmatlahuacan,Total,49,49,0,118
30 Veracruz de Ignacio de la Llave,84,084 Ixmatlahuacan,Total,35,34,1,80
30 Veracruz de Ignacio de la Llave,84,084 Ixmatlahuacan,Total,16,16,0,55
30 Veracruz de Ignacio de la Llave,84,084 Ixmatlahuacan,Total,3,3,0,43
30 Veracruz de Ignacio de la Llave,84,084 Ixmatlahuacan,Hombres,1745,1691,54,503
30 Veracruz de Ignacio de la Llave,84,084 Ixmatlahuacan,Hombres,20,15,5,138
30 Veracruz de Ignacio de la Llave,84,084 Ixmatlahuacan,Hombres,125,114,11,131
30 Veracruz de Ignacio de la Llave,84,084 Ixmatlahuacan,Hombres,177,171,6,37
30 Veracruz de Ignacio de la Llave,84,084 Ixmatlahuacan,Hombres,159,155,4,6
30 Veracruz de Ignacio de la Llave,84,084 Ixmatlahuacan,Hombres,188,183,5,3
30 Veracruz de Ignacio de la Llave,84,084 Ixmatlahuacan,Hombres,192,190,2,8
30 Veracruz de Ignacio de la Llave,84,084 Ixmatlahuacan,Hombres,185,181,4,12
30 Veracruz de Ignacio de la Llave,84,084 Ixmatlahuacan,Hombres,174,166,8,7
30 Veracruz de Ignacio de la Llave,84,084 Ixmatlahuacan,Hombres,162,161,1,8
30 Veracruz de Ignacio de la Llave,84,084 Ixmatlahuacan,Hombres,123,119,4,6
30 Veracruz de Ignacio de la Llave,84,084 Ixmatlahuacan,Hombres,76,74,2,13
30 Veracruz de Ignacio de la Llave,84,084 Ixmatlahuacan,Hombres,64,63,1,16
30 Veracruz de Ignacio de la Llave,84,084 Ixmatlahuacan,Hombres,46,46,0,39
30 Veracruz de Ignacio de la Llave,84,084 Ixmatlahuacan,Hombres,35,34,1,22
30 Veracruz de Ignacio de la Llave,84,084 Ixmatlahuacan,Hombres,16,16,0,32
30 Veracruz de Ignacio de la Llave,84,084 Ixmatlahuacan,Hombres,3,3,0,25
30 Veracruz de Ignacio de la Llave,84,084 Ixmatlahuacan,Mujeres,369,359,10,1934
30 Veracruz de Ignacio de la Llave,84,084 Ixmatlahuacan,Mujeres,4,3,1,157
30 Veracruz de Ignacio de la Llave,84,084 Ixmatlahuacan,Mujeres,14,12,2,221
30 Veracruz de Ignacio de la Llave,84,084 Ixmatlahuacan,Mujeres,38,36,2,152
30 Veracruz de Ignacio de la Llave,84,084 Ixmatlahuacan,Mujeres,47,46,1,138
30 Veracruz de Ignacio de la Llave,84,084 Ixmatlahuacan,Mujeres,53,53,0,174
30 Veracruz de Ignacio de la Llave,84,084 Ixmatlahuacan,Mujeres,55,53,2,210
30 Veracruz de Ignacio de la Llave,84,084 Ixmatlahuacan,Mujeres,62,62,0,159
30 Veracruz de Ignacio de la Llave,84,084 Ixmatlahuacan,Mujeres,35,34,1,158
30 Veracruz de Ignacio de la Llave,84,084 Ixmatlahuacan,Mujeres,34,34,0,123
30 Veracruz de Ignacio de la Llave,84,084 Ixmatlahuacan,Mujeres,11,10,1,93
30 Veracruz de Ignacio de la Llave,84,084 Ixmatlahuacan,Mujeres,8,8,0,89
30 Veracruz de Ignacio de la Llave,84,084 Ixmatlahuacan,Mujeres,5,5,0,82
30 Veracruz de Ignacio de la Llave,84,084 Ixmatlahuacan,Mujeres,3,3,0,79
30 Veracruz de Ignacio de la Llave,84,084 Ixmatlahuacan,Mujeres,0,0,0,58
30 Veracruz de Ignacio de la Llave,84,084 Ixmatlahuacan,Mujeres,0,0,0,23
30 Veracruz de Ignacio de la Llave,84,084 Ixmatlahuacan,Mujeres,0,0,0,18
30 Veracruz de Ignacio de la Llave,85,085 Ixtaczoquitlán,Total,24879,23397,1482,25287
30 Veracruz de Ignacio de la Llave,85,085 Ixtaczoquitlán,Total,101,91,10,3388
30 Veracruz de Ignacio de la Llave,85,085 Ixtaczoquitlán,Total,1521,1312,209,4773
30 Veracruz de Ignacio de la Llave,85,085 Ixtaczoquitlán,Total,3457,3109,348,2710
30 Veracruz de Ignacio de la Llave,85,085 Ixtaczoquitlán,Total,3556,3293,263,1839
30 Veracruz de Ignacio de la Llave,85,085 Ixtaczoquitlán,Total,3435,3284,151,1825
30 Veracruz de Ignacio de la Llave,85,085 Ixtaczoquitlán,Total,3114,2996,118,1679
30 Veracruz de Ignacio de la Llave,85,085 Ixtaczoquitlán,Total,2669,2585,84,1412
30 Veracruz de Ignacio de la Llave,85,085 Ixtaczoquitlán,Total,2218,2138,80,1278
30 Veracruz de Ignacio de la Llave,85,085 Ixtaczoquitlán,Total,1849,1756,93,1240
30 Veracruz de Ignacio de la Llave,85,085 Ixtaczoquitlán,Total,1333,1256,77,1145
30 Veracruz de Ignacio de la Llave,85,085 Ixtaczoquitlán,Total,729,697,32,1073
30 Veracruz de Ignacio de la Llave,85,085 Ixtaczoquitlán,Total,390,382,8,834
30 Veracruz de Ignacio de la Llave,85,085 Ixtaczoquitlán,Total,260,256,4,763
30 Veracruz de Ignacio de la Llave,85,085 Ixtaczoquitlán,Total,135,130,5,598
30 Veracruz de Ignacio de la Llave,85,085 Ixtaczoquitlán,Total,66,66,0,402
30 Veracruz de Ignacio de la Llave,85,085 Ixtaczoquitlán,Total,46,46,0,328
30 Veracruz de Ignacio de la Llave,85,085 Ixtaczoquitlán,Hombres,17435,16293,1142,6424
30 Veracruz de Ignacio de la Llave,85,085 Ixtaczoquitlán,Hombres,83,74,9,1673
30 Veracruz de Ignacio de la Llave,85,085 Ixtaczoquitlán,Hombres,1118,965,153,2093
30 Veracruz de Ignacio de la Llave,85,085 Ixtaczoquitlán,Hombres,2373,2146,227,592
30 Veracruz de Ignacio de la Llave,85,085 Ixtaczoquitlán,Hombres,2373,2183,190,106
30 Veracruz de Ignacio de la Llave,85,085 Ixtaczoquitlán,Hombres,2379,2257,122,54
30 Veracruz de Ignacio de la Llave,85,085 Ixtaczoquitlán,Hombres,2133,2041,92,55
30 Veracruz de Ignacio de la Llave,85,085 Ixtaczoquitlán,Hombres,1826,1750,76,74
30 Veracruz de Ignacio de la Llave,85,085 Ixtaczoquitlán,Hombres,1557,1488,69,73
30 Veracruz de Ignacio de la Llave,85,085 Ixtaczoquitlán,Hombres,1320,1237,83,113
30 Veracruz de Ignacio de la Llave,85,085 Ixtaczoquitlán,Hombres,1001,927,74,182
30 Veracruz de Ignacio de la Llave,85,085 Ixtaczoquitlán,Hombres,549,518,31,353
30 Veracruz de Ignacio de la Llave,85,085 Ixtaczoquitlán,Hombres,302,295,7,275
30 Veracruz de Ignacio de la Llave,85,085 Ixtaczoquitlán,Hombres,208,204,4,267
30 Veracruz de Ignacio de la Llave,85,085 Ixtaczoquitlán,Hombres,117,112,5,219
30 Veracruz de Ignacio de la Llave,85,085 Ixtaczoquitlán,Hombres,58,58,0,158
30 Veracruz de Ignacio de la Llave,85,085 Ixtaczoquitlán,Hombres,38,38,0,137
30 Veracruz de Ignacio de la Llave,85,085 Ixtaczoquitlán,Mujeres,7444,7104,340,18863
30 Veracruz de Ignacio de la Llave,85,085 Ixtaczoquitlán,Mujeres,18,17,1,1715
30 Veracruz de Ignacio de la Llave,85,085 Ixtaczoquitlán,Mujeres,403,347,56,2680
30 Veracruz de Ignacio de la Llave,85,085 Ixtaczoquitlán,Mujeres,1084,963,121,2118
30 Veracruz de Ignacio de la Llave,85,085 Ixtaczoquitlán,Mujeres,1183,1110,73,1733
30 Veracruz de Ignacio de la Llave,85,085 Ixtaczoquitlán,Mujeres,1056,1027,29,1771
30 Veracruz de Ignacio de la Llave,85,085 Ixtaczoquitlán,Mujeres,981,955,26,1624
30 Veracruz de Ignacio de la Llave,85,085 Ixtaczoquitlán,Mujeres,843,835,8,1338
30 Veracruz de Ignacio de la Llave,85,085 Ixtaczoquitlán,Mujeres,661,650,11,1205
30 Veracruz de Ignacio de la Llave,85,085 Ixtaczoquitlán,Mujeres,529,519,10,1127
30 Veracruz de Ignacio de la Llave,85,085 Ixtaczoquitlán,Mujeres,332,329,3,963
30 Veracruz de Ignacio de la Llave,85,085 Ixtaczoquitlán,Mujeres,180,179,1,720
30 Veracruz de Ignacio de la Llave,85,085 Ixtaczoquitlán,Mujeres,88,87,1,559
30 Veracruz de Ignacio de la Llave,85,085 Ixtaczoquitlán,Mujeres,52,52,0,496
30 Veracruz de Ignacio de la Llave,85,085 Ixtaczoquitlán,Mujeres,18,18,0,379
30 Veracruz de Ignacio de la Llave,85,085 Ixtaczoquitlán,Mujeres,8,8,0,244
30 Veracruz de Ignacio de la Llave,85,085 Ixtaczoquitlán,Mujeres,8,8,0,191
30 Veracruz de Ignacio de la Llave,86,086 Jalacingo,Total,14208,13943,265,13964
30 Veracruz de Ignacio de la Llave,86,086 Jalacingo,Total,356,347,9,2489
30 Veracruz de Ignacio de la Llave,86,086 Jalacingo,Total,2090,2053,37,2495
30 Veracruz de Ignacio de la Llave,86,086 Jalacingo,Total,2236,2194,42,1388
30 Veracruz de Ignacio de la Llave,86,086 Jalacingo,Total,1896,1861,35,1271
30 Veracruz de Ignacio de la Llave,86,086 Jalacingo,Total,1654,1619,35,1180
30 Veracruz de Ignacio de la Llave,86,086 Jalacingo,Total,1423,1390,33,977
30 Veracruz de Ignacio de la Llave,86,086 Jalacingo,Total,1168,1149,19,737
30 Veracruz de Ignacio de la Llave,86,086 Jalacingo,Total,904,888,16,639
30 Veracruz de Ignacio de la Llave,86,086 Jalacingo,Total,741,726,15,580
30 Veracruz de Ignacio de la Llave,86,086 Jalacingo,Total,537,523,14,475
30 Veracruz de Ignacio de la Llave,86,086 Jalacingo,Total,416,412,4,424
30 Veracruz de Ignacio de la Llave,86,086 Jalacingo,Total,309,305,4,352
30 Veracruz de Ignacio de la Llave,86,086 Jalacingo,Total,237,236,1,329
30 Veracruz de Ignacio de la Llave,86,086 Jalacingo,Total,123,123,0,270
30 Veracruz de Ignacio de la Llave,86,086 Jalacingo,Total,69,68,1,150
30 Veracruz de Ignacio de la Llave,86,086 Jalacingo,Total,49,49,0,208
30 Veracruz de Ignacio de la Llave,86,086 Jalacingo,Hombres,11048,10809,239,2527
30 Veracruz de Ignacio de la Llave,86,086 Jalacingo,Hombres,296,288,8,1119
30 Veracruz de Ignacio de la Llave,86,086 Jalacingo,Hombres,1527,1496,31,748
30 Veracruz de Ignacio de la Llave,86,086 Jalacingo,Hombres,1669,1634,35,103
30 Veracruz de Ignacio de la Llave,86,086 Jalacingo,Hombres,1483,1455,28,37
30 Veracruz de Ignacio de la Llave,86,086 Jalacingo,Hombres,1293,1259,34,29
30 Veracruz de Ignacio de la Llave,86,086 Jalacingo,Hombres,1090,1061,29,28
30 Veracruz de Ignacio de la Llave,86,086 Jalacingo,Hombres,906,887,19,20
30 Veracruz de Ignacio de la Llave,86,086 Jalacingo,Hombres,726,710,16,38
30 Veracruz de Ignacio de la Llave,86,086 Jalacingo,Hombres,590,575,15,29
30 Veracruz de Ignacio de la Llave,86,086 Jalacingo,Hombres,432,418,14,36
30 Veracruz de Ignacio de la Llave,86,086 Jalacingo,Hombres,361,357,4,49
30 Veracruz de Ignacio de la Llave,86,086 Jalacingo,Hombres,267,263,4,48
30 Veracruz de Ignacio de la Llave,86,086 Jalacingo,Hombres,199,198,1,63
30 Veracruz de Ignacio de la Llave,86,086 Jalacingo,Hombres,104,104,0,70
30 Veracruz de Ignacio de la Llave,86,086 Jalacingo,Hombres,62,61,1,37
30 Veracruz de Ignacio de la Llave,86,086 Jalacingo,Hombres,43,43,0,73
30 Veracruz de Ignacio de la Llave,86,086 Jalacingo,Mujeres,3160,3134,26,11437
30 Veracruz de Ignacio de la Llave,86,086 Jalacingo,Mujeres,60,59,1,1370
30 Veracruz de Ignacio de la Llave,86,086 Jalacingo,Mujeres,563,557,6,1747
30 Veracruz de Ignacio de la Llave,86,086 Jalacingo,Mujeres,567,560,7,1285
30 Veracruz de Ignacio de la Llave,86,086 Jalacingo,Mujeres,413,406,7,1234
30 Veracruz de Ignacio de la Llave,86,086 Jalacingo,Mujeres,361,360,1,1151
30 Veracruz de Ignacio de la Llave,86,086 Jalacingo,Mujeres,333,329,4,949
30 Veracruz de Ignacio de la Llave,86,086 Jalacingo,Mujeres,262,262,0,717
30 Veracruz de Ignacio de la Llave,86,086 Jalacingo,Mujeres,178,178,0,601
30 Veracruz de Ignacio de la Llave,86,086 Jalacingo,Mujeres,151,151,0,551
30 Veracruz de Ignacio de la Llave,86,086 Jalacingo,Mujeres,105,105,0,439
30 Veracruz de Ignacio de la Llave,86,086 Jalacingo,Mujeres,55,55,0,375
30 Veracruz de Ignacio de la Llave,86,086 Jalacingo,Mujeres,42,42,0,304
30 Veracruz de Ignacio de la Llave,86,086 Jalacingo,Mujeres,38,38,0,266
30 Veracruz de Ignacio de la Llave,86,086 Jalacingo,Mujeres,19,19,0,200
30 Veracruz de Ignacio de la Llave,86,086 Jalacingo,Mujeres,7,7,0,113
30 Veracruz de Ignacio de la Llave,86,086 Jalacingo,Mujeres,6,6,0,135
30 Veracruz de Ignacio de la Llave,88,088 Jalcomulco,Total,2061,2030,31,1896
30 Veracruz de Ignacio de la Llave,88,088 Jalcomulco,Total,7,7,0,217
30 Veracruz de Ignacio de la Llave,88,088 Jalcomulco,Total,149,144,5,299
30 Veracruz de Ignacio de la Llave,88,088 Jalcomulco,Total,212,203,9,143
30 Veracruz de Ignacio de la Llave,88,088 Jalcomulco,Total,244,242,2,130
30 Veracruz de Ignacio de la Llave,88,088 Jalcomulco,Total,238,237,1,153
30 Veracruz de Ignacio de la Llave,88,088 Jalcomulco,Total,211,207,4,126
30 Veracruz de Ignacio de la Llave,88,088 Jalcomulco,Total,210,205,5,131
30 Veracruz de Ignacio de la Llave,88,088 Jalcomulco,Total,196,195,1,118
30 Veracruz de Ignacio de la Llave,88,088 Jalcomulco,Total,162,161,1,97
30 Veracruz de Ignacio de la Llave,88,088 Jalcomulco,Total,151,149,2,82
30 Veracruz de Ignacio de la Llave,88,088 Jalcomulco,Total,96,95,1,74
30 Veracruz de Ignacio de la Llave,88,088 Jalcomulco,Total,76,76,0,78
30 Veracruz de Ignacio de la Llave,88,088 Jalcomulco,Total,63,63,0,96
30 Veracruz de Ignacio de la Llave,88,088 Jalcomulco,Total,26,26,0,76
30 Veracruz de Ignacio de la Llave,88,088 Jalcomulco,Total,16,16,0,37
30 Veracruz de Ignacio de la Llave,88,088 Jalcomulco,Total,4,4,0,39
30 Veracruz de Ignacio de la Llave,88,088 Jalcomulco,Hombres,1544,1517,27,433
30 Veracruz de Ignacio de la Llave,88,088 Jalcomulco,Hombres,3,3,0,103
30 Veracruz de Ignacio de la Llave,88,088 Jalcomulco,Hombres,104,100,4,114
30 Veracruz de Ignacio de la Llave,88,088 Jalcomulco,Hombres,158,150,8,27
30 Veracruz de Ignacio de la Llave,88,088 Jalcomulco,Hombres,164,162,2,19
30 Veracruz de Ignacio de la Llave,88,088 Jalcomulco,Hombres,169,168,1,18
30 Veracruz de Ignacio de la Llave,88,088 Jalcomulco,Hombres,148,146,2,14
30 Veracruz de Ignacio de la Llave,88,088 Jalcomulco,Hombres,168,163,5,9
30 Veracruz de Ignacio de la Llave,88,088 Jalcomulco,Hombres,145,144,1,14
30 Veracruz de Ignacio de la Llave,88,088 Jalcomulco,Hombres,129,128,1,9
30 Veracruz de Ignacio de la Llave,88,088 Jalcomulco,Hombres,120,118,2,10
30 Veracruz de Ignacio de la Llave,88,088 Jalcomulco,Hombres,79,78,1,11
30 Veracruz de Ignacio de la Llave,88,088 Jalcomulco,Hombres,63,63,0,18
30 Veracruz de Ignacio de la Llave,88,088 Jalcomulco,Hombres,56,56,0,23
30 Veracruz de Ignacio de la Llave,88,088 Jalcomulco,Hombres,23,23,0,17
30 Veracruz de Ignacio de la Llave,88,088 Jalcomulco,Hombres,12,12,0,10
30 Veracruz de Ignacio de la Llave,88,088 Jalcomulco,Hombres,3,3,0,17
30 Veracruz de Ignacio de la Llave,88,088 Jalcomulco,Mujeres,517,513,4,1463
30 Veracruz de Ignacio de la Llave,88,088 Jalcomulco,Mujeres,4,4,0,114
30 Veracruz de Ignacio de la Llave,88,088 Jalcomulco,Mujeres,45,44,1,185
30 Veracruz de Ignacio de la Llave,88,088 Jalcomulco,Mujeres,54,53,1,116
30 Veracruz de Ignacio de la Llave,88,088 Jalcomulco,Mujeres,80,80,0,111
30 Veracruz de Ignacio de la Llave,88,088 Jalcomulco,Mujeres,69,69,0,135
30 Veracruz de Ignacio de la Llave,88,088 Jalcomulco,Mujeres,63,61,2,112
30 Veracruz de Ignacio de la Llave,88,088 Jalcomulco,Mujeres,42,42,0,122
30 Veracruz de Ignacio de la Llave,88,088 Jalcomulco,Mujeres,51,51,0,104
30 Veracruz de Ignacio de la Llave,88,088 Jalcomulco,Mujeres,33,33,0,88
30 Veracruz de Ignacio de la Llave,88,088 Jalcomulco,Mujeres,31,31,0,72
30 Veracruz de Ignacio de la Llave,88,088 Jalcomulco,Mujeres,17,17,0,63
30 Veracruz de Ignacio de la Llave,88,088 Jalcomulco,Mujeres,13,13,0,60
30 Veracruz de Ignacio de la Llave,88,088 Jalcomulco,Mujeres,7,7,0,73
30 Veracruz de Ignacio de la Llave,88,088 Jalcomulco,Mujeres,3,3,0,59
30 Veracruz de Ignacio de la Llave,88,088 Jalcomulco,Mujeres,4,4,0,27
30 Veracruz de Ignacio de la Llave,88,088 Jalcomulco,Mujeres,1,1,0,22
30 Veracruz de Ignacio de la Llave,89,089 Jáltipan,Total,15877,15046,831,15593
30 Veracruz de Ignacio de la Llave,89,089 Jáltipan,Total,46,40,6,2138
30 Veracruz de Ignacio de la Llave,89,089 Jáltipan,Total,857,769,88,3011
30 Veracruz de Ignacio de la Llave,89,089 Jáltipan,Total,1858,1710,148,1531
30 Veracruz de Ignacio de la Llave,89,089 Jáltipan,Total,1917,1783,134,964
30 Veracruz de Ignacio de la Llave,89,089 Jáltipan,Total,1874,1790,84,1023
30 Veracruz de Ignacio de la Llave,89,089 Jáltipan,Total,1996,1916,80,917
30 Veracruz de Ignacio de la Llave,89,089 Jáltipan,Total,1889,1828,61,913
30 Veracruz de Ignacio de la Llave,89,089 Jáltipan,Total,1637,1582,55,802
30 Veracruz de Ignacio de la Llave,89,089 Jáltipan,Total,1309,1252,57,722
30 Veracruz de Ignacio de la Llave,89,089 Jáltipan,Total,964,913,51,744
30 Veracruz de Ignacio de la Llave,89,089 Jáltipan,Total,621,590,31,717
30 Veracruz de Ignacio de la Llave,89,089 Jáltipan,Total,394,381,13,616
30 Veracruz de Ignacio de la Llave,89,089 Jáltipan,Total,275,264,11,557
30 Veracruz de Ignacio de la Llave,89,089 Jáltipan,Total,148,142,6,391
30 Veracruz de Ignacio de la Llave,89,089 Jáltipan,Total,52,48,4,285
30 Veracruz de Ignacio de la Llave,89,089 Jáltipan,Total,40,38,2,262
30 Veracruz de Ignacio de la Llave,89,089 Jáltipan,Hombres,10918,10231,687,3873
30 Veracruz de Ignacio de la Llave,89,089 Jáltipan,Hombres,39,33,6,1027
30 Veracruz de Ignacio de la Llave,89,089 Jáltipan,Hombres,655,577,78,1305
30 Veracruz de Ignacio de la Llave,89,089 Jáltipan,Hombres,1245,1144,101,324
30 Veracruz de Ignacio de la Llave,89,089 Jáltipan,Hombres,1244,1144,100,65
30 Veracruz de Ignacio de la Llave,89,089 Jáltipan,Hombres,1211,1143,68,39
30 Veracruz de Ignacio de la Llave,89,089 Jáltipan,Hombres,1295,1227,68,37
30 Veracruz de Ignacio de la Llave,89,089 Jáltipan,Hombres,1226,1172,54,43
30 Veracruz de Ignacio de la Llave,89,089 Jáltipan,Hombres,1136,1086,50,42
30 Veracruz de Ignacio de la Llave,89,089 Jáltipan,Hombres,934,885,49,63
30 Veracruz de Ignacio de la Llave,89,089 Jáltipan,Hombres,693,644,49,73
30 Veracruz de Ignacio de la Llave,89,089 Jáltipan,Hombres,474,446,28,153
30 Veracruz de Ignacio de la Llave,89,089 Jáltipan,Hombres,323,310,13,170
30 Veracruz de Ignacio de la Llave,89,089 Jáltipan,Hombres,238,227,11,167
30 Veracruz de Ignacio de la Llave,89,089 Jáltipan,Hombres,128,122,6,128
30 Veracruz de Ignacio de la Llave,89,089 Jáltipan,Hombres,45,41,4,128
30 Veracruz de Ignacio de la Llave,89,089 Jáltipan,Hombres,32,30,2,109
30 Veracruz de Ignacio de la Llave,89,089 Jáltipan,Mujeres,4959,4815,144,11720
30 Veracruz de Ignacio de la Llave,89,089 Jáltipan,Mujeres,7,7,0,1111
30 Veracruz de Ignacio de la Llave,89,089 Jáltipan,Mujeres,202,192,10,1706
30 Veracruz de Ignacio de la Llave,89,089 Jáltipan,Mujeres,613,566,47,1207
30 Veracruz de Ignacio de la Llave,89,089 Jáltipan,Mujeres,673,639,34,899
30 Veracruz de Ignacio de la Llave,89,089 Jáltipan,Mujeres,663,647,16,984
30 Veracruz de Ignacio de la Llave,89,089 Jáltipan,Mujeres,701,689,12,880
30 Veracruz de Ignacio de la Llave,89,089 Jáltipan,Mujeres,663,656,7,870
30 Veracruz de Ignacio de la Llave,89,089 Jáltipan,Mujeres,501,496,5,760
30 Veracruz de Ignacio de la Llave,89,089 Jáltipan,Mujeres,375,367,8,659
30 Veracruz de Ignacio de la Llave,89,089 Jáltipan,Mujeres,271,269,2,671
30 Veracruz de Ignacio de la Llave,89,089 Jáltipan,Mujeres,147,144,3,564
30 Veracruz de Ignacio de la Llave,89,089 Jáltipan,Mujeres,71,71,0,446
30 Veracruz de Ignacio de la Llave,89,089 Jáltipan,Mujeres,37,37,0,390
30 Veracruz de Ignacio de la Llave,89,089 Jáltipan,Mujeres,20,20,0,263
30 Veracruz de Ignacio de la Llave,89,089 Jáltipan,Mujeres,7,7,0,157
30 Veracruz de Ignacio de la Llave,89,089 Jáltipan,Mujeres,8,8,0,153
30 Veracruz de Ignacio de la Llave,90,090 Jamapa,Total,4094,3940,154,4129
30 Veracruz de Ignacio de la Llave,90,090 Jamapa,Total,17,15,2,546
30 Veracruz de Ignacio de la Llave,90,090 Jamapa,Total,306,275,31,762
30 Veracruz de Ignacio de la Llave,90,090 Jamapa,Total,528,483,45,347
30 Veracruz de Ignacio de la Llave,90,090 Jamapa,Total,445,432,13,252
30 Veracruz de Ignacio de la Llave,90,090 Jamapa,Total,470,457,13,287
30 Veracruz de Ignacio de la Llave,90,090 Jamapa,Total,467,457,10,289
30 Veracruz de Ignacio de la Llave,90,090 Jamapa,Total,427,418,9,268
30 Veracruz de Ignacio de la Llave,90,090 Jamapa,Total,399,387,12,234
30 Veracruz de Ignacio de la Llave,90,090 Jamapa,Total,348,338,10,196
30 Veracruz de Ignacio de la Llave,90,090 Jamapa,Total,229,227,2,173
30 Veracruz de Ignacio de la Llave,90,090 Jamapa,Total,181,180,1,185
30 Veracruz de Ignacio de la Llave,90,090 Jamapa,Total,107,104,3,162
30 Veracruz de Ignacio de la Llave,90,090 Jamapa,Total,92,90,2,152
30 Veracruz de Ignacio de la Llave,90,090 Jamapa,Total,50,49,1,124
30 Veracruz de Ignacio de la Llave,90,090 Jamapa,Total,19,19,0,86
30 Veracruz de Ignacio de la Llave,90,090 Jamapa,Total,9,9,0,66
30 Veracruz de Ignacio de la Llave,90,090 Jamapa,Hombres,3074,2948,126,882
30 Veracruz de Ignacio de la Llave,90,090 Jamapa,Hombres,15,13,2,272
30 Veracruz de Ignacio de la Llave,90,090 Jamapa,Hombres,254,228,26,295
30 Veracruz de Ignacio de la Llave,90,090 Jamapa,Hombres,382,348,34,43
30 Veracruz de Ignacio de la Llave,90,090 Jamapa,Hombres,317,305,12,15
30 Veracruz de Ignacio de la Llave,90,090 Jamapa,Hombres,338,326,12,13
30 Veracruz de Ignacio de la Llave,90,090 Jamapa,Hombres,337,327,10,12
30 Veracruz de Ignacio de la Llave,90,090 Jamapa,Hombres,307,299,8,12
30 Veracruz de Ignacio de la Llave,90,090 Jamapa,Hombres,296,290,6,10
30 Veracruz de Ignacio de la Llave,90,090 Jamapa,Hombres,262,255,7,16
30 Veracruz de Ignacio de la Llave,90,090 Jamapa,Hombres,169,167,2,14
30 Veracruz de Ignacio de la Llave,90,090 Jamapa,Hombres,152,151,1,24
30 Veracruz de Ignacio de la Llave,90,090 Jamapa,Hombres,92,89,3,27
30 Veracruz de Ignacio de la Llave,90,090 Jamapa,Hombres,82,80,2,34
30 Veracruz de Ignacio de la Llave,90,090 Jamapa,Hombres,45,44,1,40
30 Veracruz de Ignacio de la Llave,90,090 Jamapa,Hombres,17,17,0,35
30 Veracruz de Ignacio de la Llave,90,090 Jamapa,Hombres,9,9,0,20
30 Veracruz de Ignacio de la Llave,90,090 Jamapa,Mujeres,1020,992,28,3247
30 Veracruz de Ignacio de la Llave,90,090 Jamapa,Mujeres,2,2,0,274
30 Veracruz de Ignacio de la Llave,90,090 Jamapa,Mujeres,52,47,5,467
30 Veracruz de Ignacio de la Llave,90,090 Jamapa,Mujeres,146,135,11,304
30 Veracruz de Ignacio de la Llave,90,090 Jamapa,Mujeres,128,127,1,237
30 Veracruz de Ignacio de la Llave,90,090 Jamapa,Mujeres,132,131,1,274
30 Veracruz de Ignacio de la Llave,90,090 Jamapa,Mujeres,130,130,0,277
30 Veracruz de Ignacio de la Llave,90,090 Jamapa,Mujeres,120,119,1,256
30 Veracruz de Ignacio de la Llave,90,090 Jamapa,Mujeres,103,97,6,224
30 Veracruz de Ignacio de la Llave,90,090 Jamapa,Mujeres,86,83,3,180
30 Veracruz de Ignacio de la Llave,90,090 Jamapa,Mujeres,60,60,0,159
30 Veracruz de Ignacio de la Llave,90,090 Jamapa,Mujeres,29,29,0,161
30 Veracruz de Ignacio de la Llave,90,090 Jamapa,Mujeres,15,15,0,135
30 Veracruz de Ignacio de la Llave,90,090 Jamapa,Mujeres,10,10,0,118
30 Veracruz de Ignacio de la Llave,90,090 Jamapa,Mujeres,5,5,0,84
30 Veracruz de Ignacio de la Llave,90,090 Jamapa,Mujeres,2,2,0,51
30 Veracruz de Ignacio de la Llave,90,090 Jamapa,Mujeres,0,0,0,46
30 Veracruz de Ignacio de la Llave,91,091 Jesús Carranza,Total,9090,8829,261,11045
30 Veracruz de Ignacio de la Llave,91,091 Jesús Carranza,Total,143,133,10,1762
30 Veracruz de Ignacio de la Llave,91,091 Jesús Carranza,Total,986,933,53,2275
30 Veracruz de Ignacio de la Llave,91,091 Jesús Carranza,Total,1185,1145,40,1084
30 Veracruz de Ignacio de la Llave,91,091 Jesús Carranza,Total,880,858,22,761
30 Veracruz de Ignacio de la Llave,91,091 Jesús Carranza,Total,939,919,20,797
30 Veracruz de Ignacio de la Llave,91,091 Jesús Carranza,Total,916,895,21,746
30 Veracruz de Ignacio de la Llave,91,091 Jesús Carranza,Total,928,914,14,613
30 Veracruz de Ignacio de la Llave,91,091 Jesús Carranza,Total,747,731,16,568
30 Veracruz de Ignacio de la Llave,91,091 Jesús Carranza,Total,622,610,12,494
30 Veracruz de Ignacio de la Llave,91,091 Jesús Carranza,Total,523,513,10,409
30 Veracruz de Ignacio de la Llave,91,091 Jesús Carranza,Total,418,411,7,413
30 Veracruz de Ignacio de la Llave,91,091 Jesús Carranza,Total,310,301,9,330
30 Veracruz de Ignacio de la Llave,91,091 Jesús Carranza,Total,258,246,12,317
30 Veracruz de Ignacio de la Llave,91,091 Jesús Carranza,Total,139,137,2,183
30 Veracruz de Ignacio de la Llave,91,091 Jesús Carranza,Total,63,54,9,132
30 Veracruz de Ignacio de la Llave,91,091 Jesús Carranza,Total,33,29,4,161
30 Veracruz de Ignacio de la Llave,91,091 Jesús Carranza,Hombres,7614,7390,224,2203
30 Veracruz de Ignacio de la Llave,91,091 Jesús Carranza,Hombres,127,117,10,825
30 Veracruz de Ignacio de la Llave,91,091 Jesús Carranza,Hombres,836,792,44,821
30 Veracruz de Ignacio de la Llave,91,091 Jesús Carranza,Hombres,944,918,26,144
30 Veracruz de Ignacio de la Llave,91,091 Jesús Carranza,Hombres,710,690,20,30
30 Veracruz de Ignacio de la Llave,91,091 Jesús Carranza,Hombres,784,765,19,22
30 Veracruz de Ignacio de la Llave,91,091 Jesús Carranza,Hombres,722,703,19,21
30 Veracruz de Ignacio de la Llave,91,091 Jesús Carranza,Hombres,762,748,14,16
30 Veracruz de Ignacio de la Llave,91,091 Jesús Carranza,Hombres,623,607,16,14
30 Veracruz de Ignacio de la Llave,91,091 Jesús Carranza,Hombres,525,514,11,14
30 Veracruz de Ignacio de la Llave,91,091 Jesús Carranza,Hombres,464,454,10,17
30 Veracruz de Ignacio de la Llave,91,091 Jesús Carranza,Hombres,376,369,7,30
30 Veracruz de Ignacio de la Llave,91,091 Jesús Carranza,Hombres,277,270,7,40
30 Veracruz de Ignacio de la Llave,91,091 Jesús Carranza,Hombres,240,230,10,47
30 Veracruz de Ignacio de la Llave,91,091 Jesús Carranza,Hombres,135,133,2,42
30 Veracruz de Ignacio de la Llave,91,091 Jesús Carranza,Hombres,58,52,6,41
30 Veracruz de Ignacio de la Llave,91,091 Jesús Carranza,Hombres,31,28,3,79
30 Veracruz de Ignacio de la Llave,91,091 Jesús Carranza,Mujeres,1476,1439,37,8842
30 Veracruz de Ignacio de la Llave,91,091 Jesús Carranza,Mujeres,16,16,0,937
30 Veracruz de Ignacio de la Llave,91,091 Jesús Carranza,Mujeres,150,141,9,1454
30 Veracruz de Ignacio de la Llave,91,091 Jesús Carranza,Mujeres,241,227,14,940
30 Veracruz de Ignacio de la Llave,91,091 Jesús Carranza,Mujeres,170,168,2,731
30 Veracruz de Ignacio de la Llave,91,091 Jesús Carranza,Mujeres,155,154,1,775
30 Veracruz de Ignacio de la Llave,91,091 Jesús Carranza,Mujeres,194,192,2,725
30 Veracruz de Ignacio de la Llave,91,091 Jesús Carranza,Mujeres,166,166,0,597
30 Veracruz de Ignacio de la Llave,91,091 Jesús Carranza,Mujeres,124,124,0,554
30 Veracruz de Ignacio de la Llave,91,091 Jesús Carranza,Mujeres,97,96,1,480
30 Veracruz de Ignacio de la Llave,91,091 Jesús Carranza,Mujeres,59,59,0,392
30 Veracruz de Ignacio de la Llave,91,091 Jesús Carranza,Mujeres,42,42,0,383
30 Veracruz de Ignacio de la Llave,91,091 Jesús Carranza,Mujeres,33,31,2,290
30 Veracruz de Ignacio de la Llave,91,091 Jesús Carranza,Mujeres,18,16,2,270
30 Veracruz de Ignacio de la Llave,91,091 Jesús Carranza,Mujeres,4,4,0,141
30 Veracruz de Ignacio de la Llave,91,091 Jesús Carranza,Mujeres,5,2,3,91
30 Veracruz de Ignacio de la Llave,91,091 Jesús Carranza,Mujeres,2,1,1,82
30 Veracruz de Ignacio de la Llave,93,093 Jilotepec,Total,5591,5426,165,6058
30 Veracruz de Ignacio de la Llave,93,093 Jilotepec,Total,31,28,3,851
30 Veracruz de Ignacio de la Llave,93,093 Jilotepec,Total,410,387,23,1014
30 Veracruz de Ignacio de la Llave,93,093 Jilotepec,Total,760,732,28,607
30 Veracruz de Ignacio de la Llave,93,093 Jilotepec,Total,702,678,24,425
30 Veracruz de Ignacio de la Llave,93,093 Jilotepec,Total,747,729,18,470
30 Veracruz de Ignacio de la Llave,93,093 Jilotepec,Total,700,683,17,404
30 Veracruz de Ignacio de la Llave,93,093 Jilotepec,Total,635,621,14,367
30 Veracruz de Ignacio de la Llave,93,093 Jilotepec,Total,467,455,12,337
30 Veracruz de Ignacio de la Llave,93,093 Jilotepec,Total,392,382,10,289
30 Veracruz de Ignacio de la Llave,93,093 Jilotepec,Total,292,280,12,263
30 Veracruz de Ignacio de la Llave,93,093 Jilotepec,Total,179,179,0,269
30 Veracruz de Ignacio de la Llave,93,093 Jilotepec,Total,121,118,3,236
30 Veracruz de Ignacio de la Llave,93,093 Jilotepec,Total,68,68,0,193
30 Veracruz de Ignacio de la Llave,93,093 Jilotepec,Total,55,54,1,154
30 Veracruz de Ignacio de la Llave,93,093 Jilotepec,Total,21,21,0,92
30 Veracruz de Ignacio de la Llave,93,093 Jilotepec,Total,11,11,0,87
30 Veracruz de Ignacio de la Llave,93,093 Jilotepec,Hombres,4128,3973,155,1423
30 Veracruz de Ignacio de la Llave,93,093 Jilotepec,Hombres,22,19,3,435
30 Veracruz de Ignacio de la Llave,93,093 Jilotepec,Hombres,312,292,20,429
30 Veracruz de Ignacio de la Llave,93,093 Jilotepec,Hombres,533,508,25,101
30 Veracruz de Ignacio de la Llave,93,093 Jilotepec,Hombres,500,478,22,36
30 Veracruz de Ignacio de la Llave,93,093 Jilotepec,Hombres,525,508,17,10
30 Veracruz de Ignacio de la Llave,93,093 Jilotepec,Hombres,490,473,17,16
30 Veracruz de Ignacio de la Llave,93,093 Jilotepec,Hombres,467,454,13,15
30 Veracruz de Ignacio de la Llave,93,093 Jilotepec,Hombres,360,348,12,27
30 Veracruz de Ignacio de la Llave,93,093 Jilotepec,Hombres,299,289,10,23
30 Veracruz de Ignacio de la Llave,93,093 Jilotepec,Hombres,228,216,12,26
30 Veracruz de Ignacio de la Llave,93,093 Jilotepec,Hombres,147,147,0,75
30 Veracruz de Ignacio de la Llave,93,093 Jilotepec,Hombres,102,99,3,71
30 Veracruz de Ignacio de la Llave,93,093 Jilotepec,Hombres,61,61,0,58
30 Veracruz de Ignacio de la Llave,93,093 Jilotepec,Hombres,51,50,1,46
30 Veracruz de Ignacio de la Llave,93,093 Jilotepec,Hombres,20,20,0,23
30 Veracruz de Ignacio de la Llave,93,093 Jilotepec,Hombres,11,11,0,32
30 Veracruz de Ignacio de la Llave,93,093 Jilotepec,Mujeres,1463,1453,10,4635
30 Veracruz de Ignacio de la Llave,93,093 Jilotepec,Mujeres,9,9,0,416
30 Veracruz de Ignacio de la Llave,93,093 Jilotepec,Mujeres,98,95,3,585
30 Veracruz de Ignacio de la Llave,93,093 Jilotepec,Mujeres,227,224,3,506
30 Veracruz de Ignacio de la Llave,93,093 Jilotepec,Mujeres,202,200,2,389
30 Veracruz de Ignacio de la Llave,93,093 Jilotepec,Mujeres,222,221,1,460
30 Veracruz de Ignacio de la Llave,93,093 Jilotepec,Mujeres,210,210,0,388
30 Veracruz de Ignacio de la Llave,93,093 Jilotepec,Mujeres,168,167,1,352
30 Veracruz de Ignacio de la Llave,93,093 Jilotepec,Mujeres,107,107,0,310
30 Veracruz de Ignacio de la Llave,93,093 Jilotepec,Mujeres,93,93,0,266
30 Veracruz de Ignacio de la Llave,93,093 Jilotepec,Mujeres,64,64,0,237
30 Veracruz de Ignacio de la Llave,93,093 Jilotepec,Mujeres,32,32,0,194
30 Veracruz de Ignacio de la Llave,93,093 Jilotepec,Mujeres,19,19,0,165
30 Veracruz de Ignacio de la Llave,93,093 Jilotepec,Mujeres,7,7,0,135
30 Veracruz de Ignacio de la Llave,93,093 Jilotepec,Mujeres,4,4,0,108
30 Veracruz de Ignacio de la Llave,93,093 Jilotepec,Mujeres,1,1,0,69
30 Veracruz de Ignacio de la Llave,93,093 Jilotepec,Mujeres,0,0,0,55
30 Veracruz de Ignacio de la Llave,169,169 José Azueta,Total,8428,8029,399,10252
30 Veracruz de Ignacio de la Llave,169,169 José Azueta,Total,60,53,7,1389
30 Veracruz de Ignacio de la Llave,169,169 José Azueta,Total,741,671,70,1828
30 Veracruz de Ignacio de la Llave,169,169 José Azueta,Total,1044,964,80,888
30 Veracruz de Ignacio de la Llave,169,169 José Azueta,Total,904,848,56,749
30 Veracruz de Ignacio de la Llave,169,169 José Azueta,Total,857,822,35,701
30 Veracruz de Ignacio de la Llave,169,169 José Azueta,Total,914,882,32,768
30 Veracruz de Ignacio de la Llave,169,169 José Azueta,Total,883,859,24,632
30 Veracruz de Ignacio de la Llave,169,169 José Azueta,Total,729,714,15,576
30 Veracruz de Ignacio de la Llave,169,169 José Azueta,Total,630,612,18,508
30 Veracruz de Ignacio de la Llave,169,169 José Azueta,Total,529,508,21,469
30 Veracruz de Ignacio de la Llave,169,169 José Azueta,Total,393,380,13,413
30 Veracruz de Ignacio de la Llave,169,169 José Azueta,Total,294,284,10,375
30 Veracruz de Ignacio de la Llave,169,169 José Azueta,Total,233,224,9,405
30 Veracruz de Ignacio de la Llave,169,169 José Azueta,Total,137,133,4,229
30 Veracruz de Ignacio de la Llave,169,169 José Azueta,Total,53,51,2,152
30 Veracruz de Ignacio de la Llave,169,169 José Azueta,Total,27,24,3,170
30 Veracruz de Ignacio de la Llave,169,169 José Azueta,Hombres,6961,6622,339,2069
30 Veracruz de Ignacio de la Llave,169,169 José Azueta,Hombres,52,47,5,646
30 Veracruz de Ignacio de la Llave,169,169 José Azueta,Hombres,637,578,59,678
30 Veracruz de Ignacio de la Llave,169,169 José Azueta,Hombres,808,748,60,111
30 Veracruz de Ignacio de la Llave,169,169 José Azueta,Hombres,718,670,48,30
30 Veracruz de Ignacio de la Llave,169,169 José Azueta,Hombres,650,622,28,22
30 Veracruz de Ignacio de la Llave,169,169 José Azueta,Hombres,715,686,29,33
30 Veracruz de Ignacio de la Llave,169,169 José Azueta,Hombres,729,707,22,29
30 Veracruz de Ignacio de la Llave,169,169 José Azueta,Hombres,601,588,13,19
30 Veracruz de Ignacio de la Llave,169,169 José Azueta,Hombres,533,515,18,35
30 Veracruz de Ignacio de la Llave,169,169 José Azueta,Hombres,457,439,18,34
30 Veracruz de Ignacio de la Llave,169,169 José Azueta,Hombres,367,354,13,60
30 Veracruz de Ignacio de la Llave,169,169 José Azueta,Hombres,266,256,10,73
30 Veracruz de Ignacio de la Llave,169,169 José Azueta,Hombres,222,213,9,98
30 Veracruz de Ignacio de la Llave,169,169 José Azueta,Hombres,131,128,3,77
30 Veracruz de Ignacio de la Llave,169,169 José Azueta,Hombres,49,48,1,56
30 Veracruz de Ignacio de la Llave,169,169 José Azueta,Hombres,26,23,3,68
30 Veracruz de Ignacio de la Llave,169,169 José Azueta,Mujeres,1467,1407,60,8183
30 Veracruz de Ignacio de la Llave,169,169 José Azueta,Mujeres,8,6,2,743
30 Veracruz de Ignacio de la Llave,169,169 José Azueta,Mujeres,104,93,11,1150
30 Veracruz de Ignacio de la Llave,169,169 José Azueta,Mujeres,236,216,20,777
30 Veracruz de Ignacio de la Llave,169,169 José Azueta,Mujeres,186,178,8,719
30 Veracruz de Ignacio de la Llave,169,169 José Azueta,Mujeres,207,200,7,679
30 Veracruz de Ignacio de la Llave,169,169 José Azueta,Mujeres,199,196,3,735
30 Veracruz de Ignacio de la Llave,169,169 José Azueta,Mujeres,154,152,2,603
30 Veracruz de Ignacio de la Llave,169,169 José Azueta,Mujeres,128,126,2,557
30 Veracruz de Ignacio de la Llave,169,169 José Azueta,Mujeres,97,97,0,473
30 Veracruz de Ignacio de la Llave,169,169 José Azueta,Mujeres,72,69,3,435
30 Veracruz de Ignacio de la Llave,169,169 José Azueta,Mujeres,26,26,0,353
30 Veracruz de Ignacio de la Llave,169,169 José Azueta,Mujeres,28,28,0,302
30 Veracruz de Ignacio de la Llave,169,169 José Azueta,Mujeres,11,11,0,307
30 Veracruz de Ignacio de la Llave,169,169 José Azueta,Mujeres,6,5,1,152
30 Veracruz de Ignacio de la Llave,169,169 José Azueta,Mujeres,4,3,1,96
30 Veracruz de Ignacio de la Llave,169,169 José Azueta,Mujeres,1,1,0,102
30 Veracruz de Ignacio de la Llave,94,094 Juan Rodríguez Clara,Total,13790,13375,415,14898
30 Veracruz de Ignacio de la Llave,94,094 Juan Rodríguez Clara,Total,185,173,12,2130
30 Veracruz de Ignacio de la Llave,94,094 Juan Rodríguez Clara,Total,1359,1310,49,2632
30 Veracruz de Ignacio de la Llave,94,094 Juan Rodríguez Clara,Total,1647,1593,54,1335
30 Veracruz de Ignacio de la Llave,94,094 Juan Rodríguez Clara,Total,1406,1362,44,1025
30 Veracruz de Ignacio de la Llave,94,094 Juan Rodríguez Clara,Total,1514,1468,46,1105
30 Veracruz de Ignacio de la Llave,94,094 Juan Rodríguez Clara,Total,1563,1517,46,1122
30 Veracruz de Ignacio de la Llave,94,094 Juan Rodríguez Clara,Total,1385,1342,43,969
30 Veracruz de Ignacio de la Llave,94,094 Juan Rodríguez Clara,Total,1161,1140,21,841
30 Veracruz de Ignacio de la Llave,94,094 Juan Rodríguez Clara,Total,1082,1051,31,754
30 Veracruz de Ignacio de la Llave,94,094 Juan Rodríguez Clara,Total,836,801,35,661
30 Veracruz de Ignacio de la Llave,94,094 Juan Rodríguez Clara,Total,576,564,12,513
30 Veracruz de Ignacio de la Llave,94,094 Juan Rodríguez Clara,Total,432,423,9,506
30 Veracruz de Ignacio de la Llave,94,094 Juan Rodríguez Clara,Total,347,339,8,501
30 Veracruz de Ignacio de la Llave,94,094 Juan Rodríguez Clara,Total,184,179,5,351
30 Veracruz de Ignacio de la Llave,94,094 Juan Rodríguez Clara,Total,79,79,0,209
30 Veracruz de Ignacio de la Llave,94,094 Juan Rodríguez Clara,Total,34,34,0,244
30 Veracruz de Ignacio de la Llave,94,094 Juan Rodríguez Clara,Hombres,11215,10844,371,2840
30 Veracruz de Ignacio de la Llave,94,094 Juan Rodríguez Clara,Hombres,155,145,10,1039
30 Veracruz de Ignacio de la Llave,94,094 Juan Rodríguez Clara,Hombres,1107,1064,43,922
30 Veracruz de Ignacio de la Llave,94,094 Juan Rodríguez Clara,Hombres,1291,1252,39,143
30 Veracruz de Ignacio de la Llave,94,094 Juan Rodríguez Clara,Hombres,1106,1071,35,40
30 Veracruz de Ignacio de la Llave,94,094 Juan Rodríguez Clara,Hombres,1222,1177,45,30
30 Veracruz de Ignacio de la Llave,94,094 Juan Rodríguez Clara,Hombres,1228,1185,43,27
30 Veracruz de Ignacio de la Llave,94,094 Juan Rodríguez Clara,Hombres,1088,1048,40,37
30 Veracruz de Ignacio de la Llave,94,094 Juan Rodríguez Clara,Hombres,938,919,19,30
30 Veracruz de Ignacio de la Llave,94,094 Juan Rodríguez Clara,Hombres,884,853,31,44
30 Veracruz de Ignacio de la Llave,94,094 Juan Rodríguez Clara,Hombres,714,681,33,46
30 Veracruz de Ignacio de la Llave,94,094 Juan Rodríguez Clara,Hombres,503,492,11,49
30 Veracruz de Ignacio de la Llave,94,094 Juan Rodríguez Clara,Hombres,382,373,9,75
30 Veracruz de Ignacio de la Llave,94,094 Juan Rodríguez Clara,Hombres,317,309,8,93
30 Veracruz de Ignacio de la Llave,94,094 Juan Rodríguez Clara,Hombres,170,165,5,91
30 Veracruz de Ignacio de la Llave,94,094 Juan Rodríguez Clara,Hombres,78,78,0,64
30 Veracruz de Ignacio de la Llave,94,094 Juan Rodríguez Clara,Hombres,32,32,0,110
30 Veracruz de Ignacio de la Llave,94,094 Juan Rodríguez Clara,Mujeres,2575,2531,44,12058
30 Veracruz de Ignacio de la Llave,94,094 Juan Rodríguez Clara,Mujeres,30,28,2,1091
30 Veracruz de Ignacio de la Llave,94,094 Juan Rodríguez Clara,Mujeres,252,246,6,1710
30 Veracruz de Ignacio de la Llave,94,094 Juan Rodríguez Clara,Mujeres,356,341,15,1192
30 Veracruz de Ignacio de la Llave,94,094 Juan Rodríguez Clara,Mujeres,300,291,9,985
30 Veracruz de Ignacio de la Llave,94,094 Juan Rodríguez Clara,Mujeres,292,291,1,1075
30 Veracruz de Ignacio de la Llave,94,094 Juan Rodríguez Clara,Mujeres,335,332,3,1095
30 Veracruz de Ignacio de la Llave,94,094 Juan Rodríguez Clara,Mujeres,297,294,3,932
30 Veracruz de Ignacio de la Llave,94,094 Juan Rodríguez Clara,Mujeres,223,221,2,811
30 Veracruz de Ignacio de la Llave,94,094 Juan Rodríguez Clara,Mujeres,198,198,0,710
30 Veracruz de Ignacio de la Llave,94,094 Juan Rodríguez Clara,Mujeres,122,120,2,615
30 Veracruz de Ignacio de la Llave,94,094 Juan Rodríguez Clara,Mujeres,73,72,1,464
30 Veracruz de Ignacio de la Llave,94,094 Juan Rodríguez Clara,Mujeres,50,50,0,431
30 Veracruz de Ignacio de la Llave,94,094 Juan Rodríguez Clara,Mujeres,30,30,0,408
30 Veracruz de Ignacio de la Llave,94,094 Juan Rodríguez Clara,Mujeres,14,14,0,260
30 Veracruz de Ignacio de la Llave,94,094 Juan Rodríguez Clara,Mujeres,1,1,0,145
30 Veracruz de Ignacio de la Llave,94,094 Juan Rodríguez Clara,Mujeres,2,2,0,134
30 Veracruz de Ignacio de la Llave,95,095 Juchique de Ferrer,Total,5354,5191,163,7206
30 Veracruz de Ignacio de la Llave,95,095 Juchique de Ferrer,Total,63,61,2,1117
30 Veracruz de Ignacio de la Llave,95,095 Juchique de Ferrer,Total,415,402,13,1234
30 Veracruz de Ignacio de la Llave,95,095 Juchique de Ferrer,Total,569,547,22,586
30 Veracruz de Ignacio de la Llave,95,095 Juchique de Ferrer,Total,473,452,21,441
30 Veracruz de Ignacio de la Llave,95,095 Juchique de Ferrer,Total,565,544,21,489
30 Veracruz de Ignacio de la Llave,95,095 Juchique de Ferrer,Total,581,565,16,460
30 Veracruz de Ignacio de la Llave,95,095 Juchique de Ferrer,Total,535,524,11,410
30 Veracruz de Ignacio de la Llave,95,095 Juchique de Ferrer,Total,484,470,14,405
30 Veracruz de Ignacio de la Llave,95,095 Juchique de Ferrer,Total,418,409,9,349
30 Veracruz de Ignacio de la Llave,95,095 Juchique de Ferrer,Total,374,365,9,368
30 Veracruz de Ignacio de la Llave,95,095 Juchique de Ferrer,Total,287,279,8,292
30 Veracruz de Ignacio de la Llave,95,095 Juchique de Ferrer,Total,228,220,8,289
30 Veracruz de Ignacio de la Llave,95,095 Juchique de Ferrer,Total,202,195,7,285
30 Veracruz de Ignacio de la Llave,95,095 Juchique de Ferrer,Total,87,85,2,218
30 Veracruz de Ignacio de la Llave,95,095 Juchique de Ferrer,Total,46,46,0,126
30 Veracruz de Ignacio de la Llave,95,095 Juchique de Ferrer,Total,27,27,0,137
30 Veracruz de Ignacio de la Llave,95,095 Juchique de Ferrer,Hombres,4514,4363,151,1616
30 Veracruz de Ignacio de la Llave,95,095 Juchique de Ferrer,Hombres,50,48,2,523
30 Veracruz de Ignacio de la Llave,95,095 Juchique de Ferrer,Hombres,356,344,12,490
30 Veracruz de Ignacio de la Llave,95,095 Juchique de Ferrer,Hombres,434,417,17,94
30 Veracruz de Ignacio de la Llave,95,095 Juchique de Ferrer,Hombres,383,365,18,33
30 Veracruz de Ignacio de la Llave,95,095 Juchique de Ferrer,Hombres,462,444,18,28
30 Veracruz de Ignacio de la Llave,95,095 Juchique de Ferrer,Hombres,475,459,16,34
30 Veracruz de Ignacio de la Llave,95,095 Juchique de Ferrer,Hombres,438,427,11,25
30 Veracruz de Ignacio de la Llave,95,095 Juchique de Ferrer,Hombres,397,383,14,27
30 Veracruz de Ignacio de la Llave,95,095 Juchique de Ferrer,Hombres,361,352,9,19
30 Veracruz de Ignacio de la Llave,95,095 Juchique de Ferrer,Hombres,333,324,9,31
30 Veracruz de Ignacio de la Llave,95,095 Juchique de Ferrer,Hombres,267,259,8,26
30 Veracruz de Ignacio de la Llave,95,095 Juchique de Ferrer,Hombres,217,209,8,47
30 Veracruz de Ignacio de la Llave,95,095 Juchique de Ferrer,Hombres,189,182,7,72
30 Veracruz de Ignacio de la Llave,95,095 Juchique de Ferrer,Hombres,80,78,2,64
30 Veracruz de Ignacio de la Llave,95,095 Juchique de Ferrer,Hombres,45,45,0,40
30 Veracruz de Ignacio de la Llave,95,095 Juchique de Ferrer,Hombres,27,27,0,63
30 Veracruz de Ignacio de la Llave,95,095 Juchique de Ferrer,Mujeres,840,828,12,5590
30 Veracruz de Ignacio de la Llave,95,095 Juchique de Ferrer,Mujeres,13,13,0,594
30 Veracruz de Ignacio de la Llave,95,095 Juchique de Ferrer,Mujeres,59,58,1,744
30 Veracruz de Ignacio de la Llave,95,095 Juchique de Ferrer,Mujeres,135,130,5,492
30 Veracruz de Ignacio de la Llave,95,095 Juchique de Ferrer,Mujeres,90,87,3,408
30 Veracruz de Ignacio de la Llave,95,095 Juchique de Ferrer,Mujeres,103,100,3,461
30 Veracruz de Ignacio de la Llave,95,095 Juchique de Ferrer,Mujeres,106,106,0,426
30 Veracruz de Ignacio de la Llave,95,095 Juchique de Ferrer,Mujeres,97,97,0,385
30 Veracruz de Ignacio de la Llave,95,095 Juchique de Ferrer,Mujeres,87,87,0,378
30 Veracruz de Ignacio de la Llave,95,095 Juchique de Ferrer,Mujeres,57,57,0,330
30 Veracruz de Ignacio de la Llave,95,095 Juchique de Ferrer,Mujeres,41,41,0,337
30 Veracruz de Ignacio de la Llave,95,095 Juchique de Ferrer,Mujeres,20,20,0,266
30 Veracruz de Ignacio de la Llave,95,095 Juchique de Ferrer,Mujeres,11,11,0,242
30 Veracruz de Ignacio de la Llave,95,095 Juchique de Ferrer,Mujeres,13,13,0,213
30 Veracruz de Ignacio de la Llave,95,095 Juchique de Ferrer,Mujeres,7,7,0,154
30 Veracruz de Ignacio de la Llave,95,095 Juchique de Ferrer,Mujeres,1,1,0,86
30 Veracruz de Ignacio de la Llave,95,095 Juchique de Ferrer,Mujeres,0,0,0,74
30 Veracruz de Ignacio de la Llave,16,016 La Antigua,Total,10268,9873,395,9447
30 Veracruz de Ignacio de la Llave,16,016 La Antigua,Total,61,55,6,1256
30 Veracruz de Ignacio de la Llave,16,016 La Antigua,Total,634,588,46,1688
30 Veracruz de Ignacio de la Llave,16,016 La Antigua,Total,1193,1139,54,841
30 Veracruz de Ignacio de la Llave,16,016 La Antigua,Total,1240,1171,69,537
30 Veracruz de Ignacio de la Llave,16,016 La Antigua,Total,1197,1162,35,591
30 Veracruz de Ignacio de la Llave,16,016 La Antigua,Total,1381,1345,36,613
30 Veracruz de Ignacio de la Llave,16,016 La Antigua,Total,1209,1185,24,532
30 Veracruz de Ignacio de la Llave,16,016 La Antigua,Total,1048,1021,27,517
30 Veracruz de Ignacio de la Llave,16,016 La Antigua,Total,835,806,29,542
30 Veracruz de Ignacio de la Llave,16,016 La Antigua,Total,629,605,24,470
30 Veracruz de Ignacio de la Llave,16,016 La Antigua,Total,388,366,22,522
30 Veracruz de Ignacio de la Llave,16,016 La Antigua,Total,226,215,11,406
30 Veracruz de Ignacio de la Llave,16,016 La Antigua,Total,126,121,5,372
30 Veracruz de Ignacio de la Llave,16,016 La Antigua,Total,67,61,6,248
30 Veracruz de Ignacio de la Llave,16,016 La Antigua,Total,24,23,1,168
30 Veracruz de Ignacio de la Llave,16,016 La Antigua,Total,10,10,0,144
30 Veracruz de Ignacio de la Llave,16,016 La Antigua,Hombres,6895,6557,338,2434
30 Veracruz de Ignacio de la Llave,16,016 La Antigua,Hombres,50,45,5,609
30 Veracruz de Ignacio de la Llave,16,016 La Antigua,Hombres,459,423,36,725
30 Veracruz de Ignacio de la Llave,16,016 La Antigua,Hombres,792,752,40,201
30 Veracruz de Ignacio de la Llave,16,016 La Antigua,Hombres,783,726,57,53
30 Veracruz de Ignacio de la Llave,16,016 La Antigua,Hombres,758,726,32,24
30 Veracruz de Ignacio de la Llave,16,016 La Antigua,Hombres,875,849,26,29
30 Veracruz de Ignacio de la Llave,16,016 La Antigua,Hombres,767,746,21,21
30 Veracruz de Ignacio de la Llave,16,016 La Antigua,Hombres,709,683,26,35
30 Veracruz de Ignacio de la Llave,16,016 La Antigua,Hombres,588,560,28,49
30 Veracruz de Ignacio de la Llave,16,016 La Antigua,Hombres,453,430,23,72
30 Veracruz de Ignacio de la Llave,16,016 La Antigua,Hombres,298,276,22,144
30 Veracruz de Ignacio de la Llave,16,016 La Antigua,Hombres,183,173,10,142
30 Veracruz de Ignacio de la Llave,16,016 La Antigua,Hombres,99,94,5,116
30 Veracruz de Ignacio de la Llave,16,016 La Antigua,Hombres,54,48,6,85
30 Veracruz de Ignacio de la Llave,16,016 La Antigua,Hombres,17,16,1,74
30 Veracruz de Ignacio de la Llave,16,016 La Antigua,Hombres,10,10,0,55
30 Veracruz de Ignacio de la Llave,16,016 La Antigua,Mujeres,3373,3316,57,7013
30 Veracruz de Ignacio de la Llave,16,016 La Antigua,Mujeres,11,10,1,647
30 Veracruz de Ignacio de la Llave,16,016 La Antigua,Mujeres,175,165,10,963
30 Veracruz de Ignacio de la Llave,16,016 La Antigua,Mujeres,401,387,14,640
30 Veracruz de Ignacio de la Llave,16,016 La Antigua,Mujeres,457,445,12,484
30 Veracruz de Ignacio de la Llave,16,016 La Antigua,Mujeres,439,436,3,567
30 Veracruz de Ignacio de la Llave,16,016 La Antigua,Mujeres,506,496,10,584
30 Veracruz de Ignacio de la Llave,16,016 La Antigua,Mujeres,442,439,3,511
30 Veracruz de Ignacio de la Llave,16,016 La Antigua,Mujeres,339,338,1,482
30 Veracruz de Ignacio de la Llave,16,016 La Antigua,Mujeres,247,246,1,493
30 Veracruz de Ignacio de la Llave,16,016 La Antigua,Mujeres,176,175,1,398
30 Veracruz de Ignacio de la Llave,16,016 La Antigua,Mujeres,90,90,0,378
30 Veracruz de Ignacio de la Llave,16,016 La Antigua,Mujeres,43,42,1,264
30 Veracruz de Ignacio de la Llave,16,016 La Antigua,Mujeres,27,27,0,256
30 Veracruz de Ignacio de la Llave,16,016 La Antigua,Mujeres,13,13,0,163
30 Veracruz de Ignacio de la Llave,16,016 La Antigua,Mujeres,7,7,0,94
30 Veracruz de Ignacio de la Llave,16,016 La Antigua,Mujeres,0,0,0,89
30 Veracruz de Ignacio de la Llave,127,127 La Perla,Total,6733,6391,342,7670
30 Veracruz de Ignacio de la Llave,127,127 La Perla,Total,338,325,13,1560
30 Veracruz de Ignacio de la Llave,127,127 La Perla,Total,1156,1103,53,1558
30 Veracruz de Ignacio de la Llave,127,127 La Perla,Total,946,888,58,911
30 Veracruz de Ignacio de la Llave,127,127 La Perla,Total,801,746,55,720
30 Veracruz de Ignacio de la Llave,127,127 La Perla,Total,725,690,35,684
30 Veracruz de Ignacio de la Llave,127,127 La Perla,Total,644,619,25,497
30 Veracruz de Ignacio de la Llave,127,127 La Perla,Total,506,479,27,416
30 Veracruz de Ignacio de la Llave,127,127 La Perla,Total,443,420,23,295
30 Veracruz de Ignacio de la Llave,127,127 La Perla,Total,311,299,12,229
30 Veracruz de Ignacio de la Llave,127,127 La Perla,Total,243,233,10,189
30 Veracruz de Ignacio de la Llave,127,127 La Perla,Total,186,174,12,154
30 Veracruz de Ignacio de la Llave,127,127 La Perla,Total,176,167,9,136
30 Veracruz de Ignacio de la Llave,127,127 La Perla,Total,128,123,5,140
30 Veracruz de Ignacio de la Llave,127,127 La Perla,Total,75,70,5,76
30 Veracruz de Ignacio de la Llave,127,127 La Perla,Total,33,33,0,50
30 Veracruz de Ignacio de la Llave,127,127 La Perla,Total,22,22,0,55
30 Veracruz de Ignacio de la Llave,127,127 La Perla,Hombres,5632,5304,328,1243
30 Veracruz de Ignacio de la Llave,127,127 La Perla,Hombres,282,270,12,655
30 Veracruz de Ignacio de la Llave,127,127 La Perla,Hombres,1004,953,51,276
30 Veracruz de Ignacio de la Llave,127,127 La Perla,Hombres,777,722,55,52
30 Veracruz de Ignacio de la Llave,127,127 La Perla,Hombres,691,638,53,34
30 Veracruz de Ignacio de la Llave,127,127 La Perla,Hombres,614,582,32,35
30 Veracruz de Ignacio de la Llave,127,127 La Perla,Hombres,519,496,23,22
30 Veracruz de Ignacio de la Llave,127,127 La Perla,Hombres,426,399,27,19
30 Veracruz de Ignacio de la Llave,127,127 La Perla,Hombres,367,344,23,14
30 Veracruz de Ignacio de la Llave,127,127 La Perla,Hombres,242,230,12,14
30 Veracruz de Ignacio de la Llave,127,127 La Perla,Hombres,191,181,10,12
30 Veracruz de Ignacio de la Llave,127,127 La Perla,Hombres,156,144,12,20
30 Veracruz de Ignacio de la Llave,127,127 La Perla,Hombres,137,128,9,22
30 Veracruz de Ignacio de la Llave,127,127 La Perla,Hombres,112,107,5,19
30 Veracruz de Ignacio de la Llave,127,127 La Perla,Hombres,64,60,4,17
30 Veracruz de Ignacio de la Llave,127,127 La Perla,Hombres,29,29,0,15
30 Veracruz de Ignacio de la Llave,127,127 La Perla,Hombres,21,21,0,17
30 Veracruz de Ignacio de la Llave,127,127 La Perla,Mujeres,1101,1087,14,6427
30 Veracruz de Ignacio de la Llave,127,127 La Perla,Mujeres,56,55,1,905
30 Veracruz de Ignacio de la Llave,127,127 La Perla,Mujeres,152,150,2,1282
30 Veracruz de Ignacio de la Llave,127,127 La Perla,Mujeres,169,166,3,859
30 Veracruz de Ignacio de la Llave,127,127 La Perla,Mujeres,110,108,2,686
30 Veracruz de Ignacio de la Llave,127,127 La Perla,Mujeres,111,108,3,649
30 Veracruz de Ignacio de la Llave,127,127 La Perla,Mujeres,125,123,2,475
30 Veracruz de Ignacio de la Llave,127,127 La Perla,Mujeres,80,80,0,397
30 Veracruz de Ignacio de la Llave,127,127 La Perla,Mujeres,76,76,0,281
30 Veracruz de Ignacio de la Llave,127,127 La Perla,Mujeres,69,69,0,215
30 Veracruz de Ignacio de la Llave,127,127 La Perla,Mujeres,52,52,0,177
30 Veracruz de Ignacio de la Llave,127,127 La Perla,Mujeres,30,30,0,134
30 Veracruz de Ignacio de la Llave,127,127 La Perla,Mujeres,39,39,0,114
30 Veracruz de Ignacio de la Llave,127,127 La Perla,Mujeres,16,16,0,121
30 Veracruz de Ignacio de la Llave,127,127 La Perla,Mujeres,11,10,1,59
30 Veracruz de Ignacio de la Llave,127,127 La Perla,Mujeres,4,4,0,35
30 Veracruz de Ignacio de la Llave,127,127 La Perla,Mujeres,1,1,0,38
30 Veracruz de Ignacio de la Llave,96,096 Landero y Coss,Total,485,474,11,784
30 Veracruz de Ignacio de la Llave,96,096 Landero y Coss,Total,4,4,0,58
30 Veracruz de Ignacio de la Llave,96,096 Landero y Coss,Total,41,40,1,126
30 Veracruz de Ignacio de la Llave,96,096 Landero y Coss,Total,51,47,4,62
30 Veracruz de Ignacio de la Llave,96,096 Landero y Coss,Total,55,54,1,47
30 Veracruz de Ignacio de la Llave,96,096 Landero y Coss,Total,51,50,1,46
30 Veracruz de Ignacio de la Llave,96,096 Landero y Coss,Total,34,34,0,51
30 Veracruz de Ignacio de la Llave,96,096 Landero y Coss,Total,44,43,1,33
30 Veracruz de Ignacio de la Llave,96,096 Landero y Coss,Total,35,34,1,53
30 Veracruz de Ignacio de la Llave,96,096 Landero y Coss,Total,53,53,0,62
30 Veracruz de Ignacio de la Llave,96,096 Landero y Coss,Total,33,32,1,40
30 Veracruz de Ignacio de la Llave,96,096 Landero y Coss,Total,26,26,0,51
30 Veracruz de Ignacio de la Llave,96,096 Landero y Coss,Total,22,22,0,36
30 Veracruz de Ignacio de la Llave,96,096 Landero y Coss,Total,23,23,0,49
30 Veracruz de Ignacio de la Llave,96,096 Landero y Coss,Total,8,7,1,25
30 Veracruz de Ignacio de la Llave,96,096 Landero y Coss,Total,4,4,0,18
30 Veracruz de Ignacio de la Llave,96,096 Landero y Coss,Total,1,1,0,27
30 Veracruz de Ignacio de la Llave,96,096 Landero y Coss,Hombres,417,408,9,171
30 Veracruz de Ignacio de la Llave,96,096 Landero y Coss,Hombres,3,3,0,24
30 Veracruz de Ignacio de la Llave,96,096 Landero y Coss,Hombres,34,33,1,51
30 Veracruz de Ignacio de la Llave,96,096 Landero y Coss,Hombres,34,32,2,15
30 Veracruz de Ignacio de la Llave,96,096 Landero y Coss,Hombres,43,42,1,6
30 Veracruz de Ignacio de la Llave,96,096 Landero y Coss,Hombres,39,38,1,3
30 Veracruz de Ignacio de la Llave,96,096 Landero y Coss,Hombres,29,29,0,5
30 Veracruz de Ignacio de la Llave,96,096 Landero y Coss,Hombres,42,41,1,5
30 Veracruz de Ignacio de la Llave,96,096 Landero y Coss,Hombres,32,31,1,2
30 Veracruz de Ignacio de la Llave,96,096 Landero y Coss,Hombres,49,49,0,3
30 Veracruz de Ignacio de la Llave,96,096 Landero y Coss,Hombres,29,28,1,3
30 Veracruz de Ignacio de la Llave,96,096 Landero y Coss,Hombres,25,25,0,8
30 Veracruz de Ignacio de la Llave,96,096 Landero y Coss,Hombres,22,22,0,11
30 Veracruz de Ignacio de la Llave,96,096 Landero y Coss,Hombres,23,23,0,10
30 Veracruz de Ignacio de la Llave,96,096 Landero y Coss,Hombres,8,7,1,9
30 Veracruz de Ignacio de la Llave,96,096 Landero y Coss,Hombres,4,4,0,4
30 Veracruz de Ignacio de la Llave,96,096 Landero y Coss,Hombres,1,1,0,12
30 Veracruz de Ignacio de la Llave,96,096 Landero y Coss,Mujeres,68,66,2,613
30 Veracruz de Ignacio de la Llave,96,096 Landero y Coss,Mujeres,1,1,0,34
30 Veracruz de Ignacio de la Llave,96,096 Landero y Coss,Mujeres,7,7,0,75
30 Veracruz de Ignacio de la Llave,96,096 Landero y Coss,Mujeres,17,15,2,47
30 Veracruz de Ignacio de la Llave,96,096 Landero y Coss,Mujeres,12,12,0,41
30 Veracruz de Ignacio de la Llave,96,096 Landero y Coss,Mujeres,12,12,0,43
30 Veracruz de Ignacio de la Llave,96,096 Landero y Coss,Mujeres,5,5,0,46
30 Veracruz de Ignacio de la Llave,96,096 Landero y Coss,Mujeres,2,2,0,28
30 Veracruz de Ignacio de la Llave,96,096 Landero y Coss,Mujeres,3,3,0,51
30 Veracruz de Ignacio de la Llave,96,096 Landero y Coss,Mujeres,4,4,0,59
30 Veracruz de Ignacio de la Llave,96,096 Landero y Coss,Mujeres,4,4,0,37
30 Veracruz de Ignacio de la Llave,96,096 Landero y Coss,Mujeres,1,1,0,43
30 Veracruz de Ignacio de la Llave,96,096 Landero y Coss,Mujeres,0,0,0,25
30 Veracruz de Ignacio de la Llave,96,096 Landero y Coss,Mujeres,0,0,0,39
30 Veracruz de Ignacio de la Llave,96,096 Landero y Coss,Mujeres,0,0,0,16
30 Veracruz de Ignacio de la Llave,96,096 Landero y Coss,Mujeres,0,0,0,14
30 Veracruz de Ignacio de la Llave,96,096 Landero y Coss,Mujeres,0,0,0,15
30 Veracruz de Ignacio de la Llave,61,061 Las Choapas,Total,25827,24987,840,29281
30 Veracruz de Ignacio de la Llave,61,061 Las Choapas,Total,612,598,14,5012
30 Veracruz de Ignacio de la Llave,61,061 Las Choapas,Total,2868,2731,137,6015
30 Veracruz de Ignacio de la Llave,61,061 Las Choapas,Total,3327,3191,136,3050
30 Veracruz de Ignacio de la Llave,61,061 Las Choapas,Total,3043,2926,117,2187
30 Veracruz de Ignacio de la Llave,61,061 Las Choapas,Total,2816,2727,89,1973
30 Veracruz de Ignacio de la Llave,61,061 Las Choapas,Total,2778,2702,76,1808
30 Veracruz de Ignacio de la Llave,61,061 Las Choapas,Total,2561,2507,54,1549
30 Veracruz de Ignacio de la Llave,61,061 Las Choapas,Total,2313,2270,43,1320
30 Veracruz de Ignacio de la Llave,61,061 Las Choapas,Total,1775,1726,49,1238
30 Veracruz de Ignacio de la Llave,61,061 Las Choapas,Total,1238,1205,33,1178
30 Veracruz de Ignacio de la Llave,61,061 Las Choapas,Total,958,926,32,1091
30 Veracruz de Ignacio de la Llave,61,061 Las Choapas,Total,634,608,26,910
30 Veracruz de Ignacio de la Llave,61,061 Las Choapas,Total,492,474,18,777
30 Veracruz de Ignacio de la Llave,61,061 Las Choapas,Total,231,218,13,496
30 Veracruz de Ignacio de la Llave,61,061 Las Choapas,Total,105,103,2,324
30 Veracruz de Ignacio de la Llave,61,061 Las Choapas,Total,76,75,1,353
30 Veracruz de Ignacio de la Llave,61,061 Las Choapas,Hombres,20163,19476,687,6511
30 Veracruz de Ignacio de la Llave,61,061 Las Choapas,Hombres,545,535,10,2378
30 Veracruz de Ignacio de la Llave,61,061 Las Choapas,Hombres,2413,2307,106,2039
30 Veracruz de Ignacio de la Llave,61,061 Las Choapas,Hombres,2570,2475,95,435
30 Veracruz de Ignacio de la Llave,61,061 Las Choapas,Hombres,2260,2170,90,111
30 Veracruz de Ignacio de la Llave,61,061 Las Choapas,Hombres,2093,2023,70,63
30 Veracruz de Ignacio de la Llave,61,061 Las Choapas,Hombres,2108,2043,65,45
30 Veracruz de Ignacio de la Llave,61,061 Las Choapas,Hombres,1888,1842,46,48
30 Veracruz de Ignacio de la Llave,61,061 Las Choapas,Hombres,1732,1694,38,60
30 Veracruz de Ignacio de la Llave,61,061 Las Choapas,Hombres,1384,1338,46,70
30 Veracruz de Ignacio de la Llave,61,061 Las Choapas,Hombres,999,967,32,168
30 Veracruz de Ignacio de la Llave,61,061 Las Choapas,Hombres,805,775,30,226
30 Veracruz de Ignacio de la Llave,61,061 Las Choapas,Hombres,555,529,26,217
30 Veracruz de Ignacio de la Llave,61,061 Las Choapas,Hombres,436,418,18,214
30 Veracruz de Ignacio de la Llave,61,061 Las Choapas,Hombres,212,200,12,156
30 Veracruz de Ignacio de la Llave,61,061 Las Choapas,Hombres,91,89,2,131
30 Veracruz de Ignacio de la Llave,61,061 Las Choapas,Hombres,72,71,1,150
30 Veracruz de Ignacio de la Llave,61,061 Las Choapas,Mujeres,5664,5511,153,22770
30 Veracruz de Ignacio de la Llave,61,061 Las Choapas,Mujeres,67,63,4,2634
30 Veracruz de Ignacio de la Llave,61,061 Las Choapas,Mujeres,455,424,31,3976
30 Veracruz de Ignacio de la Llave,61,061 Las Choapas,Mujeres,757,716,41,2615
30 Veracruz de Ignacio de la Llave,61,061 Las Choapas,Mujeres,783,756,27,2076
30 Veracruz de Ignacio de la Llave,61,061 Las Choapas,Mujeres,723,704,19,1910
30 Veracruz de Ignacio de la Llave,61,061 Las Choapas,Mujeres,670,659,11,1763
30 Veracruz de Ignacio de la Llave,61,061 Las Choapas,Mujeres,673,665,8,1501
30 Veracruz de Ignacio de la Llave,61,061 Las Choapas,Mujeres,581,576,5,1260
30 Veracruz de Ignacio de la Llave,61,061 Las Choapas,Mujeres,391,388,3,1168
30 Veracruz de Ignacio de la Llave,61,061 Las Choapas,Mujeres,239,238,1,1010
30 Veracruz de Ignacio de la Llave,61,061 Las Choapas,Mujeres,153,151,2,865
30 Veracruz de Ignacio de la Llave,61,061 Las Choapas,Mujeres,79,79,0,693
30 Veracruz de Ignacio de la Llave,61,061 Las Choapas,Mujeres,56,56,0,563
30 Veracruz de Ignacio de la Llave,61,061 Las Choapas,Mujeres,19,18,1,340
30 Veracruz de Ignacio de la Llave,61,061 Las Choapas,Mujeres,14,14,0,193
30 Veracruz de Ignacio de la Llave,61,061 Las Choapas,Mujeres,4,4,0,203
30 Veracruz de Ignacio de la Llave,107,107 Las Minas,Total,737,669,68,1175
30 Veracruz de Ignacio de la Llave,107,107 Las Minas,Total,22,21,1,188
30 Veracruz de Ignacio de la Llave,107,107 Las Minas,Total,96,83,13,222
30 Veracruz de Ignacio de la Llave,107,107 Las Minas,Total,116,101,15,109
30 Veracruz de Ignacio de la Llave,107,107 Las Minas,Total,95,86,9,106
30 Veracruz de Ignacio de la Llave,107,107 Las Minas,Total,92,83,9,97
30 Veracruz de Ignacio de la Llave,107,107 Las Minas,Total,74,70,4,90
30 Veracruz de Ignacio de la Llave,107,107 Las Minas,Total,51,46,5,59
30 Veracruz de Ignacio de la Llave,107,107 Las Minas,Total,42,37,5,52
30 Veracruz de Ignacio de la Llave,107,107 Las Minas,Total,31,29,2,44
30 Veracruz de Ignacio de la Llave,107,107 Las Minas,Total,40,38,2,37
30 Veracruz de Ignacio de la Llave,107,107 Las Minas,Total,31,29,2,55
30 Veracruz de Ignacio de la Llave,107,107 Las Minas,Total,25,24,1,34
30 Veracruz de Ignacio de la Llave,107,107 Las Minas,Total,13,13,0,28
30 Veracruz de Ignacio de la Llave,107,107 Las Minas,Total,6,6,0,21
30 Veracruz de Ignacio de la Llave,107,107 Las Minas,Total,3,3,0,11
30 Veracruz de Ignacio de la Llave,107,107 Las Minas,Total,0,0,0,22
30 Veracruz de Ignacio de la Llave,107,107 Las Minas,Hombres,672,605,67,293
30 Veracruz de Ignacio de la Llave,107,107 Las Minas,Hombres,21,20,1,87
30 Veracruz de Ignacio de la Llave,107,107 Las Minas,Hombres,85,73,12,84
30 Veracruz de Ignacio de la Llave,107,107 Las Minas,Hombres,104,89,15,12
30 Veracruz de Ignacio de la Llave,107,107 Las Minas,Hombres,87,78,9,8
30 Veracruz de Ignacio de la Llave,107,107 Las Minas,Hombres,88,79,9,12
30 Veracruz de Ignacio de la Llave,107,107 Las Minas,Hombres,72,68,4,12
30 Veracruz de Ignacio de la Llave,107,107 Las Minas,Hombres,45,40,5,9
30 Veracruz de Ignacio de la Llave,107,107 Las Minas,Hombres,40,35,5,9
30 Veracruz de Ignacio de la Llave,107,107 Las Minas,Hombres,25,23,2,8
30 Veracruz de Ignacio de la Llave,107,107 Las Minas,Hombres,33,31,2,8
30 Veracruz de Ignacio de la Llave,107,107 Las Minas,Hombres,29,27,2,7
30 Veracruz de Ignacio de la Llave,107,107 Las Minas,Hombres,23,22,1,11
30 Veracruz de Ignacio de la Llave,107,107 Las Minas,Hombres,12,12,0,9
30 Veracruz de Ignacio de la Llave,107,107 Las Minas,Hombres,5,5,0,5
30 Veracruz de Ignacio de la Llave,107,107 Las Minas,Hombres,3,3,0,1
30 Veracruz de Ignacio de la Llave,107,107 Las Minas,Hombres,0,0,0,11
30 Veracruz de Ignacio de la Llave,107,107 Las Minas,Mujeres,65,64,1,882
30 Veracruz de Ignacio de la Llave,107,107 Las Minas,Mujeres,1,1,0,101
30 Veracruz de Ignacio de la Llave,107,107 Las Minas,Mujeres,11,10,1,138
30 Veracruz de Ignacio de la Llave,107,107 Las Minas,Mujeres,12,12,0,97
30 Veracruz de Ignacio de la Llave,107,107 Las Minas,Mujeres,8,8,0,98
30 Veracruz de Ignacio de la Llave,107,107 Las Minas,Mujeres,4,4,0,85
30 Veracruz de Ignacio de la Llave,107,107 Las Minas,Mujeres,2,2,0,78
30 Veracruz de Ignacio de la Llave,107,107 Las Minas,Mujeres,6,6,0,50
30 Veracruz de Ignacio de la Llave,107,107 Las Minas,Mujeres,2,2,0,43
30 Veracruz de Ignacio de la Llave,107,107 Las Minas,Mujeres,6,6,0,36
30 Veracruz de Ignacio de la Llave,107,107 Las Minas,Mujeres,7,7,0,29
30 Veracruz de Ignacio de la Llave,107,107 Las Minas,Mujeres,2,2,0,48
30 Veracruz de Ignacio de la Llave,107,107 Las Minas,Mujeres,2,2,0,23
30 Veracruz de Ignacio de la Llave,107,107 Las Minas,Mujeres,1,1,0,19
30 Veracruz de Ignacio de la Llave,107,107 Las Minas,Mujeres,1,1,0,16
30 Veracruz de Ignacio de la Llave,107,107 Las Minas,Mujeres,0,0,0,10
30 Veracruz de Ignacio de la Llave,107,107 Las Minas,Mujeres,0,0,0,11
30 Veracruz de Ignacio de la Llave,132,132 Las Vigas de Ramírez,Total,6265,6082,183,6692
30 Veracruz de Ignacio de la Llave,132,132 Las Vigas de Ramírez,Total,67,67,0,1015
30 Veracruz de Ignacio de la Llave,132,132 Las Vigas de Ramírez,Total,687,661,26,1216
30 Veracruz de Ignacio de la Llave,132,132 Las Vigas de Ramírez,Total,924,894,30,783
30 Veracruz de Ignacio de la Llave,132,132 Las Vigas de Ramírez,Total,897,868,29,596
30 Veracruz de Ignacio de la Llave,132,132 Las Vigas de Ramírez,Total,777,758,19,545
30 Veracruz de Ignacio de la Llave,132,132 Las Vigas de Ramírez,Total,768,750,18,466
30 Veracruz de Ignacio de la Llave,132,132 Las Vigas de Ramírez,Total,604,585,19,372
30 Veracruz de Ignacio de la Llave,132,132 Las Vigas de Ramírez,Total,483,470,13,321
30 Veracruz de Ignacio de la Llave,132,132 Las Vigas de Ramírez,Total,367,355,12,259
30 Veracruz de Ignacio de la Llave,132,132 Las Vigas de Ramírez,Total,228,224,4,206
30 Veracruz de Ignacio de la Llave,132,132 Las Vigas de Ramírez,Total,170,164,6,202
30 Veracruz de Ignacio de la Llave,132,132 Las Vigas de Ramírez,Total,107,104,3,204
30 Veracruz de Ignacio de la Llave,132,132 Las Vigas de Ramírez,Total,98,95,3,164
30 Veracruz de Ignacio de la Llave,132,132 Las Vigas de Ramírez,Total,43,43,0,137
30 Veracruz de Ignacio de la Llave,132,132 Las Vigas de Ramírez,Total,23,22,1,94
30 Veracruz de Ignacio de la Llave,132,132 Las Vigas de Ramírez,Total,22,22,0,112
30 Veracruz de Ignacio de la Llave,132,132 Las Vigas de Ramírez,Hombres,5010,4842,168,1312
30 Veracruz de Ignacio de la Llave,132,132 Las Vigas de Ramírez,Hombres,58,58,0,466
30 Veracruz de Ignacio de la Llave,132,132 Las Vigas de Ramírez,Hombres,576,552,24,379
30 Veracruz de Ignacio de la Llave,132,132 Las Vigas de Ramírez,Hombres,753,726,27,107
30 Veracruz de Ignacio de la Llave,132,132 Las Vigas de Ramírez,Hombres,724,700,24,26
30 Veracruz de Ignacio de la Llave,132,132 Las Vigas de Ramírez,Hombres,616,598,18,15
30 Veracruz de Ignacio de la Llave,132,132 Las Vigas de Ramírez,Hombres,591,574,17,10
30 Veracruz de Ignacio de la Llave,132,132 Las Vigas de Ramírez,Hombres,460,442,18,22
30 Veracruz de Ignacio de la Llave,132,132 Las Vigas de Ramírez,Hombres,380,368,12,14
30 Veracruz de Ignacio de la Llave,132,132 Las Vigas de Ramírez,Hombres,282,270,12,23
30 Veracruz de Ignacio de la Llave,132,132 Las Vigas de Ramírez,Hombres,178,175,3,29
30 Veracruz de Ignacio de la Llave,132,132 Las Vigas de Ramírez,Hombres,137,131,6,36
30 Veracruz de Ignacio de la Llave,132,132 Las Vigas de Ramírez,Hombres,93,90,3,42
30 Veracruz de Ignacio de la Llave,132,132 Las Vigas de Ramírez,Hombres,88,85,3,42
30 Veracruz de Ignacio de la Llave,132,132 Las Vigas de Ramírez,Hombres,39,39,0,43
30 Veracruz de Ignacio de la Llave,132,132 Las Vigas de Ramírez,Hombres,15,14,1,23
30 Veracruz de Ignacio de la Llave,132,132 Las Vigas de Ramírez,Hombres,20,20,0,35
30 Veracruz de Ignacio de la Llave,132,132 Las Vigas de Ramírez,Mujeres,1255,1240,15,5380
30 Veracruz de Ignacio de la Llave,132,132 Las Vigas de Ramírez,Mujeres,9,9,0,549
30 Veracruz de Ignacio de la Llave,132,132 Las Vigas de Ramírez,Mujeres,111,109,2,837
30 Veracruz de Ignacio de la Llave,132,132 Las Vigas de Ramírez,Mujeres,171,168,3,676
30 Veracruz de Ignacio de la Llave,132,132 Las Vigas de Ramírez,Mujeres,173,168,5,570
30 Veracruz de Ignacio de la Llave,132,132 Las Vigas de Ramírez,Mujeres,161,160,1,530
30 Veracruz de Ignacio de la Llave,132,132 Las Vigas de Ramírez,Mujeres,177,176,1,456
30 Veracruz de Ignacio de la Llave,132,132 Las Vigas de Ramírez,Mujeres,144,143,1,350
30 Veracruz de Ignacio de la Llave,132,132 Las Vigas de Ramírez,Mujeres,103,102,1,307
30 Veracruz de Ignacio de la Llave,132,132 Las Vigas de Ramírez,Mujeres,85,85,0,236
30 Veracruz de Ignacio de la Llave,132,132 Las Vigas de Ramírez,Mujeres,50,49,1,177
30 Veracruz de Ignacio de la Llave,132,132 Las Vigas de Ramírez,Mujeres,33,33,0,166
30 Veracruz de Ignacio de la Llave,132,132 Las Vigas de Ramírez,Mujeres,14,14,0,162
30 Veracruz de Ignacio de la Llave,132,132 Las Vigas de Ramírez,Mujeres,10,10,0,122
30 Veracruz de Ignacio de la Llave,132,132 Las Vigas de Ramírez,Mujeres,4,4,0,94
30 Veracruz de Ignacio de la Llave,132,132 Las Vigas de Ramírez,Mujeres,8,8,0,71
30 Veracruz de Ignacio de la Llave,132,132 Las Vigas de Ramírez,Mujeres,2,2,0,77
30 Veracruz de Ignacio de la Llave,97,097 Lerdo de Tejada,Total,7232,6866,366,8940
30 Veracruz de Ignacio de la Llave,97,097 Lerdo de Tejada,Total,28,25,3,1016
30 Veracruz de Ignacio de la Llave,97,097 Lerdo de Tejada,Total,351,303,48,1375
30 Veracruz de Ignacio de la Llave,97,097 Lerdo de Tejada,Total,733,666,67,709
30 Veracruz de Ignacio de la Llave,97,097 Lerdo de Tejada,Total,812,759,53,436
30 Veracruz de Ignacio de la Llave,97,097 Lerdo de Tejada,Total,834,797,37,422
30 Veracruz de Ignacio de la Llave,97,097 Lerdo de Tejada,Total,921,868,53,519
30 Veracruz de Ignacio de la Llave,97,097 Lerdo de Tejada,Total,936,896,40,490
30 Veracruz de Ignacio de la Llave,97,097 Lerdo de Tejada,Total,832,811,21,454
30 Veracruz de Ignacio de la Llave,97,097 Lerdo de Tejada,Total,749,731,18,528
30 Veracruz de Ignacio de la Llave,97,097 Lerdo de Tejada,Total,518,507,11,519
30 Veracruz de Ignacio de la Llave,97,097 Lerdo de Tejada,Total,233,229,4,687
30 Veracruz de Ignacio de la Llave,97,097 Lerdo de Tejada,Total,132,126,6,539
30 Veracruz de Ignacio de la Llave,97,097 Lerdo de Tejada,Total,94,91,3,510
30 Veracruz de Ignacio de la Llave,97,097 Lerdo de Tejada,Total,40,39,1,352
30 Veracruz de Ignacio de la Llave,97,097 Lerdo de Tejada,Total,14,13,1,191
30 Veracruz de Ignacio de la Llave,97,097 Lerdo de Tejada,Total,5,5,0,193
30 Veracruz de Ignacio de la Llave,97,097 Lerdo de Tejada,Hombres,4894,4581,313,2587
30 Veracruz de Ignacio de la Llave,97,097 Lerdo de Tejada,Hombres,24,21,3,503
30 Veracruz de Ignacio de la Llave,97,097 Lerdo de Tejada,Hombres,261,221,40,585
30 Veracruz de Ignacio de la Llave,97,097 Lerdo de Tejada,Hombres,523,466,57,204
30 Veracruz de Ignacio de la Llave,97,097 Lerdo de Tejada,Hombres,508,465,43,55
30 Veracruz de Ignacio de la Llave,97,097 Lerdo de Tejada,Hombres,508,482,26,31
30 Veracruz de Ignacio de la Llave,97,097 Lerdo de Tejada,Hombres,591,546,45,38
30 Veracruz de Ignacio de la Llave,97,097 Lerdo de Tejada,Hombres,601,562,39,31
30 Veracruz de Ignacio de la Llave,97,097 Lerdo de Tejada,Hombres,558,541,17,37
30 Veracruz de Ignacio de la Llave,97,097 Lerdo de Tejada,Hombres,542,524,18,53
30 Veracruz de Ignacio de la Llave,97,097 Lerdo de Tejada,Hombres,399,389,10,69
30 Veracruz de Ignacio de la Llave,97,097 Lerdo de Tejada,Hombres,166,162,4,259
30 Veracruz de Ignacio de la Llave,97,097 Lerdo de Tejada,Hombres,103,97,6,195
30 Veracruz de Ignacio de la Llave,97,097 Lerdo de Tejada,Hombres,63,60,3,219
30 Veracruz de Ignacio de la Llave,97,097 Lerdo de Tejada,Hombres,31,30,1,154
30 Veracruz de Ignacio de la Llave,97,097 Lerdo de Tejada,Hombres,12,11,1,75
30 Veracruz de Ignacio de la Llave,97,097 Lerdo de Tejada,Hombres,4,4,0,79
30 Veracruz de Ignacio de la Llave,97,097 Lerdo de Tejada,Mujeres,2338,2285,53,6353
30 Veracruz de Ignacio de la Llave,97,097 Lerdo de Tejada,Mujeres,4,4,0,513
30 Veracruz de Ignacio de la Llave,97,097 Lerdo de Tejada,Mujeres,90,82,8,790
30 Veracruz de Ignacio de la Llave,97,097 Lerdo de Tejada,Mujeres,210,200,10,505
30 Veracruz de Ignacio de la Llave,97,097 Lerdo de Tejada,Mujeres,304,294,10,381
30 Veracruz de Ignacio de la Llave,97,097 Lerdo de Tejada,Mujeres,326,315,11,391
30 Veracruz de Ignacio de la Llave,97,097 Lerdo de Tejada,Mujeres,330,322,8,481
30 Veracruz de Ignacio de la Llave,97,097 Lerdo de Tejada,Mujeres,335,334,1,459
30 Veracruz de Ignacio de la Llave,97,097 Lerdo de Tejada,Mujeres,274,270,4,417
30 Veracruz de Ignacio de la Llave,97,097 Lerdo de Tejada,Mujeres,207,207,0,475
30 Veracruz de Ignacio de la Llave,97,097 Lerdo de Tejada,Mujeres,119,118,1,450
30 Veracruz de Ignacio de la Llave,97,097 Lerdo de Tejada,Mujeres,67,67,0,428
30 Veracruz de Ignacio de la Llave,97,097 Lerdo de Tejada,Mujeres,29,29,0,344
30 Veracruz de Ignacio de la Llave,97,097 Lerdo de Tejada,Mujeres,31,31,0,291
30 Veracruz de Ignacio de la Llave,97,097 Lerdo de Tejada,Mujeres,9,9,0,198
30 Veracruz de Ignacio de la Llave,97,097 Lerdo de Tejada,Mujeres,2,2,0,116
30 Veracruz de Ignacio de la Llave,97,097 Lerdo de Tejada,Mujeres,1,1,0,114
30 Veracruz de Ignacio de la Llave,137,137 Los Reyes,Total,1588,1542,46,2173
30 Veracruz de Ignacio de la Llave,137,137 Los Reyes,Total,25,25,0,395
30 Veracruz de Ignacio de la Llave,137,137 Los Reyes,Total,179,171,8,410
30 Veracruz de Ignacio de la Llave,137,137 Los Reyes,Total,246,236,10,278
30 Veracruz de Ignacio de la Llave,137,137 Los Reyes,Total,220,216,4,185
30 Veracruz de Ignacio de la Llave,137,137 Los Reyes,Total,180,171,9,200
30 Veracruz de Ignacio de la Llave,137,137 Los Reyes,Total,186,180,6,138
30 Veracruz de Ignacio de la Llave,137,137 Los Reyes,Total,108,107,1,97
30 Veracruz de Ignacio de la Llave,137,137 Los Reyes,Total,97,96,1,89
30 Veracruz de Ignacio de la Llave,137,137 Los Reyes,Total,97,93,4,84
30 Veracruz de Ignacio de la Llave,137,137 Los Reyes,Total,99,98,1,55
30 Veracruz de Ignacio de la Llave,137,137 Los Reyes,Total,56,56,0,62
30 Veracruz de Ignacio de la Llave,137,137 Los Reyes,Total,46,45,1,55
30 Veracruz de Ignacio de la Llave,137,137 Los Reyes,Total,28,28,0,63
30 Veracruz de Ignacio de la Llave,137,137 Los Reyes,Total,15,14,1,23
30 Veracruz de Ignacio de la Llave,137,137 Los Reyes,Total,4,4,0,16
30 Veracruz de Ignacio de la Llave,137,137 Los Reyes,Total,2,2,0,23
30 Veracruz de Ignacio de la Llave,137,137 Los Reyes,Hombres,1297,1251,46,554
30 Veracruz de Ignacio de la Llave,137,137 Los Reyes,Hombres,16,16,0,191
30 Veracruz de Ignacio de la Llave,137,137 Los Reyes,Hombres,143,135,8,148
30 Veracruz de Ignacio de la Llave,137,137 Los Reyes,Hombres,213,203,10,55
30 Veracruz de Ignacio de la Llave,137,137 Los Reyes,Hombres,181,177,4,20
30 Veracruz de Ignacio de la Llave,137,137 Los Reyes,Hombres,142,133,9,26
30 Veracruz de Ignacio de la Llave,137,137 Los Reyes,Hombres,151,145,6,14
30 Veracruz de Ignacio de la Llave,137,137 Los Reyes,Hombres,83,82,1,14
30 Veracruz de Ignacio de la Llave,137,137 Los Reyes,Hombres,82,81,1,13
30 Veracruz de Ignacio de la Llave,137,137 Los Reyes,Hombres,83,79,4,13
30 Veracruz de Ignacio de la Llave,137,137 Los Reyes,Hombres,76,75,1,8
30 Veracruz de Ignacio de la Llave,137,137 Los Reyes,Hombres,45,45,0,8
30 Veracruz de Ignacio de la Llave,137,137 Los Reyes,Hombres,42,41,1,11
30 Veracruz de Ignacio de la Llave,137,137 Los Reyes,Hombres,23,23,0,15
30 Veracruz de Ignacio de la Llave,137,137 Los Reyes,Hombres,12,11,1,5
30 Veracruz de Ignacio de la Llave,137,137 Los Reyes,Hombres,3,3,0,7
30 Veracruz de Ignacio de la Llave,137,137 Los Reyes,Hombres,2,2,0,6
30 Veracruz de Ignacio de la Llave,137,137 Los Reyes,Mujeres,291,291,0,1619
30 Veracruz de Ignacio de la Llave,137,137 Los Reyes,Mujeres,9,9,0,204
30 Veracruz de Ignacio de la Llave,137,137 Los Reyes,Mujeres,36,36,0,262
30 Veracruz de Ignacio de la Llave,137,137 Los Reyes,Mujeres,33,33,0,223
30 Veracruz de Ignacio de la Llave,137,137 Los Reyes,Mujeres,39,39,0,165
30 Veracruz de Ignacio de la Llave,137,137 Los Reyes,Mujeres,38,38,0,174
30 Veracruz de Ignacio de la Llave,137,137 Los Reyes,Mujeres,35,35,0,124
30 Veracruz de Ignacio de la Llave,137,137 Los Reyes,Mujeres,25,25,0,83
30 Veracruz de Ignacio de la Llave,137,137 Los Reyes,Mujeres,15,15,0,76
30 Veracruz de Ignacio de la Llave,137,137 Los Reyes,Mujeres,14,14,0,71
30 Veracruz de Ignacio de la Llave,137,137 Los Reyes,Mujeres,23,23,0,47
30 Veracruz de Ignacio de la Llave,137,137 Los Reyes,Mujeres,11,11,0,54
30 Veracruz de Ignacio de la Llave,137,137 Los Reyes,Mujeres,4,4,0,44
30 Veracruz de Ignacio de la Llave,137,137 Los Reyes,Mujeres,5,5,0,48
30 Veracruz de Ignacio de la Llave,137,137 Los Reyes,Mujeres,3,3,0,18
30 Veracruz de Ignacio de la Llave,137,137 Los Reyes,Mujeres,1,1,0,9
30 Veracruz de Ignacio de la Llave,137,137 Los Reyes,Mujeres,0,0,0,17
30 Veracruz de Ignacio de la Llave,98,098 Magdalena,Total,898,854,44,1119
30 Veracruz de Ignacio de la Llave,98,098 Magdalena,Total,5,5,0,212
30 Veracruz de Ignacio de la Llave,98,098 Magdalena,Total,105,98,7,225
30 Veracruz de Ignacio de la Llave,98,098 Magdalena,Total,141,131,10,134
30 Veracruz de Ignacio de la Llave,98,098 Magdalena,Total,117,114,3,108
30 Veracruz de Ignacio de la Llave,98,098 Magdalena,Total,119,115,4,72
30 Veracruz de Ignacio de la Llave,98,098 Magdalena,Total,87,84,3,71
30 Veracruz de Ignacio de la Llave,98,098 Magdalena,Total,80,78,2,38
30 Veracruz de Ignacio de la Llave,98,098 Magdalena,Total,50,48,2,55
30 Veracruz de Ignacio de la Llave,98,098 Magdalena,Total,55,50,5,45
30 Veracruz de Ignacio de la Llave,98,098 Magdalena,Total,49,47,2,48
30 Veracruz de Ignacio de la Llave,98,098 Magdalena,Total,41,38,3,25
30 Veracruz de Ignacio de la Llave,98,098 Magdalena,Total,22,21,1,23
30 Veracruz de Ignacio de la Llave,98,098 Magdalena,Total,19,17,2,27
30 Veracruz de Ignacio de la Llave,98,098 Magdalena,Total,7,7,0,20
30 Veracruz de Ignacio de la Llave,98,098 Magdalena,Total,1,1,0,9
30 Veracruz de Ignacio de la Llave,98,098 Magdalena,Total,0,0,0,7
30 Veracruz de Ignacio de la Llave,98,098 Magdalena,Hombres,714,675,39,287
30 Veracruz de Ignacio de la Llave,98,098 Magdalena,Hombres,5,5,0,107
30 Veracruz de Ignacio de la Llave,98,098 Magdalena,Hombres,86,79,7,83
30 Veracruz de Ignacio de la Llave,98,098 Magdalena,Hombres,105,96,9,27
30 Veracruz de Ignacio de la Llave,98,098 Magdalena,Hombres,96,94,2,16
30 Veracruz de Ignacio de la Llave,98,098 Magdalena,Hombres,95,92,3,3
30 Veracruz de Ignacio de la Llave,98,098 Magdalena,Hombres,58,55,3,4
30 Veracruz de Ignacio de la Llave,98,098 Magdalena,Hombres,66,64,2,2
30 Veracruz de Ignacio de la Llave,98,098 Magdalena,Hombres,41,39,2,7
30 Veracruz de Ignacio de la Llave,98,098 Magdalena,Hombres,42,38,4,8
30 Veracruz de Ignacio de la Llave,98,098 Magdalena,Hombres,42,40,2,5
30 Veracruz de Ignacio de la Llave,98,098 Magdalena,Hombres,35,32,3,4
30 Veracruz de Ignacio de la Llave,98,098 Magdalena,Hombres,18,17,1,1
30 Veracruz de Ignacio de la Llave,98,098 Magdalena,Hombres,17,16,1,10
30 Veracruz de Ignacio de la Llave,98,098 Magdalena,Hombres,7,7,0,6
30 Veracruz de Ignacio de la Llave,98,098 Magdalena,Hombres,1,1,0,1
30 Veracruz de Ignacio de la Llave,98,098 Magdalena,Hombres,0,0,0,3
30 Veracruz de Ignacio de la Llave,98,098 Magdalena,Mujeres,184,179,5,832
30 Veracruz de Ignacio de la Llave,98,098 Magdalena,Mujeres,0,0,0,105
30 Veracruz de Ignacio de la Llave,98,098 Magdalena,Mujeres,19,19,0,142
30 Veracruz de Ignacio de la Llave,98,098 Magdalena,Mujeres,36,35,1,107
30 Veracruz de Ignacio de la Llave,98,098 Magdalena,Mujeres,21,20,1,92
30 Veracruz de Ignacio de la Llave,98,098 Magdalena,Mujeres,24,23,1,69
30 Veracruz de Ignacio de la Llave,98,098 Magdalena,Mujeres,29,29,0,67
30 Veracruz de Ignacio de la Llave,98,098 Magdalena,Mujeres,14,14,0,36
30 Veracruz de Ignacio de la Llave,98,098 Magdalena,Mujeres,9,9,0,48
30 Veracruz de Ignacio de la Llave,98,098 Magdalena,Mujeres,13,12,1,37
30 Veracruz de Ignacio de la Llave,98,098 Magdalena,Mujeres,7,7,0,43
30 Veracruz de Ignacio de la Llave,98,098 Magdalena,Mujeres,6,6,0,21
30 Veracruz de Ignacio de la Llave,98,098 Magdalena,Mujeres,4,4,0,22
30 Veracruz de Ignacio de la Llave,98,098 Magdalena,Mujeres,2,1,1,17
30 Veracruz de Ignacio de la Llave,98,098 Magdalena,Mujeres,0,0,0,14
30 Veracruz de Ignacio de la Llave,98,098 Magdalena,Mujeres,0,0,0,8
30 Veracruz de Ignacio de la Llave,98,098 Magdalena,Mujeres,0,0,0,4
30 Veracruz de Ignacio de la Llave,99,099 Maltrata,Total,5430,5244,186,6810
30 Veracruz de Ignacio de la Llave,99,099 Maltrata,Total,70,66,4,1089
30 Veracruz de Ignacio de la Llave,99,099 Maltrata,Total,628,597,31,1382
30 Veracruz de Ignacio de la Llave,99,099 Maltrata,Total,806,765,41,711
30 Veracruz de Ignacio de la Llave,99,099 Maltrata,Total,685,660,25,506
30 Veracruz de Ignacio de la Llave,99,099 Maltrata,Total,613,598,15,479
30 Veracruz de Ignacio de la Llave,99,099 Maltrata,Total,579,565,14,402
30 Veracruz de Ignacio de la Llave,99,099 Maltrata,Total,536,529,7,394
30 Veracruz de Ignacio de la Llave,99,099 Maltrata,Total,438,427,11,341
30 Veracruz de Ignacio de la Llave,99,099 Maltrata,Total,297,284,13,299
30 Veracruz de Ignacio de la Llave,99,099 Maltrata,Total,227,221,6,231
30 Veracruz de Ignacio de la Llave,99,099 Maltrata,Total,183,173,10,219
30 Veracruz de Ignacio de la Llave,99,099 Maltrata,Total,117,116,1,179
30 Veracruz de Ignacio de la Llave,99,099 Maltrata,Total,111,110,1,201
30 Veracruz de Ignacio de la Llave,99,099 Maltrata,Total,78,73,5,146
30 Veracruz de Ignacio de la Llave,99,099 Maltrata,Total,42,42,0,115
30 Veracruz de Ignacio de la Llave,99,099 Maltrata,Total,20,18,2,116
30 Veracruz de Ignacio de la Llave,99,099 Maltrata,Hombres,4252,4095,157,1500
30 Veracruz de Ignacio de la Llave,99,099 Maltrata,Hombres,54,52,2,527
30 Veracruz de Ignacio de la Llave,99,099 Maltrata,Hombres,517,490,27,474
30 Veracruz de Ignacio de la Llave,99,099 Maltrata,Hombres,615,586,29,97
30 Veracruz de Ignacio de la Llave,99,099 Maltrata,Hombres,518,497,21,27
30 Veracruz de Ignacio de la Llave,99,099 Maltrata,Hombres,466,453,13,17
30 Veracruz de Ignacio de la Llave,99,099 Maltrata,Hombres,432,419,13,12
30 Veracruz de Ignacio de la Llave,99,099 Maltrata,Hombres,437,431,6,17
30 Veracruz de Ignacio de la Llave,99,099 Maltrata,Hombres,335,325,10,26
30 Veracruz de Ignacio de la Llave,99,099 Maltrata,Hombres,231,219,12,26
30 Veracruz de Ignacio de la Llave,99,099 Maltrata,Hombres,183,177,6,27
30 Veracruz de Ignacio de la Llave,99,099 Maltrata,Hombres,151,141,10,46
30 Veracruz de Ignacio de la Llave,99,099 Maltrata,Hombres,95,94,1,32
30 Veracruz de Ignacio de la Llave,99,099 Maltrata,Hombres,94,93,1,57
30 Veracruz de Ignacio de la Llave,99,099 Maltrata,Hombres,69,64,5,47
30 Veracruz de Ignacio de la Llave,99,099 Maltrata,Hombres,38,38,0,27
30 Veracruz de Ignacio de la Llave,99,099 Maltrata,Hombres,17,16,1,41
30 Veracruz de Ignacio de la Llave,99,099 Maltrata,Mujeres,1178,1149,29,5310
30 Veracruz de Ignacio de la Llave,99,099 Maltrata,Mujeres,16,14,2,562
30 Veracruz de Ignacio de la Llave,99,099 Maltrata,Mujeres,111,107,4,908
30 Veracruz de Ignacio de la Llave,99,099 Maltrata,Mujeres,191,179,12,614
30 Veracruz de Ignacio de la Llave,99,099 Maltrata,Mujeres,167,163,4,479
30 Veracruz de Ignacio de la Llave,99,099 Maltrata,Mujeres,147,145,2,462
30 Veracruz de Ignacio de la Llave,99,099 Maltrata,Mujeres,147,146,1,390
30 Veracruz de Ignacio de la Llave,99,099 Maltrata,Mujeres,99,98,1,377
30 Veracruz de Ignacio de la Llave,99,099 Maltrata,Mujeres,103,102,1,315
30 Veracruz de Ignacio de la Llave,99,099 Maltrata,Mujeres,66,65,1,273
30 Veracruz de Ignacio de la Llave,99,099 Maltrata,Mujeres,44,44,0,204
30 Veracruz de Ignacio de la Llave,99,099 Maltrata,Mujeres,32,32,0,173
30 Veracruz de Ignacio de la Llave,99,099 Maltrata,Mujeres,22,22,0,147
30 Veracruz de Ignacio de la Llave,99,099 Maltrata,Mujeres,17,17,0,144
30 Veracruz de Ignacio de la Llave,99,099 Maltrata,Mujeres,9,9,0,99
30 Veracruz de Ignacio de la Llave,99,099 Maltrata,Mujeres,4,4,0,88
30 Veracruz de Ignacio de la Llave,99,099 Maltrata,Mujeres,3,2,1,75
30 Veracruz de Ignacio de la Llave,100,100 Manlio Fabio Altamirano,Total,8465,8131,334,9367
30 Veracruz de Ignacio de la Llave,100,100 Manlio Fabio Altamirano,Total,67,62,5,1111
30 Veracruz de Ignacio de la Llave,100,100 Manlio Fabio Altamirano,Total,652,605,47,1483
30 Veracruz de Ignacio de la Llave,100,100 Manlio Fabio Altamirano,Total,1100,1020,80,771
30 Veracruz de Ignacio de la Llave,100,100 Manlio Fabio Altamirano,Total,929,881,48,645
30 Veracruz de Ignacio de la Llave,100,100 Manlio Fabio Altamirano,Total,885,857,28,722
30 Veracruz de Ignacio de la Llave,100,100 Manlio Fabio Altamirano,Total,1053,1030,23,669
30 Veracruz de Ignacio de la Llave,100,100 Manlio Fabio Altamirano,Total,950,926,24,660
30 Veracruz de Ignacio de la Llave,100,100 Manlio Fabio Altamirano,Total,768,746,22,538
30 Veracruz de Ignacio de la Llave,100,100 Manlio Fabio Altamirano,Total,599,576,23,487
30 Veracruz de Ignacio de la Llave,100,100 Manlio Fabio Altamirano,Total,496,482,14,472
30 Veracruz de Ignacio de la Llave,100,100 Manlio Fabio Altamirano,Total,351,338,13,449
30 Veracruz de Ignacio de la Llave,100,100 Manlio Fabio Altamirano,Total,230,227,3,393
30 Veracruz de Ignacio de la Llave,100,100 Manlio Fabio Altamirano,Total,207,203,4,374
30 Veracruz de Ignacio de la Llave,100,100 Manlio Fabio Altamirano,Total,115,115,0,254
30 Veracruz de Ignacio de la Llave,100,100 Manlio Fabio Altamirano,Total,44,44,0,159
30 Veracruz de Ignacio de la Llave,100,100 Manlio Fabio Altamirano,Total,19,19,0,180
30 Veracruz de Ignacio de la Llave,100,100 Manlio Fabio Altamirano,Hombres,6801,6499,302,1916
30 Veracruz de Ignacio de la Llave,100,100 Manlio Fabio Altamirano,Hombres,56,51,5,566
30 Veracruz de Ignacio de la Llave,100,100 Manlio Fabio Altamirano,Hombres,506,466,40,599
30 Veracruz de Ignacio de la Llave,100,100 Manlio Fabio Altamirano,Hombres,816,747,69,98
30 Veracruz de Ignacio de la Llave,100,100 Manlio Fabio Altamirano,Hombres,724,685,39,33
30 Veracruz de Ignacio de la Llave,100,100 Manlio Fabio Altamirano,Hombres,686,659,27,21
30 Veracruz de Ignacio de la Llave,100,100 Manlio Fabio Altamirano,Hombres,829,809,20,28
30 Veracruz de Ignacio de la Llave,100,100 Manlio Fabio Altamirano,Hombres,761,737,24,28
30 Veracruz de Ignacio de la Llave,100,100 Manlio Fabio Altamirano,Hombres,626,604,22,32
30 Veracruz de Ignacio de la Llave,100,100 Manlio Fabio Altamirano,Hombres,497,475,22,32
30 Veracruz de Ignacio de la Llave,100,100 Manlio Fabio Altamirano,Hombres,427,413,14,44
30 Veracruz de Ignacio de la Llave,100,100 Manlio Fabio Altamirano,Hombres,313,300,13,87
30 Veracruz de Ignacio de la Llave,100,100 Manlio Fabio Altamirano,Hombres,205,202,3,91
30 Veracruz de Ignacio de la Llave,100,100 Manlio Fabio Altamirano,Hombres,188,184,4,79
30 Veracruz de Ignacio de la Llave,100,100 Manlio Fabio Altamirano,Hombres,107,107,0,69
30 Veracruz de Ignacio de la Llave,100,100 Manlio Fabio Altamirano,Hombres,41,41,0,51
30 Veracruz de Ignacio de la Llave,100,100 Manlio Fabio Altamirano,Hombres,19,19,0,58
30 Veracruz de Ignacio de la Llave,100,100 Manlio Fabio Altamirano,Mujeres,1664,1632,32,7451
30 Veracruz de Ignacio de la Llave,100,100 Manlio Fabio Altamirano,Mujeres,11,11,0,545
30 Veracruz de Ignacio de la Llave,100,100 Manlio Fabio Altamirano,Mujeres,146,139,7,884
30 Veracruz de Ignacio de la Llave,100,100 Manlio Fabio Altamirano,Mujeres,284,273,11,673
30 Veracruz de Ignacio de la Llave,100,100 Manlio Fabio Altamirano,Mujeres,205,196,9,612
30 Veracruz de Ignacio de la Llave,100,100 Manlio Fabio Altamirano,Mujeres,199,198,1,701
30 Veracruz de Ignacio de la Llave,100,100 Manlio Fabio Altamirano,Mujeres,224,221,3,641
30 Veracruz de Ignacio de la Llave,100,100 Manlio Fabio Altamirano,Mujeres,189,189,0,632
30 Veracruz de Ignacio de la Llave,100,100 Manlio Fabio Altamirano,Mujeres,142,142,0,506
30 Veracruz de Ignacio de la Llave,100,100 Manlio Fabio Altamirano,Mujeres,102,101,1,455
30 Veracruz de Ignacio de la Llave,100,100 Manlio Fabio Altamirano,Mujeres,69,69,0,428
30 Veracruz de Ignacio de la Llave,100,100 Manlio Fabio Altamirano,Mujeres,38,38,0,362
30 Veracruz de Ignacio de la Llave,100,100 Manlio Fabio Altamirano,Mujeres,25,25,0,302
30 Veracruz de Ignacio de la Llave,100,100 Manlio Fabio Altamirano,Mujeres,19,19,0,295
30 Veracruz de Ignacio de la Llave,100,100 Manlio Fabio Altamirano,Mujeres,8,8,0,185
30 Veracruz de Ignacio de la Llave,100,100 Manlio Fabio Altamirano,Mujeres,3,3,0,108
30 Veracruz de Ignacio de la Llave,100,100 Manlio Fabio Altamirano,Mujeres,0,0,0,122
30 Veracruz de Ignacio de la Llave,101,101 Mariano Escobedo,Total,12231,11390,841,12106
30 Veracruz de Ignacio de la Llave,101,101 Mariano Escobedo,Total,217,201,16,2000
30 Veracruz de Ignacio de la Llave,101,101 Mariano Escobedo,Total,1181,1060,121,2598
30 Veracruz de Ignacio de la Llave,101,101 Mariano Escobedo,Total,1665,1509,156,1472
30 Veracruz de Ignacio de la Llave,101,101 Mariano Escobedo,Total,1669,1534,135,987
30 Veracruz de Ignacio de la Llave,101,101 Mariano Escobedo,Total,1459,1372,87,730
30 Veracruz de Ignacio de la Llave,101,101 Mariano Escobedo,Total,1354,1277,77,659
30 Veracruz de Ignacio de la Llave,101,101 Mariano Escobedo,Total,1300,1245,55,636
30 Veracruz de Ignacio de la Llave,101,101 Mariano Escobedo,Total,1158,1115,43,569
30 Veracruz de Ignacio de la Llave,101,101 Mariano Escobedo,Total,883,820,63,545
30 Veracruz de Ignacio de la Llave,101,101 Mariano Escobedo,Total,570,525,45,439
30 Veracruz de Ignacio de la Llave,101,101 Mariano Escobedo,Total,315,295,20,427
30 Veracruz de Ignacio de la Llave,101,101 Mariano Escobedo,Total,212,204,8,330
30 Veracruz de Ignacio de la Llave,101,101 Mariano Escobedo,Total,121,113,8,263
30 Veracruz de Ignacio de la Llave,101,101 Mariano Escobedo,Total,75,74,1,180
30 Veracruz de Ignacio de la Llave,101,101 Mariano Escobedo,Total,33,29,4,156
30 Veracruz de Ignacio de la Llave,101,101 Mariano Escobedo,Total,19,17,2,115
30 Veracruz de Ignacio de la Llave,101,101 Mariano Escobedo,Hombres,8531,7831,700,2905
30 Veracruz de Ignacio de la Llave,101,101 Mariano Escobedo,Hombres,187,173,14,934
30 Veracruz de Ignacio de la Llave,101,101 Mariano Escobedo,Hombres,909,813,96,950
30 Veracruz de Ignacio de la Llave,101,101 Mariano Escobedo,Hombres,1143,1033,110,296
30 Veracruz de Ignacio de la Llave,101,101 Mariano Escobedo,Hombres,1173,1067,106,71
30 Veracruz de Ignacio de la Llave,101,101 Mariano Escobedo,Hombres,1014,933,81,27
30 Veracruz de Ignacio de la Llave,101,101 Mariano Escobedo,Hombres,912,843,69,27
30 Veracruz de Ignacio de la Llave,101,101 Mariano Escobedo,Hombres,831,781,50,36
30 Veracruz de Ignacio de la Llave,101,101 Mariano Escobedo,Hombres,766,727,39,32
30 Veracruz de Ignacio de la Llave,101,101 Mariano Escobedo,Hombres,575,519,56,51
30 Veracruz de Ignacio de la Llave,101,101 Mariano Escobedo,Hombres,432,393,39,62
30 Veracruz de Ignacio de la Llave,101,101 Mariano Escobedo,Hombres,217,199,18,110
30 Veracruz de Ignacio de la Llave,101,101 Mariano Escobedo,Hombres,164,157,7,92
30 Veracruz de Ignacio de la Llave,101,101 Mariano Escobedo,Hombres,98,90,8,61
30 Veracruz de Ignacio de la Llave,101,101 Mariano Escobedo,Hombres,60,59,1,63
30 Veracruz de Ignacio de la Llave,101,101 Mariano Escobedo,Hombres,31,27,4,51
30 Veracruz de Ignacio de la Llave,101,101 Mariano Escobedo,Hombres,19,17,2,42
30 Veracruz de Ignacio de la Llave,101,101 Mariano Escobedo,Mujeres,3700,3559,141,9201
30 Veracruz de Ignacio de la Llave,101,101 Mariano Escobedo,Mujeres,30,28,2,1066
30 Veracruz de Ignacio de la Llave,101,101 Mariano Escobedo,Mujeres,272,247,25,1648
30 Veracruz de Ignacio de la Llave,101,101 Mariano Escobedo,Mujeres,522,476,46,1176
30 Veracruz de Ignacio de la Llave,101,101 Mariano Escobedo,Mujeres,496,467,29,916
30 Veracruz de Ignacio de la Llave,101,101 Mariano Escobedo,Mujeres,445,439,6,703
30 Veracruz de Ignacio de la Llave,101,101 Mariano Escobedo,Mujeres,442,434,8,632
30 Veracruz de Ignacio de la Llave,101,101 Mariano Escobedo,Mujeres,469,464,5,600
30 Veracruz de Ignacio de la Llave,101,101 Mariano Escobedo,Mujeres,392,388,4,537
30 Veracruz de Ignacio de la Llave,101,101 Mariano Escobedo,Mujeres,308,301,7,494
30 Veracruz de Ignacio de la Llave,101,101 Mariano Escobedo,Mujeres,138,132,6,377
30 Veracruz de Ignacio de la Llave,101,101 Mariano Escobedo,Mujeres,98,96,2,317
30 Veracruz de Ignacio de la Llave,101,101 Mariano Escobedo,Mujeres,48,47,1,238
30 Veracruz de Ignacio de la Llave,101,101 Mariano Escobedo,Mujeres,23,23,0,202
30 Veracruz de Ignacio de la Llave,101,101 Mariano Escobedo,Mujeres,15,15,0,117
30 Veracruz de Ignacio de la Llave,101,101 Mariano Escobedo,Mujeres,2,2,0,105
30 Veracruz de Ignacio de la Llave,101,101 Mariano Escobedo,Mujeres,0,0,0,73
30 Veracruz de Ignacio de la Llave,102,102 Martínez de la Torre,Total,40868,39684,1184,36844
30 Veracruz de Ignacio de la Llave,102,102 Martínez de la Torre,Total,272,251,21,5685
30 Veracruz de Ignacio de la Llave,102,102 Martínez de la Torre,Total,2857,2675,182,7054
30 Veracruz de Ignacio de la Llave,102,102 Martínez de la Torre,Total,4935,4738,197,3465
30 Veracruz de Ignacio de la Llave,102,102 Martínez de la Torre,Total,4869,4729,140,2354
30 Veracruz de Ignacio de la Llave,102,102 Martínez de la Torre,Total,5190,5084,106,2453
30 Veracruz de Ignacio de la Llave,102,102 Martínez de la Torre,Total,5277,5179,98,2259
30 Veracruz de Ignacio de la Llave,102,102 Martínez de la Torre,Total,4757,4661,96,2119
30 Veracruz de Ignacio de la Llave,102,102 Martínez de la Torre,Total,4014,3934,80,1750
30 Veracruz de Ignacio de la Llave,102,102 Martínez de la Torre,Total,3012,2940,72,1803
30 Veracruz de Ignacio de la Llave,102,102 Martínez de la Torre,Total,2227,2167,60,1652
30 Veracruz de Ignacio de la Llave,102,102 Martínez de la Torre,Total,1425,1373,52,1539
30 Veracruz de Ignacio de la Llave,102,102 Martínez de la Torre,Total,934,898,36,1428
30 Veracruz de Ignacio de la Llave,102,102 Martínez de la Torre,Total,619,591,28,1267
30 Veracruz de Ignacio de la Llave,102,102 Martínez de la Torre,Total,281,275,6,907
30 Veracruz de Ignacio de la Llave,102,102 Martínez de la Torre,Total,120,116,4,570
30 Veracruz de Ignacio de la Llave,102,102 Martínez de la Torre,Total,79,73,6,539
30 Veracruz de Ignacio de la Llave,102,102 Martínez de la Torre,Hombres,27554,26605,949,8860
30 Veracruz de Ignacio de la Llave,102,102 Martínez de la Torre,Hombres,207,187,20,2744
30 Veracruz de Ignacio de la Llave,102,102 Martínez de la Torre,Hombres,2064,1921,143,2821
30 Veracruz de Ignacio de la Llave,102,102 Martínez de la Torre,Hombres,3219,3096,123,777
30 Veracruz de Ignacio de la Llave,102,102 Martínez de la Torre,Hombres,3099,3011,88,123
30 Veracruz de Ignacio de la Llave,102,102 Martínez de la Torre,Hombres,3360,3280,80,81
30 Veracruz de Ignacio de la Llave,102,102 Martínez de la Torre,Hombres,3371,3290,81,69
30 Veracruz de Ignacio de la Llave,102,102 Martínez de la Torre,Hombres,3036,2949,87,86
30 Veracruz de Ignacio de la Llave,102,102 Martínez de la Torre,Hombres,2677,2605,72,99
30 Veracruz de Ignacio de la Llave,102,102 Martínez de la Torre,Hombres,2064,1995,69,112
30 Veracruz de Ignacio de la Llave,102,102 Martínez de la Torre,Hombres,1640,1580,60,182
30 Veracruz de Ignacio de la Llave,102,102 Martínez de la Torre,Hombres,1099,1053,46,297
30 Veracruz de Ignacio de la Llave,102,102 Martínez de la Torre,Hombres,765,729,36,328
30 Veracruz de Ignacio de la Llave,102,102 Martínez de la Torre,Hombres,533,505,28,361
30 Veracruz de Ignacio de la Llave,102,102 Martínez de la Torre,Hombres,240,234,6,335
30 Veracruz de Ignacio de la Llave,102,102 Martínez de la Torre,Hombres,104,100,4,231
30 Veracruz de Ignacio de la Llave,102,102 Martínez de la Torre,Hombres,76,70,6,214
30 Veracruz de Ignacio de la Llave,102,102 Martínez de la Torre,Mujeres,13314,13079,235,27984
30 Veracruz de Ignacio de la Llave,102,102 Martínez de la Torre,Mujeres,65,64,1,2941
30 Veracruz de Ignacio de la Llave,102,102 Martínez de la Torre,Mujeres,793,754,39,4233
30 Veracruz de Ignacio de la Llave,102,102 Martínez de la Torre,Mujeres,1716,1642,74,2688
30 Veracruz de Ignacio de la Llave,102,102 Martínez de la Torre,Mujeres,1770,1718,52,2231
30 Veracruz de Ignacio de la Llave,102,102 Martínez de la Torre,Mujeres,1830,1804,26,2372
30 Veracruz de Ignacio de la Llave,102,102 Martínez de la Torre,Mujeres,1906,1889,17,2190
30 Veracruz de Ignacio de la Llave,102,102 Martínez de la Torre,Mujeres,1721,1712,9,2033
30 Veracruz de Ignacio de la Llave,102,102 Martínez de la Torre,Mujeres,1337,1329,8,1651
30 Veracruz de Ignacio de la Llave,102,102 Martínez de la Torre,Mujeres,948,945,3,1691
30 Veracruz de Ignacio de la Llave,102,102 Martínez de la Torre,Mujeres,587,587,0,1470
30 Veracruz de Ignacio de la Llave,102,102 Martínez de la Torre,Mujeres,326,320,6,1242
30 Veracruz de Ignacio de la Llave,102,102 Martínez de la Torre,Mujeres,169,169,0,1100
30 Veracruz de Ignacio de la Llave,102,102 Martínez de la Torre,Mujeres,86,86,0,906
30 Veracruz de Ignacio de la Llave,102,102 Martínez de la Torre,Mujeres,41,41,0,572
30 Veracruz de Ignacio de la Llave,102,102 Martínez de la Torre,Mujeres,16,16,0,339
30 Veracruz de Ignacio de la Llave,102,102 Martínez de la Torre,Mujeres,3,3,0,325
30 Veracruz de Ignacio de la Llave,103,103 Mecatlán,Total,2379,2218,161,5668
30 Veracruz de Ignacio de la Llave,103,103 Mecatlán,Total,28,24,4,902
30 Veracruz de Ignacio de la Llave,103,103 Mecatlán,Total,235,212,23,1049
30 Veracruz de Ignacio de la Llave,103,103 Mecatlán,Total,320,299,21,542
30 Veracruz de Ignacio de la Llave,103,103 Mecatlán,Total,276,256,20,445
30 Veracruz de Ignacio de la Llave,103,103 Mecatlán,Total,296,281,15,432
30 Veracruz de Ignacio de la Llave,103,103 Mecatlán,Total,252,232,20,373
30 Veracruz de Ignacio de la Llave,103,103 Mecatlán,Total,205,187,18,373
30 Veracruz de Ignacio de la Llave,103,103 Mecatlán,Total,193,180,13,331
30 Veracruz de Ignacio de la Llave,103,103 Mecatlán,Total,212,201,11,291
30 Veracruz de Ignacio de la Llave,103,103 Mecatlán,Total,116,108,8,261
30 Veracruz de Ignacio de la Llave,103,103 Mecatlán,Total,103,98,5,196
30 Veracruz de Ignacio de la Llave,103,103 Mecatlán,Total,82,79,3,165
30 Veracruz de Ignacio de la Llave,103,103 Mecatlán,Total,38,38,0,127
30 Veracruz de Ignacio de la Llave,103,103 Mecatlán,Total,16,16,0,90
30 Veracruz de Ignacio de la Llave,103,103 Mecatlán,Total,3,3,0,56
30 Veracruz de Ignacio de la Llave,103,103 Mecatlán,Total,4,4,0,35
30 Veracruz de Ignacio de la Llave,103,103 Mecatlán,Hombres,2054,1903,151,1825
30 Veracruz de Ignacio de la Llave,103,103 Mecatlán,Hombres,17,16,1,447
30 Veracruz de Ignacio de la Llave,103,103 Mecatlán,Hombres,176,156,20,456
30 Veracruz de Ignacio de la Llave,103,103 Mecatlán,Hombres,259,240,19,146
30 Veracruz de Ignacio de la Llave,103,103 Mecatlán,Hombres,249,230,19,78
30 Veracruz de Ignacio de la Llave,103,103 Mecatlán,Hombres,246,231,15,102
30 Veracruz de Ignacio de la Llave,103,103 Mecatlán,Hombres,231,212,19,78
30 Veracruz de Ignacio de la Llave,103,103 Mecatlán,Hombres,175,157,18,71
30 Veracruz de Ignacio de la Llave,103,103 Mecatlán,Hombres,177,164,13,75
30 Veracruz de Ignacio de la Llave,103,103 Mecatlán,Hombres,191,180,11,71
30 Veracruz de Ignacio de la Llave,103,103 Mecatlán,Hombres,104,96,8,74
30 Veracruz de Ignacio de la Llave,103,103 Mecatlán,Hombres,96,91,5,51
30 Veracruz de Ignacio de la Llave,103,103 Mecatlán,Hombres,75,72,3,63
30 Veracruz de Ignacio de la Llave,103,103 Mecatlán,Hombres,36,36,0,48
30 Veracruz de Ignacio de la Llave,103,103 Mecatlán,Hombres,15,15,0,28
30 Veracruz de Ignacio de la Llave,103,103 Mecatlán,Hombres,3,3,0,26
30 Veracruz de Ignacio de la Llave,103,103 Mecatlán,Hombres,4,4,0,11
30 Veracruz de Ignacio de la Llave,103,103 Mecatlán,Mujeres,325,315,10,3843
30 Veracruz de Ignacio de la Llave,103,103 Mecatlán,Mujeres,11,8,3,455
30 Veracruz de Ignacio de la Llave,103,103 Mecatlán,Mujeres,59,56,3,593
30 Veracruz de Ignacio de la Llave,103,103 Mecatlán,Mujeres,61,59,2,396
30 Veracruz de Ignacio de la Llave,103,103 Mecatlán,Mujeres,27,26,1,367
30 Veracruz de Ignacio de la Llave,103,103 Mecatlán,Mujeres,50,50,0,330
30 Veracruz de Ignacio de la Llave,103,103 Mecatlán,Mujeres,21,20,1,295
30 Veracruz de Ignacio de la Llave,103,103 Mecatlán,Mujeres,30,30,0,302
30 Veracruz de Ignacio de la Llave,103,103 Mecatlán,Mujeres,16,16,0,256
30 Veracruz de Ignacio de la Llave,103,103 Mecatlán,Mujeres,21,21,0,220
30 Veracruz de Ignacio de la Llave,103,103 Mecatlán,Mujeres,12,12,0,187
30 Veracruz de Ignacio de la Llave,103,103 Mecatlán,Mujeres,7,7,0,145
30 Veracruz de Ignacio de la Llave,103,103 Mecatlán,Mujeres,7,7,0,102
30 Veracruz de Ignacio de la Llave,103,103 Mecatlán,Mujeres,2,2,0,79
30 Veracruz de Ignacio de la Llave,103,103 Mecatlán,Mujeres,1,1,0,62
30 Veracruz de Ignacio de la Llave,103,103 Mecatlán,Mujeres,0,0,0,30
30 Veracruz de Ignacio de la Llave,103,103 Mecatlán,Mujeres,0,0,0,24
30 Veracruz de Ignacio de la Llave,104,104 Mecayapan,Total,4966,4564,402,7854
30 Veracruz de Ignacio de la Llave,104,104 Mecayapan,Total,58,49,9,1230
30 Veracruz de Ignacio de la Llave,104,104 Mecayapan,Total,524,446,78,1738
30 Veracruz de Ignacio de la Llave,104,104 Mecayapan,Total,770,697,73,946
30 Veracruz de Ignacio de la Llave,104,104 Mecayapan,Total,637,579,58,691
30 Veracruz de Ignacio de la Llave,104,104 Mecayapan,Total,567,511,56,594
30 Veracruz de Ignacio de la Llave,104,104 Mecayapan,Total,556,517,39,576
30 Veracruz de Ignacio de la Llave,104,104 Mecayapan,Total,462,421,41,444
30 Veracruz de Ignacio de la Llave,104,104 Mecayapan,Total,388,372,16,383
30 Veracruz de Ignacio de la Llave,104,104 Mecayapan,Total,289,279,10,298
30 Veracruz de Ignacio de la Llave,104,104 Mecayapan,Total,230,221,9,243
30 Veracruz de Ignacio de la Llave,104,104 Mecayapan,Total,141,137,4,170
30 Veracruz de Ignacio de la Llave,104,104 Mecayapan,Total,125,121,4,135
30 Veracruz de Ignacio de la Llave,104,104 Mecayapan,Total,123,119,4,196
30 Veracruz de Ignacio de la Llave,104,104 Mecayapan,Total,64,63,1,90
30 Veracruz de Ignacio de la Llave,104,104 Mecayapan,Total,17,17,0,55
30 Veracruz de Ignacio de la Llave,104,104 Mecayapan,Total,15,15,0,65
30 Veracruz de Ignacio de la Llave,104,104 Mecayapan,Hombres,4328,3946,382,1901
30 Veracruz de Ignacio de la Llave,104,104 Mecayapan,Hombres,53,44,9,593
30 Veracruz de Ignacio de la Llave,104,104 Mecayapan,Hombres,475,401,74,654
30 Veracruz de Ignacio de la Llave,104,104 Mecayapan,Hombres,674,611,63,171
30 Veracruz de Ignacio de la Llave,104,104 Mecayapan,Hombres,533,477,56,78
30 Veracruz de Ignacio de la Llave,104,104 Mecayapan,Hombres,484,428,56,53
30 Veracruz de Ignacio de la Llave,104,104 Mecayapan,Hombres,486,448,38,52
30 Veracruz de Ignacio de la Llave,104,104 Mecayapan,Hombres,395,356,39,40
30 Veracruz de Ignacio de la Llave,104,104 Mecayapan,Hombres,319,303,16,31
30 Veracruz de Ignacio de la Llave,104,104 Mecayapan,Hombres,262,252,10,31
30 Veracruz de Ignacio de la Llave,104,104 Mecayapan,Hombres,206,197,9,44
30 Veracruz de Ignacio de la Llave,104,104 Mecayapan,Hombres,131,127,4,17
30 Veracruz de Ignacio de la Llave,104,104 Mecayapan,Hombres,114,110,4,24
30 Veracruz de Ignacio de la Llave,104,104 Mecayapan,Hombres,108,104,4,41
30 Veracruz de Ignacio de la Llave,104,104 Mecayapan,Hombres,57,57,0,26
30 Veracruz de Ignacio de la Llave,104,104 Mecayapan,Hombres,17,17,0,16
30 Veracruz de Ignacio de la Llave,104,104 Mecayapan,Hombres,14,14,0,30
30 Veracruz de Ignacio de la Llave,104,104 Mecayapan,Mujeres,638,618,20,5953
30 Veracruz de Ignacio de la Llave,104,104 Mecayapan,Mujeres,5,5,0,637
30 Veracruz de Ignacio de la Llave,104,104 Mecayapan,Mujeres,49,45,4,1084
30 Veracruz de Ignacio de la Llave,104,104 Mecayapan,Mujeres,96,86,10,775
30 Veracruz de Ignacio de la Llave,104,104 Mecayapan,Mujeres,104,102,2,613
30 Veracruz de Ignacio de la Llave,104,104 Mecayapan,Mujeres,83,83,0,541
30 Veracruz de Ignacio de la Llave,104,104 Mecayapan,Mujeres,70,69,1,524
30 Veracruz de Ignacio de la Llave,104,104 Mecayapan,Mujeres,67,65,2,404
30 Veracruz de Ignacio de la Llave,104,104 Mecayapan,Mujeres,69,69,0,352
30 Veracruz de Ignacio de la Llave,104,104 Mecayapan,Mujeres,27,27,0,267
30 Veracruz de Ignacio de la Llave,104,104 Mecayapan,Mujeres,24,24,0,199
30 Veracruz de Ignacio de la Llave,104,104 Mecayapan,Mujeres,10,10,0,153
30 Veracruz de Ignacio de la Llave,104,104 Mecayapan,Mujeres,11,11,0,111
30 Veracruz de Ignacio de la Llave,104,104 Mecayapan,Mujeres,15,15,0,155
30 Veracruz de Ignacio de la Llave,104,104 Mecayapan,Mujeres,7,6,1,64
30 Veracruz de Ignacio de la Llave,104,104 Mecayapan,Mujeres,0,0,0,39
30 Veracruz de Ignacio de la Llave,104,104 Mecayapan,Mujeres,1,1,0,35
30 Veracruz de Ignacio de la Llave,105,105 Medellín,Total,25812,25081,731,20150
30 Veracruz de Ignacio de la Llave,105,105 Medellín,Total,88,79,9,2756
30 Veracruz de Ignacio de la Llave,105,105 Medellín,Total,1428,1317,111,3647
30 Veracruz de Ignacio de la Llave,105,105 Medellín,Total,3066,2931,135,2026
30 Veracruz de Ignacio de la Llave,105,105 Medellín,Total,3922,3811,111,1666
30 Veracruz de Ignacio de la Llave,105,105 Medellín,Total,4020,3933,87,1587
30 Veracruz de Ignacio de la Llave,105,105 Medellín,Total,3795,3729,66,1384
30 Veracruz de Ignacio de la Llave,105,105 Medellín,Total,2920,2875,45,1142
30 Veracruz de Ignacio de la Llave,105,105 Medellín,Total,2202,2165,37,1016
30 Veracruz de Ignacio de la Llave,105,105 Medellín,Total,1675,1620,55,945
30 Veracruz de Ignacio de la Llave,105,105 Medellín,Total,1094,1066,28,825
30 Veracruz de Ignacio de la Llave,105,105 Medellín,Total,709,691,18,807
30 Veracruz de Ignacio de la Llave,105,105 Medellín,Total,404,389,15,713
30 Veracruz de Ignacio de la Llave,105,105 Medellín,Total,258,253,5,645
30 Veracruz de Ignacio de la Llave,105,105 Medellín,Total,140,134,6,437
30 Veracruz de Ignacio de la Llave,105,105 Medellín,Total,68,65,3,278
30 Veracruz de Ignacio de la Llave,105,105 Medellín,Total,23,23,0,276
30 Veracruz de Ignacio de la Llave,105,105 Medellín,Hombres,17164,16626,538,4562
30 Veracruz de Ignacio de la Llave,105,105 Medellín,Hombres,73,65,8,1360
30 Veracruz de Ignacio de la Llave,105,105 Medellín,Hombres,1058,972,86,1464
30 Veracruz de Ignacio de la Llave,105,105 Medellín,Hombres,2022,1939,83,368
30 Veracruz de Ignacio de la Llave,105,105 Medellín,Hombres,2404,2330,74,81
30 Veracruz de Ignacio de la Llave,105,105 Medellín,Hombres,2532,2472,60,58
30 Veracruz de Ignacio de la Llave,105,105 Medellín,Hombres,2444,2395,49,52
30 Veracruz de Ignacio de la Llave,105,105 Medellín,Hombres,1885,1854,31,47
30 Veracruz de Ignacio de la Llave,105,105 Medellín,Hombres,1495,1466,29,64
30 Veracruz de Ignacio de la Llave,105,105 Medellín,Hombres,1122,1073,49,81
30 Veracruz de Ignacio de la Llave,105,105 Medellín,Hombres,832,805,27,111
30 Veracruz de Ignacio de la Llave,105,105 Medellín,Hombres,544,527,17,183
30 Veracruz de Ignacio de la Llave,105,105 Medellín,Hombres,318,306,12,179
30 Veracruz de Ignacio de la Llave,105,105 Medellín,Hombres,223,218,5,190
30 Veracruz de Ignacio de la Llave,105,105 Medellín,Hombres,126,121,5,140
30 Veracruz de Ignacio de la Llave,105,105 Medellín,Hombres,66,63,3,102
30 Veracruz de Ignacio de la Llave,105,105 Medellín,Hombres,20,20,0,82
30 Veracruz de Ignacio de la Llave,105,105 Medellín,Mujeres,8648,8455,193,15588
30 Veracruz de Ignacio de la Llave,105,105 Medellín,Mujeres,15,14,1,1396
30 Veracruz de Ignacio de la Llave,105,105 Medellín,Mujeres,370,345,25,2183
30 Veracruz de Ignacio de la Llave,105,105 Medellín,Mujeres,1044,992,52,1658
30 Veracruz de Ignacio de la Llave,105,105 Medellín,Mujeres,1518,1481,37,1585
30 Veracruz de Ignacio de la Llave,105,105 Medellín,Mujeres,1488,1461,27,1529
30 Veracruz de Ignacio de la Llave,105,105 Medellín,Mujeres,1351,1334,17,1332
30 Veracruz de Ignacio de la Llave,105,105 Medellín,Mujeres,1035,1021,14,1095
30 Veracruz de Ignacio de la Llave,105,105 Medellín,Mujeres,707,699,8,952
30 Veracruz de Ignacio de la Llave,105,105 Medellín,Mujeres,553,547,6,864
30 Veracruz de Ignacio de la Llave,105,105 Medellín,Mujeres,262,261,1,714
30 Veracruz de Ignacio de la Llave,105,105 Medellín,Mujeres,165,164,1,624
30 Veracruz de Ignacio de la Llave,105,105 Medellín,Mujeres,86,83,3,534
30 Veracruz de Ignacio de la Llave,105,105 Medellín,Mujeres,35,35,0,455
30 Veracruz de Ignacio de la Llave,105,105 Medellín,Mujeres,14,13,1,297
30 Veracruz de Ignacio de la Llave,105,105 Medellín,Mujeres,2,2,0,176
30 Veracruz de Ignacio de la Llave,105,105 Medellín,Mujeres,3,3,0,194
30 Veracruz de Ignacio de la Llave,106,106 Miahuatlán,Total,1365,1302,63,1849
30 Veracruz de Ignacio de la Llave,106,106 Miahuatlán,Total,45,41,4,274
30 Veracruz de Ignacio de la Llave,106,106 Miahuatlán,Total,192,176,16,313
30 Veracruz de Ignacio de la Llave,106,106 Miahuatlán,Total,163,154,9,189
30 Veracruz de Ignacio de la Llave,106,106 Miahuatlán,Total,153,149,4,132
30 Veracruz de Ignacio de la Llave,106,106 Miahuatlán,Total,164,158,6,168
30 Veracruz de Ignacio de la Llave,106,106 Miahuatlán,Total,146,143,3,128
30 Veracruz de Ignacio de la Llave,106,106 Miahuatlán,Total,129,119,10,94
30 Veracruz de Ignacio de la Llave,106,106 Miahuatlán,Total,94,92,2,111
30 Veracruz de Ignacio de la Llave,106,106 Miahuatlán,Total,76,73,3,90
30 Veracruz de Ignacio de la Llave,106,106 Miahuatlán,Total,59,58,1,78
30 Veracruz de Ignacio de la Llave,106,106 Miahuatlán,Total,67,63,4,66
30 Veracruz de Ignacio de la Llave,106,106 Miahuatlán,Total,37,36,1,59
30 Veracruz de Ignacio de la Llave,106,106 Miahuatlán,Total,25,25,0,48
30 Veracruz de Ignacio de la Llave,106,106 Miahuatlán,Total,10,10,0,42
30 Veracruz de Ignacio de la Llave,106,106 Miahuatlán,Total,3,3,0,28
30 Veracruz de Ignacio de la Llave,106,106 Miahuatlán,Total,2,2,0,29
30 Veracruz de Ignacio de la Llave,106,106 Miahuatlán,Hombres,1123,1063,60,383
30 Veracruz de Ignacio de la Llave,106,106 Miahuatlán,Hombres,44,40,4,122
30 Veracruz de Ignacio de la Llave,106,106 Miahuatlán,Hombres,165,150,15,89
30 Veracruz de Ignacio de la Llave,106,106 Miahuatlán,Hombres,128,119,9,23
30 Veracruz de Ignacio de la Llave,106,106 Miahuatlán,Hombres,118,114,4,13
30 Veracruz de Ignacio de la Llave,106,106 Miahuatlán,Hombres,138,132,6,17
30 Veracruz de Ignacio de la Llave,106,106 Miahuatlán,Hombres,108,105,3,4
30 Veracruz de Ignacio de la Llave,106,106 Miahuatlán,Hombres,109,101,8,9
30 Veracruz de Ignacio de la Llave,106,106 Miahuatlán,Hombres,79,77,2,11
30 Veracruz de Ignacio de la Llave,106,106 Miahuatlán,Hombres,62,59,3,11
30 Veracruz de Ignacio de la Llave,106,106 Miahuatlán,Hombres,47,46,1,20
30 Veracruz de Ignacio de la Llave,106,106 Miahuatlán,Hombres,57,53,4,12
30 Veracruz de Ignacio de la Llave,106,106 Miahuatlán,Hombres,33,32,1,9
30 Veracruz de Ignacio de la Llave,106,106 Miahuatlán,Hombres,21,21,0,9
30 Veracruz de Ignacio de la Llave,106,106 Miahuatlán,Hombres,10,10,0,18
30 Veracruz de Ignacio de la Llave,106,106 Miahuatlán,Hombres,3,3,0,6
30 Veracruz de Ignacio de la Llave,106,106 Miahuatlán,Hombres,1,1,0,10
30 Veracruz de Ignacio de la Llave,106,106 Miahuatlán,Mujeres,242,239,3,1466
30 Veracruz de Ignacio de la Llave,106,106 Miahuatlán,Mujeres,1,1,0,152
30 Veracruz de Ignacio de la Llave,106,106 Miahuatlán,Mujeres,27,26,1,224
30 Veracruz de Ignacio de la Llave,106,106 Miahuatlán,Mujeres,35,35,0,166
30 Veracruz de Ignacio de la Llave,106,106 Miahuatlán,Mujeres,35,35,0,119
30 Veracruz de Ignacio de la Llave,106,106 Miahuatlán,Mujeres,26,26,0,151
30 Veracruz de Ignacio de la Llave,106,106 Miahuatlán,Mujeres,38,38,0,124
30 Veracruz de Ignacio de la Llave,106,106 Miahuatlán,Mujeres,20,18,2,85
30 Veracruz de Ignacio de la Llave,106,106 Miahuatlán,Mujeres,15,15,0,100
30 Veracruz de Ignacio de la Llave,106,106 Miahuatlán,Mujeres,14,14,0,79
30 Veracruz de Ignacio de la Llave,106,106 Miahuatlán,Mujeres,12,12,0,58
30 Veracruz de Ignacio de la Llave,106,106 Miahuatlán,Mujeres,10,10,0,54
30 Veracruz de Ignacio de la Llave,106,106 Miahuatlán,Mujeres,4,4,0,50
30 Veracruz de Ignacio de la Llave,106,106 Miahuatlán,Mujeres,4,4,0,39
30 Veracruz de Ignacio de la Llave,106,106 Miahuatlán,Mujeres,0,0,0,24
30 Veracruz de Ignacio de la Llave,106,106 Miahuatlán,Mujeres,0,0,0,22
30 Veracruz de Ignacio de la Llave,106,106 Miahuatlán,Mujeres,1,1,0,19
30 Veracruz de Ignacio de la Llave,108,108 Minatitlán,Total,62202,59867,2335,61996
30 Veracruz de Ignacio de la Llave,108,108 Minatitlán,Total,333,319,14,8558
30 Veracruz de Ignacio de la Llave,108,108 Minatitlán,Total,3460,3209,251,12008
30 Veracruz de Ignacio de la Llave,108,108 Minatitlán,Total,6981,6515,466,6342
30 Veracruz de Ignacio de la Llave,108,108 Minatitlán,Total,8196,7760,436,3869
30 Veracruz de Ignacio de la Llave,108,108 Minatitlán,Total,7704,7471,233,3525
30 Veracruz de Ignacio de la Llave,108,108 Minatitlán,Total,8039,7817,222,3601
30 Veracruz de Ignacio de la Llave,108,108 Minatitlán,Total,7450,7288,162,3228
30 Veracruz de Ignacio de la Llave,108,108 Minatitlán,Total,6480,6340,140,2996
30 Veracruz de Ignacio de la Llave,108,108 Minatitlán,Total,5259,5121,138,3027
30 Veracruz de Ignacio de la Llave,108,108 Minatitlán,Total,3369,3262,107,3141
30 Veracruz de Ignacio de la Llave,108,108 Minatitlán,Total,2068,2006,62,3095
30 Veracruz de Ignacio de la Llave,108,108 Minatitlán,Total,1309,1265,44,2514
30 Veracruz de Ignacio de la Llave,108,108 Minatitlán,Total,828,793,35,2328
30 Veracruz de Ignacio de la Llave,108,108 Minatitlán,Total,427,410,17,1710
30 Veracruz de Ignacio de la Llave,108,108 Minatitlán,Total,193,188,5,1117
30 Veracruz de Ignacio de la Llave,108,108 Minatitlán,Total,106,103,3,937
30 Veracruz de Ignacio de la Llave,108,108 Minatitlán,Hombres,42335,40573,1762,16743
30 Veracruz de Ignacio de la Llave,108,108 Minatitlán,Hombres,274,263,11,4270
30 Veracruz de Ignacio de la Llave,108,108 Minatitlán,Hombres,2698,2501,197,5157
30 Veracruz de Ignacio de la Llave,108,108 Minatitlán,Hombres,4745,4429,316,1693
30 Veracruz de Ignacio de la Llave,108,108 Minatitlán,Hombres,5265,4973,292,297
30 Veracruz de Ignacio de la Llave,108,108 Minatitlán,Hombres,5001,4833,168,137
30 Veracruz de Ignacio de la Llave,108,108 Minatitlán,Hombres,5194,5042,152,135
30 Veracruz de Ignacio de la Llave,108,108 Minatitlán,Hombres,4895,4768,127,115
30 Veracruz de Ignacio de la Llave,108,108 Minatitlán,Hombres,4328,4205,123,147
30 Veracruz de Ignacio de la Llave,108,108 Minatitlán,Hombres,3643,3526,117,349
30 Veracruz de Ignacio de la Llave,108,108 Minatitlán,Hombres,2447,2350,97,650
30 Veracruz de Ignacio de la Llave,108,108 Minatitlán,Hombres,1538,1477,61,883
30 Veracruz de Ignacio de la Llave,108,108 Minatitlán,Hombres,1019,978,41,759
30 Veracruz de Ignacio de la Llave,108,108 Minatitlán,Hombres,667,632,35,779
30 Veracruz de Ignacio de la Llave,108,108 Minatitlán,Hombres,367,350,17,599
30 Veracruz de Ignacio de la Llave,108,108 Minatitlán,Hombres,166,161,5,411
30 Veracruz de Ignacio de la Llave,108,108 Minatitlán,Hombres,88,85,3,362
30 Veracruz de Ignacio de la Llave,108,108 Minatitlán,Mujeres,19867,19294,573,45253
30 Veracruz de Ignacio de la Llave,108,108 Minatitlán,Mujeres,59,56,3,4288
30 Veracruz de Ignacio de la Llave,108,108 Minatitlán,Mujeres,762,708,54,6851
30 Veracruz de Ignacio de la Llave,108,108 Minatitlán,Mujeres,2236,2086,150,4649
30 Veracruz de Ignacio de la Llave,108,108 Minatitlán,Mujeres,2931,2787,144,3572
30 Veracruz de Ignacio de la Llave,108,108 Minatitlán,Mujeres,2703,2638,65,3388
30 Veracruz de Ignacio de la Llave,108,108 Minatitlán,Mujeres,2845,2775,70,3466
30 Veracruz de Ignacio de la Llave,108,108 Minatitlán,Mujeres,2555,2520,35,3113
30 Veracruz de Ignacio de la Llave,108,108 Minatitlán,Mujeres,2152,2135,17,2849
30 Veracruz de Ignacio de la Llave,108,108 Minatitlán,Mujeres,1616,1595,21,2678
30 Veracruz de Ignacio de la Llave,108,108 Minatitlán,Mujeres,922,912,10,2491
30 Veracruz de Ignacio de la Llave,108,108 Minatitlán,Mujeres,530,529,1,2212
30 Veracruz de Ignacio de la Llave,108,108 Minatitlán,Mujeres,290,287,3,1755
30 Veracruz de Ignacio de la Llave,108,108 Minatitlán,Mujeres,161,161,0,1549
30 Veracruz de Ignacio de la Llave,108,108 Minatitlán,Mujeres,60,60,0,1111
30 Veracruz de Ignacio de la Llave,108,108 Minatitlán,Mujeres,27,27,0,706
30 Veracruz de Ignacio de la Llave,108,108 Minatitlán,Mujeres,18,18,0,575
30 Veracruz de Ignacio de la Llave,109,109 Misantla,Total,23771,22980,791,25011
30 Veracruz de Ignacio de la Llave,109,109 Misantla,Total,382,375,7,3769
30 Veracruz de Ignacio de la Llave,109,109 Misantla,Total,1970,1885,85,4750
30 Veracruz de Ignacio de la Llave,109,109 Misantla,Total,2735,2598,137,2227
30 Veracruz de Ignacio de la Llave,109,109 Misantla,Total,2389,2303,86,1483
30 Veracruz de Ignacio de la Llave,109,109 Misantla,Total,2532,2441,91,1555
30 Veracruz de Ignacio de la Llave,109,109 Misantla,Total,2701,2621,80,1643
30 Veracruz de Ignacio de la Llave,109,109 Misantla,Total,2616,2552,64,1487
30 Veracruz de Ignacio de la Llave,109,109 Misantla,Total,2268,2204,64,1279
30 Veracruz de Ignacio de la Llave,109,109 Misantla,Total,1808,1752,56,1131
30 Veracruz de Ignacio de la Llave,109,109 Misantla,Total,1333,1293,40,1179
30 Veracruz de Ignacio de la Llave,109,109 Misantla,Total,1051,1015,36,1048
30 Veracruz de Ignacio de la Llave,109,109 Misantla,Total,837,809,28,1015
30 Veracruz de Ignacio de la Llave,109,109 Misantla,Total,567,558,9,872
30 Veracruz de Ignacio de la Llave,109,109 Misantla,Total,331,329,2,668
30 Veracruz de Ignacio de la Llave,109,109 Misantla,Total,164,158,6,484
30 Veracruz de Ignacio de la Llave,109,109 Misantla,Total,87,87,0,421
30 Veracruz de Ignacio de la Llave,109,109 Misantla,Hombres,17797,17091,706,5726
30 Veracruz de Ignacio de la Llave,109,109 Misantla,Hombres,299,292,7,1774
30 Veracruz de Ignacio de la Llave,109,109 Misantla,Hombres,1526,1453,73,1918
30 Veracruz de Ignacio de la Llave,109,109 Misantla,Hombres,1922,1814,108,445
30 Veracruz de Ignacio de la Llave,109,109 Misantla,Hombres,1652,1587,65,90
30 Veracruz de Ignacio de la Llave,109,109 Misantla,Hombres,1768,1682,86,67
30 Veracruz de Ignacio de la Llave,109,109 Misantla,Hombres,1928,1853,75,61
30 Veracruz de Ignacio de la Llave,109,109 Misantla,Hombres,1886,1829,57,68
30 Veracruz de Ignacio de la Llave,109,109 Misantla,Hombres,1665,1602,63,55
30 Veracruz de Ignacio de la Llave,109,109 Misantla,Hombres,1368,1314,54,91
30 Veracruz de Ignacio de la Llave,109,109 Misantla,Hombres,1104,1066,38,119
30 Veracruz de Ignacio de la Llave,109,109 Misantla,Hombres,899,864,35,143
30 Veracruz de Ignacio de la Llave,109,109 Misantla,Hombres,726,698,28,177
30 Veracruz de Ignacio de la Llave,109,109 Misantla,Hombres,504,495,9,205
30 Veracruz de Ignacio de la Llave,109,109 Misantla,Hombres,315,313,2,164
30 Veracruz de Ignacio de la Llave,109,109 Misantla,Hombres,153,147,6,169
30 Veracruz de Ignacio de la Llave,109,109 Misantla,Hombres,82,82,0,180
30 Veracruz de Ignacio de la Llave,109,109 Misantla,Mujeres,5974,5889,85,19285
30 Veracruz de Ignacio de la Llave,109,109 Misantla,Mujeres,83,83,0,1995
30 Veracruz de Ignacio de la Llave,109,109 Misantla,Mujeres,444,432,12,2832
30 Veracruz de Ignacio de la Llave,109,109 Misantla,Mujeres,813,784,29,1782
30 Veracruz de Ignacio de la Llave,109,109 Misantla,Mujeres,737,716,21,1393
30 Veracruz de Ignacio de la Llave,109,109 Misantla,Mujeres,764,759,5,1488
30 Veracruz de Ignacio de la Llave,109,109 Misantla,Mujeres,773,768,5,1582
30 Veracruz de Ignacio de la Llave,109,109 Misantla,Mujeres,730,723,7,1419
30 Veracruz de Ignacio de la Llave,109,109 Misantla,Mujeres,603,602,1,1224
30 Veracruz de Ignacio de la Llave,109,109 Misantla,Mujeres,440,438,2,1040
30 Veracruz de Ignacio de la Llave,109,109 Misantla,Mujeres,229,227,2,1060
30 Veracruz de Ignacio de la Llave,109,109 Misantla,Mujeres,152,151,1,905
30 Veracruz de Ignacio de la Llave,109,109 Misantla,Mujeres,111,111,0,838
30 Veracruz de Ignacio de la Llave,109,109 Misantla,Mujeres,63,63,0,667
30 Veracruz de Ignacio de la Llave,109,109 Misantla,Mujeres,16,16,0,504
30 Veracruz de Ignacio de la Llave,109,109 Misantla,Mujeres,11,11,0,315
30 Veracruz de Ignacio de la Llave,109,109 Misantla,Mujeres,5,5,0,241
30 Veracruz de Ignacio de la Llave,110,110 Mixtla de Altamirano,Total,2874,2653,221,3958
30 Veracruz de Ignacio de la Llave,110,110 Mixtla de Altamirano,Total,85,64,21,667
30 Veracruz de Ignacio de la Llave,110,110 Mixtla de Altamirano,Total,415,366,49,680
30 Veracruz de Ignacio de la Llave,110,110 Mixtla de Altamirano,Total,410,378,32,481
30 Veracruz de Ignacio de la Llave,110,110 Mixtla de Altamirano,Total,342,311,31,391
30 Veracruz de Ignacio de la Llave,110,110 Mixtla de Altamirano,Total,317,299,18,297
30 Veracruz de Ignacio de la Llave,110,110 Mixtla de Altamirano,Total,276,263,13,267
30 Veracruz de Ignacio de la Llave,110,110 Mixtla de Altamirano,Total,202,187,15,202
30 Veracruz de Ignacio de la Llave,110,110 Mixtla de Altamirano,Total,210,203,7,201
30 Veracruz de Ignacio de la Llave,110,110 Mixtla de Altamirano,Total,175,164,11,180
30 Veracruz de Ignacio de la Llave,110,110 Mixtla de Altamirano,Total,148,139,9,154
30 Veracruz de Ignacio de la Llave,110,110 Mixtla de Altamirano,Total,111,105,6,118
30 Veracruz de Ignacio de la Llave,110,110 Mixtla de Altamirano,Total,81,78,3,105
30 Veracruz de Ignacio de la Llave,110,110 Mixtla de Altamirano,Total,50,48,2,96
30 Veracruz de Ignacio de la Llave,110,110 Mixtla de Altamirano,Total,27,26,1,48
30 Veracruz de Ignacio de la Llave,110,110 Mixtla de Altamirano,Total,18,17,1,41
30 Veracruz de Ignacio de la Llave,110,110 Mixtla de Altamirano,Total,7,5,2,30
30 Veracruz de Ignacio de la Llave,110,110 Mixtla de Altamirano,Hombres,2588,2378,210,788
30 Veracruz de Ignacio de la Llave,110,110 Mixtla de Altamirano,Hombres,73,55,18,301
30 Veracruz de Ignacio de la Llave,110,110 Mixtla de Altamirano,Hombres,372,328,44,170
30 Veracruz de Ignacio de la Llave,110,110 Mixtla de Altamirano,Hombres,367,336,31,56
30 Veracruz de Ignacio de la Llave,110,110 Mixtla de Altamirano,Hombres,315,284,31,45
30 Veracruz de Ignacio de la Llave,110,110 Mixtla de Altamirano,Hombres,289,272,17,33
30 Veracruz de Ignacio de la Llave,110,110 Mixtla de Altamirano,Hombres,250,237,13,28
30 Veracruz de Ignacio de la Llave,110,110 Mixtla de Altamirano,Hombres,187,172,15,19
30 Veracruz de Ignacio de la Llave,110,110 Mixtla de Altamirano,Hombres,178,171,7,20
30 Veracruz de Ignacio de la Llave,110,110 Mixtla de Altamirano,Hombres,157,146,11,18
30 Veracruz de Ignacio de la Llave,110,110 Mixtla de Altamirano,Hombres,127,119,8,14
30 Veracruz de Ignacio de la Llave,110,110 Mixtla de Altamirano,Hombres,101,95,6,18
30 Veracruz de Ignacio de la Llave,110,110 Mixtla de Altamirano,Hombres,73,70,3,16
30 Veracruz de Ignacio de la Llave,110,110 Mixtla de Altamirano,Hombres,49,47,2,23
30 Veracruz de Ignacio de la Llave,110,110 Mixtla de Altamirano,Hombres,27,26,1,7
30 Veracruz de Ignacio de la Llave,110,110 Mixtla de Altamirano,Hombres,17,16,1,9
30 Veracruz de Ignacio de la Llave,110,110 Mixtla de Altamirano,Hombres,6,4,2,11
30 Veracruz de Ignacio de la Llave,110,110 Mixtla de Altamirano,Mujeres,286,275,11,3170
30 Veracruz de Ignacio de la Llave,110,110 Mixtla de Altamirano,Mujeres,12,9,3,366
30 Veracruz de Ignacio de la Llave,110,110 Mixtla de Altamirano,Mujeres,43,38,5,510
30 Veracruz de Ignacio de la Llave,110,110 Mixtla de Altamirano,Mujeres,43,42,1,425
30 Veracruz de Ignacio de la Llave,110,110 Mixtla de Altamirano,Mujeres,27,27,0,346
30 Veracruz de Ignacio de la Llave,110,110 Mixtla de Altamirano,Mujeres,28,27,1,264
30 Veracruz de Ignacio de la Llave,110,110 Mixtla de Altamirano,Mujeres,26,26,0,239
30 Veracruz de Ignacio de la Llave,110,110 Mixtla de Altamirano,Mujeres,15,15,0,183
30 Veracruz de Ignacio de la Llave,110,110 Mixtla de Altamirano,Mujeres,32,32,0,181
30 Veracruz de Ignacio de la Llave,110,110 Mixtla de Altamirano,Mujeres,18,18,0,162
30 Veracruz de Ignacio de la Llave,110,110 Mixtla de Altamirano,Mujeres,21,20,1,140
30 Veracruz de Ignacio de la Llave,110,110 Mixtla de Altamirano,Mujeres,10,10,0,100
30 Veracruz de Ignacio de la Llave,110,110 Mixtla de Altamirano,Mujeres,8,8,0,89
30 Veracruz de Ignacio de la Llave,110,110 Mixtla de Altamirano,Mujeres,1,1,0,73
30 Veracruz de Ignacio de la Llave,110,110 Mixtla de Altamirano,Mujeres,0,0,0,41
30 Veracruz de Ignacio de la Llave,110,110 Mixtla de Altamirano,Mujeres,1,1,0,32
30 Veracruz de Ignacio de la Llave,110,110 Mixtla de Altamirano,Mujeres,1,1,0,19
30 Veracruz de Ignacio de la Llave,111,111 Moloacán,Total,5263,4927,336,7191
30 Veracruz de Ignacio de la Llave,111,111 Moloacán,Total,29,24,5,1008
30 Veracruz de Ignacio de la Llave,111,111 Moloacán,Total,363,323,40,1469
30 Veracruz de Ignacio de la Llave,111,111 Moloacán,Total,708,641,67,738
30 Veracruz de Ignacio de la Llave,111,111 Moloacán,Total,681,641,40,545
30 Veracruz de Ignacio de la Llave,111,111 Moloacán,Total,623,595,28,439
30 Veracruz de Ignacio de la Llave,111,111 Moloacán,Total,626,600,26,449
30 Veracruz de Ignacio de la Llave,111,111 Moloacán,Total,590,564,26,404
30 Veracruz de Ignacio de la Llave,111,111 Moloacán,Total,495,468,27,359
30 Veracruz de Ignacio de la Llave,111,111 Moloacán,Total,391,373,18,328
30 Veracruz de Ignacio de la Llave,111,111 Moloacán,Total,286,263,23,373
30 Veracruz de Ignacio de la Llave,111,111 Moloacán,Total,214,194,20,280
30 Veracruz de Ignacio de la Llave,111,111 Moloacán,Total,115,105,10,221
30 Veracruz de Ignacio de la Llave,111,111 Moloacán,Total,77,75,2,245
30 Veracruz de Ignacio de la Llave,111,111 Moloacán,Total,44,40,4,140
30 Veracruz de Ignacio de la Llave,111,111 Moloacán,Total,12,12,0,102
30 Veracruz de Ignacio de la Llave,111,111 Moloacán,Total,9,9,0,91
30 Veracruz de Ignacio de la Llave,111,111 Moloacán,Hombres,4065,3749,316,1903
30 Veracruz de Ignacio de la Llave,111,111 Moloacán,Hombres,24,19,5,512
30 Veracruz de Ignacio de la Llave,111,111 Moloacán,Hombres,297,258,39,627
30 Veracruz de Ignacio de la Llave,111,111 Moloacán,Hombres,542,479,63,149
30 Veracruz de Ignacio de la Llave,111,111 Moloacán,Hombres,496,460,36,44
30 Veracruz de Ignacio de la Llave,111,111 Moloacán,Hombres,467,441,26,21
30 Veracruz de Ignacio de la Llave,111,111 Moloacán,Hombres,482,457,25,16
30 Veracruz de Ignacio de la Llave,111,111 Moloacán,Hombres,444,420,24,18
30 Veracruz de Ignacio de la Llave,111,111 Moloacán,Hombres,374,348,26,31
30 Veracruz de Ignacio de la Llave,111,111 Moloacán,Hombres,312,295,17,40
30 Veracruz de Ignacio de la Llave,111,111 Moloacán,Hombres,225,205,20,82
30 Veracruz de Ignacio de la Llave,111,111 Moloacán,Hombres,173,153,20,86
30 Veracruz de Ignacio de la Llave,111,111 Moloacán,Hombres,99,90,9,58
30 Veracruz de Ignacio de la Llave,111,111 Moloacán,Hombres,71,69,2,91
30 Veracruz de Ignacio de la Llave,111,111 Moloacán,Hombres,39,35,4,46
30 Veracruz de Ignacio de la Llave,111,111 Moloacán,Hombres,11,11,0,38
30 Veracruz de Ignacio de la Llave,111,111 Moloacán,Hombres,9,9,0,44
30 Veracruz de Ignacio de la Llave,111,111 Moloacán,Mujeres,1198,1178,20,5288
30 Veracruz de Ignacio de la Llave,111,111 Moloacán,Mujeres,5,5,0,496
30 Veracruz de Ignacio de la Llave,111,111 Moloacán,Mujeres,66,65,1,842
30 Veracruz de Ignacio de la Llave,111,111 Moloacán,Mujeres,166,162,4,589
30 Veracruz de Ignacio de la Llave,111,111 Moloacán,Mujeres,185,181,4,501
30 Veracruz de Ignacio de la Llave,111,111 Moloacán,Mujeres,156,154,2,418
30 Veracruz de Ignacio de la Llave,111,111 Moloacán,Mujeres,144,143,1,433
30 Veracruz de Ignacio de la Llave,111,111 Moloacán,Mujeres,146,144,2,386
30 Veracruz de Ignacio de la Llave,111,111 Moloacán,Mujeres,121,120,1,328
30 Veracruz de Ignacio de la Llave,111,111 Moloacán,Mujeres,79,78,1,288
30 Veracruz de Ignacio de la Llave,111,111 Moloacán,Mujeres,61,58,3,291
30 Veracruz de Ignacio de la Llave,111,111 Moloacán,Mujeres,41,41,0,194
30 Veracruz de Ignacio de la Llave,111,111 Moloacán,Mujeres,16,15,1,163
30 Veracruz de Ignacio de la Llave,111,111 Moloacán,Mujeres,6,6,0,154
30 Veracruz de Ignacio de la Llave,111,111 Moloacán,Mujeres,5,5,0,94
30 Veracruz de Ignacio de la Llave,111,111 Moloacán,Mujeres,1,1,0,64
30 Veracruz de Ignacio de la Llave,111,111 Moloacán,Mujeres,0,0,0,47
30 Veracruz de Ignacio de la Llave,206,206 Nanchital de Lázaro Cárdenas del Río,Total,10217,9719,498,11061
30 Veracruz de Ignacio de la Llave,206,206 Nanchital de Lázaro Cárdenas del Río,Total,20,15,5,1390
30 Veracruz de Ignacio de la Llave,206,206 Nanchital de Lázaro Cárdenas del Río,Total,458,382,76,2164
30 Veracruz de Ignacio de la Llave,206,206 Nanchital de Lázaro Cárdenas del Río,Total,1229,1088,141,1120
30 Veracruz de Ignacio de la Llave,206,206 Nanchital de Lázaro Cárdenas del Río,Total,1548,1458,90,632
30 Veracruz de Ignacio de la Llave,206,206 Nanchital de Lázaro Cárdenas del Río,Total,1308,1273,35,623
30 Veracruz de Ignacio de la Llave,206,206 Nanchital de Lázaro Cárdenas del Río,Total,1399,1355,44,644
30 Veracruz de Ignacio de la Llave,206,206 Nanchital de Lázaro Cárdenas del Río,Total,1398,1368,30,598
30 Veracruz de Ignacio de la Llave,206,206 Nanchital de Lázaro Cárdenas del Río,Total,1163,1140,23,567
30 Veracruz de Ignacio de la Llave,206,206 Nanchital de Lázaro Cárdenas del Río,Total,909,885,24,656
30 Veracruz de Ignacio de la Llave,206,206 Nanchital de Lázaro Cárdenas del Río,Total,363,350,13,719
30 Veracruz de Ignacio de la Llave,206,206 Nanchital de Lázaro Cárdenas del Río,Total,200,195,5,619
30 Veracruz de Ignacio de la Llave,206,206 Nanchital de Lázaro Cárdenas del Río,Total,97,91,6,489
30 Veracruz de Ignacio de la Llave,206,206 Nanchital de Lázaro Cárdenas del Río,Total,75,72,3,372
30 Veracruz de Ignacio de la Llave,206,206 Nanchital de Lázaro Cárdenas del Río,Total,31,29,2,222
30 Veracruz de Ignacio de la Llave,206,206 Nanchital de Lázaro Cárdenas del Río,Total,16,15,1,144
30 Veracruz de Ignacio de la Llave,206,206 Nanchital de Lázaro Cárdenas del Río,Total,3,3,0,102
30 Veracruz de Ignacio de la Llave,206,206 Nanchital de Lázaro Cárdenas del Río,Hombres,6625,6242,383,3525
30 Veracruz de Ignacio de la Llave,206,206 Nanchital de Lázaro Cárdenas del Río,Hombres,11,7,4,713
30 Veracruz de Ignacio de la Llave,206,206 Nanchital de Lázaro Cárdenas del Río,Hombres,321,256,65,1018
30 Veracruz de Ignacio de la Llave,206,206 Nanchital de Lázaro Cárdenas del Río,Hombres,787,692,95,374
30 Veracruz de Ignacio de la Llave,206,206 Nanchital de Lázaro Cárdenas del Río,Hombres,957,895,62,56
30 Veracruz de Ignacio de la Llave,206,206 Nanchital de Lázaro Cárdenas del Río,Hombres,819,794,25,29
30 Veracruz de Ignacio de la Llave,206,206 Nanchital de Lázaro Cárdenas del Río,Hombres,875,839,36,21
30 Veracruz de Ignacio de la Llave,206,206 Nanchital de Lázaro Cárdenas del Río,Hombres,897,871,26,26
30 Veracruz de Ignacio de la Llave,206,206 Nanchital de Lázaro Cárdenas del Río,Hombres,783,762,21,55
30 Veracruz de Ignacio de la Llave,206,206 Nanchital de Lázaro Cárdenas del Río,Hombres,649,627,22,139
30 Veracruz de Ignacio de la Llave,206,206 Nanchital de Lázaro Cárdenas del Río,Hombres,235,224,11,271
30 Veracruz de Ignacio de la Llave,206,206 Nanchital de Lázaro Cárdenas del Río,Hombres,130,125,5,259
30 Veracruz de Ignacio de la Llave,206,206 Nanchital de Lázaro Cárdenas del Río,Hombres,70,64,6,202
30 Veracruz de Ignacio de la Llave,206,206 Nanchital de Lázaro Cárdenas del Río,Hombres,51,48,3,170
30 Veracruz de Ignacio de la Llave,206,206 Nanchital de Lázaro Cárdenas del Río,Hombres,23,21,2,94
30 Veracruz de Ignacio de la Llave,206,206 Nanchital de Lázaro Cárdenas del Río,Hombres,15,15,0,55
30 Veracruz de Ignacio de la Llave,206,206 Nanchital de Lázaro Cárdenas del Río,Hombres,2,2,0,43
30 Veracruz de Ignacio de la Llave,206,206 Nanchital de Lázaro Cárdenas del Río,Mujeres,3592,3477,115,7536
30 Veracruz de Ignacio de la Llave,206,206 Nanchital de Lázaro Cárdenas del Río,Mujeres,9,8,1,677
30 Veracruz de Ignacio de la Llave,206,206 Nanchital de Lázaro Cárdenas del Río,Mujeres,137,126,11,1146
30 Veracruz de Ignacio de la Llave,206,206 Nanchital de Lázaro Cárdenas del Río,Mujeres,442,396,46,746
30 Veracruz de Ignacio de la Llave,206,206 Nanchital de Lázaro Cárdenas del Río,Mujeres,591,563,28,576
30 Veracruz de Ignacio de la Llave,206,206 Nanchital de Lázaro Cárdenas del Río,Mujeres,489,479,10,594
30 Veracruz de Ignacio de la Llave,206,206 Nanchital de Lázaro Cárdenas del Río,Mujeres,524,516,8,623
30 Veracruz de Ignacio de la Llave,206,206 Nanchital de Lázaro Cárdenas del Río,Mujeres,501,497,4,572
30 Veracruz de Ignacio de la Llave,206,206 Nanchital de Lázaro Cárdenas del Río,Mujeres,380,378,2,512
30 Veracruz de Ignacio de la Llave,206,206 Nanchital de Lázaro Cárdenas del Río,Mujeres,260,258,2,517
30 Veracruz de Ignacio de la Llave,206,206 Nanchital de Lázaro Cárdenas del Río,Mujeres,128,126,2,448
30 Veracruz de Ignacio de la Llave,206,206 Nanchital de Lázaro Cárdenas del Río,Mujeres,70,70,0,360
30 Veracruz de Ignacio de la Llave,206,206 Nanchital de Lázaro Cárdenas del Río,Mujeres,27,27,0,287
30 Veracruz de Ignacio de la Llave,206,206 Nanchital de Lázaro Cárdenas del Río,Mujeres,24,24,0,202
30 Veracruz de Ignacio de la Llave,206,206 Nanchital de Lázaro Cárdenas del Río,Mujeres,8,8,0,128
30 Veracruz de Ignacio de la Llave,206,206 Nanchital de Lázaro Cárdenas del Río,Mujeres,1,0,1,89
30 Veracruz de Ignacio de la Llave,206,206 Nanchital de Lázaro Cárdenas del Río,Mujeres,1,1,0,59
30 Veracruz de Ignacio de la Llave,112,112 Naolinco,Total,8415,8299,116,7284
30 Veracruz de Ignacio de la Llave,112,112 Naolinco,Total,156,155,1,1050
30 Veracruz de Ignacio de la Llave,112,112 Naolinco,Total,813,795,18,1201
30 Veracruz de Ignacio de la Llave,112,112 Naolinco,Total,1037,1017,20,680
30 Veracruz de Ignacio de la Llave,112,112 Naolinco,Total,1013,994,19,531
30 Veracruz de Ignacio de la Llave,112,112 Naolinco,Total,990,980,10,531
30 Veracruz de Ignacio de la Llave,112,112 Naolinco,Total,991,985,6,518
30 Veracruz de Ignacio de la Llave,112,112 Naolinco,Total,826,817,9,408
30 Veracruz de Ignacio de la Llave,112,112 Naolinco,Total,736,729,7,335
30 Veracruz de Ignacio de la Llave,112,112 Naolinco,Total,582,573,9,385
30 Veracruz de Ignacio de la Llave,112,112 Naolinco,Total,414,413,1,352
30 Veracruz de Ignacio de la Llave,112,112 Naolinco,Total,320,313,7,299
30 Veracruz de Ignacio de la Llave,112,112 Naolinco,Total,231,231,0,266
30 Veracruz de Ignacio de la Llave,112,112 Naolinco,Total,158,154,4,244
30 Veracruz de Ignacio de la Llave,112,112 Naolinco,Total,82,80,2,200
30 Veracruz de Ignacio de la Llave,112,112 Naolinco,Total,38,35,3,130
30 Veracruz de Ignacio de la Llave,112,112 Naolinco,Total,28,28,0,154
30 Veracruz de Ignacio de la Llave,112,112 Naolinco,Hombres,5977,5874,103,1548
30 Veracruz de Ignacio de la Llave,112,112 Naolinco,Hombres,115,114,1,500
30 Veracruz de Ignacio de la Llave,112,112 Naolinco,Hombres,589,574,15,412
30 Veracruz de Ignacio de la Llave,112,112 Naolinco,Hombres,673,661,12,146
30 Veracruz de Ignacio de la Llave,112,112 Naolinco,Hombres,679,661,18,30
30 Veracruz de Ignacio de la Llave,112,112 Naolinco,Hombres,685,676,9,22
30 Veracruz de Ignacio de la Llave,112,112 Naolinco,Hombres,681,675,6,15
30 Veracruz de Ignacio de la Llave,112,112 Naolinco,Hombres,574,565,9,17
30 Veracruz de Ignacio de la Llave,112,112 Naolinco,Hombres,504,497,7,14
30 Veracruz de Ignacio de la Llave,112,112 Naolinco,Hombres,434,425,9,32
30 Veracruz de Ignacio de la Llave,112,112 Naolinco,Hombres,320,319,1,33
30 Veracruz de Ignacio de la Llave,112,112 Naolinco,Hombres,263,256,7,51
30 Veracruz de Ignacio de la Llave,112,112 Naolinco,Hombres,201,201,0,55
30 Veracruz de Ignacio de la Llave,112,112 Naolinco,Hombres,130,126,4,65
30 Veracruz de Ignacio de la Llave,112,112 Naolinco,Hombres,69,67,2,55
30 Veracruz de Ignacio de la Llave,112,112 Naolinco,Hombres,37,34,3,50
30 Veracruz de Ignacio de la Llave,112,112 Naolinco,Hombres,23,23,0,51
30 Veracruz de Ignacio de la Llave,112,112 Naolinco,Mujeres,2438,2425,13,5736
30 Veracruz de Ignacio de la Llave,112,112 Naolinco,Mujeres,41,41,0,550
30 Veracruz de Ignacio de la Llave,112,112 Naolinco,Mujeres,224,221,3,789
30 Veracruz de Ignacio de la Llave,112,112 Naolinco,Mujeres,364,356,8,534
30 Veracruz de Ignacio de la Llave,112,112 Naolinco,Mujeres,334,333,1,501
30 Veracruz de Ignacio de la Llave,112,112 Naolinco,Mujeres,305,304,1,509
30 Veracruz de Ignacio de la Llave,112,112 Naolinco,Mujeres,310,310,0,503
30 Veracruz de Ignacio de la Llave,112,112 Naolinco,Mujeres,252,252,0,391
30 Veracruz de Ignacio de la Llave,112,112 Naolinco,Mujeres,232,232,0,321
30 Veracruz de Ignacio de la Llave,112,112 Naolinco,Mujeres,148,148,0,353
30 Veracruz de Ignacio de la Llave,112,112 Naolinco,Mujeres,94,94,0,319
30 Veracruz de Ignacio de la Llave,112,112 Naolinco,Mujeres,57,57,0,248
30 Veracruz de Ignacio de la Llave,112,112 Naolinco,Mujeres,30,30,0,211
30 Veracruz de Ignacio de la Llave,112,112 Naolinco,Mujeres,28,28,0,179
30 Veracruz de Ignacio de la Llave,112,112 Naolinco,Mujeres,13,13,0,145
30 Veracruz de Ignacio de la Llave,112,112 Naolinco,Mujeres,1,1,0,80
30 Veracruz de Ignacio de la Llave,112,112 Naolinco,Mujeres,5,5,0,103
30 Veracruz de Ignacio de la Llave,113,113 Naranjal,Total,1494,1467,27,1811
30 Veracruz de Ignacio de la Llave,113,113 Naranjal,Total,10,10,0,266
30 Veracruz de Ignacio de la Llave,113,113 Naranjal,Total,110,103,7,382
30 Veracruz de Ignacio de la Llave,113,113 Naranjal,Total,212,209,3,182
30 Veracruz de Ignacio de la Llave,113,113 Naranjal,Total,197,192,5,126
30 Veracruz de Ignacio de la Llave,113,113 Naranjal,Total,182,179,3,129
30 Veracruz de Ignacio de la Llave,113,113 Naranjal,Total,185,181,4,114
30 Veracruz de Ignacio de la Llave,113,113 Naranjal,Total,139,138,1,100
30 Veracruz de Ignacio de la Llave,113,113 Naranjal,Total,125,123,2,81
30 Veracruz de Ignacio de la Llave,113,113 Naranjal,Total,90,90,0,74
30 Veracruz de Ignacio de la Llave,113,113 Naranjal,Total,89,88,1,67
30 Veracruz de Ignacio de la Llave,113,113 Naranjal,Total,54,53,1,54
30 Veracruz de Ignacio de la Llave,113,113 Naranjal,Total,45,45,0,60
30 Veracruz de Ignacio de la Llave,113,113 Naranjal,Total,30,30,0,63
30 Veracruz de Ignacio de la Llave,113,113 Naranjal,Total,17,17,0,51
30 Veracruz de Ignacio de la Llave,113,113 Naranjal,Total,7,7,0,29
30 Veracruz de Ignacio de la Llave,113,113 Naranjal,Total,2,2,0,33
30 Veracruz de Ignacio de la Llave,113,113 Naranjal,Hombres,1066,1043,23,478
30 Veracruz de Ignacio de la Llave,113,113 Naranjal,Hombres,7,7,0,124
30 Veracruz de Ignacio de la Llave,113,113 Naranjal,Hombres,84,77,7,165
30 Veracruz de Ignacio de la Llave,113,113 Naranjal,Hombres,142,141,1,31
30 Veracruz de Ignacio de la Llave,113,113 Naranjal,Hombres,133,129,4,11
30 Veracruz de Ignacio de la Llave,113,113 Naranjal,Hombres,118,115,3,14
30 Veracruz de Ignacio de la Llave,113,113 Naranjal,Hombres,135,131,4,13
30 Veracruz de Ignacio de la Llave,113,113 Naranjal,Hombres,99,98,1,11
30 Veracruz de Ignacio de la Llave,113,113 Naranjal,Hombres,95,93,2,7
30 Veracruz de Ignacio de la Llave,113,113 Naranjal,Hombres,61,61,0,11
30 Veracruz de Ignacio de la Llave,113,113 Naranjal,Hombres,66,66,0,12
30 Veracruz de Ignacio de la Llave,113,113 Naranjal,Hombres,44,43,1,8
30 Veracruz de Ignacio de la Llave,113,113 Naranjal,Hombres,36,36,0,11
30 Veracruz de Ignacio de la Llave,113,113 Naranjal,Hombres,23,23,0,20
30 Veracruz de Ignacio de la Llave,113,113 Naranjal,Hombres,17,17,0,18
30 Veracruz de Ignacio de la Llave,113,113 Naranjal,Hombres,5,5,0,8
30 Veracruz de Ignacio de la Llave,113,113 Naranjal,Hombres,1,1,0,14
30 Veracruz de Ignacio de la Llave,113,113 Naranjal,Mujeres,428,424,4,1333
30 Veracruz de Ignacio de la Llave,113,113 Naranjal,Mujeres,3,3,0,142
30 Veracruz de Ignacio de la Llave,113,113 Naranjal,Mujeres,26,26,0,217
30 Veracruz de Ignacio de la Llave,113,113 Naranjal,Mujeres,70,68,2,151
30 Veracruz de Ignacio de la Llave,113,113 Naranjal,Mujeres,64,63,1,115
30 Veracruz de Ignacio de la Llave,113,113 Naranjal,Mujeres,64,64,0,115
30 Veracruz de Ignacio de la Llave,113,113 Naranjal,Mujeres,50,50,0,101
30 Veracruz de Ignacio de la Llave,113,113 Naranjal,Mujeres,40,40,0,89
30 Veracruz de Ignacio de la Llave,113,113 Naranjal,Mujeres,30,30,0,74
30 Veracruz de Ignacio de la Llave,113,113 Naranjal,Mujeres,29,29,0,63
30 Veracruz de Ignacio de la Llave,113,113 Naranjal,Mujeres,23,22,1,55
30 Veracruz de Ignacio de la Llave,113,113 Naranjal,Mujeres,10,10,0,46
30 Veracruz de Ignacio de la Llave,113,113 Naranjal,Mujeres,9,9,0,49
30 Veracruz de Ignacio de la Llave,113,113 Naranjal,Mujeres,7,7,0,43
30 Veracruz de Ignacio de la Llave,113,113 Naranjal,Mujeres,0,0,0,33
30 Veracruz de Ignacio de la Llave,113,113 Naranjal,Mujeres,2,2,0,21
30 Veracruz de Ignacio de la Llave,113,113 Naranjal,Mujeres,1,1,0,19
30 Veracruz de Ignacio de la Llave,13,013 Naranjos Amatlán,Total,10748,10395,353,10638
30 Veracruz de Ignacio de la Llave,13,013 Naranjos Amatlán,Total,64,62,2,1423
30 Veracruz de Ignacio de la Llave,13,013 Naranjos Amatlán,Total,591,549,42,1973
30 Veracruz de Ignacio de la Llave,13,013 Naranjos Amatlán,Total,1169,1090,79,1003
30 Veracruz de Ignacio de la Llave,13,013 Naranjos Amatlán,Total,1221,1174,47,602
30 Veracruz de Ignacio de la Llave,13,013 Naranjos Amatlán,Total,1102,1082,20,524
30 Veracruz de Ignacio de la Llave,13,013 Naranjos Amatlán,Total,1224,1195,29,527
30 Veracruz de Ignacio de la Llave,13,013 Naranjos Amatlán,Total,1258,1228,30,558
30 Veracruz de Ignacio de la Llave,13,013 Naranjos Amatlán,Total,1265,1240,25,525
30 Veracruz de Ignacio de la Llave,13,013 Naranjos Amatlán,Total,971,944,27,526
30 Veracruz de Ignacio de la Llave,13,013 Naranjos Amatlán,Total,654,636,18,543
30 Veracruz de Ignacio de la Llave,13,013 Naranjos Amatlán,Total,488,475,13,531
30 Veracruz de Ignacio de la Llave,13,013 Naranjos Amatlán,Total,309,299,10,529
30 Veracruz de Ignacio de la Llave,13,013 Naranjos Amatlán,Total,233,228,5,519
30 Veracruz de Ignacio de la Llave,13,013 Naranjos Amatlán,Total,124,122,2,364
30 Veracruz de Ignacio de la Llave,13,013 Naranjos Amatlán,Total,47,43,4,270
30 Veracruz de Ignacio de la Llave,13,013 Naranjos Amatlán,Total,28,28,0,221
30 Veracruz de Ignacio de la Llave,13,013 Naranjos Amatlán,Hombres,7132,6838,294,2861
30 Veracruz de Ignacio de la Llave,13,013 Naranjos Amatlán,Hombres,51,49,2,695
30 Veracruz de Ignacio de la Llave,13,013 Naranjos Amatlán,Hombres,414,381,33,877
30 Veracruz de Ignacio de la Llave,13,013 Naranjos Amatlán,Hombres,751,694,57,299
30 Veracruz de Ignacio de la Llave,13,013 Naranjos Amatlán,Hombres,770,738,32,55
30 Veracruz de Ignacio de la Llave,13,013 Naranjos Amatlán,Hombres,719,703,16,20
30 Veracruz de Ignacio de la Llave,13,013 Naranjos Amatlán,Hombres,781,755,26,21
30 Veracruz de Ignacio de la Llave,13,013 Naranjos Amatlán,Hombres,798,769,29,20
30 Veracruz de Ignacio de la Llave,13,013 Naranjos Amatlán,Hombres,837,814,23,31
30 Veracruz de Ignacio de la Llave,13,013 Naranjos Amatlán,Hombres,631,606,25,52
30 Veracruz de Ignacio de la Llave,13,013 Naranjos Amatlán,Hombres,459,442,17,97
30 Veracruz de Ignacio de la Llave,13,013 Naranjos Amatlán,Hombres,341,328,13,123
30 Veracruz de Ignacio de la Llave,13,013 Naranjos Amatlán,Hombres,237,227,10,119
30 Veracruz de Ignacio de la Llave,13,013 Naranjos Amatlán,Hombres,175,170,5,162
30 Veracruz de Ignacio de la Llave,13,013 Naranjos Amatlán,Hombres,103,101,2,123
30 Veracruz de Ignacio de la Llave,13,013 Naranjos Amatlán,Hombres,39,35,4,91
30 Veracruz de Ignacio de la Llave,13,013 Naranjos Amatlán,Hombres,26,26,0,76
30 Veracruz de Ignacio de la Llave,13,013 Naranjos Amatlán,Mujeres,3616,3557,59,7777
30 Veracruz de Ignacio de la Llave,13,013 Naranjos Amatlán,Mujeres,13,13,0,728
30 Veracruz de Ignacio de la Llave,13,013 Naranjos Amatlán,Mujeres,177,168,9,1096
30 Veracruz de Ignacio de la Llave,13,013 Naranjos Amatlán,Mujeres,418,396,22,704
30 Veracruz de Ignacio de la Llave,13,013 Naranjos Amatlán,Mujeres,451,436,15,547
30 Veracruz de Ignacio de la Llave,13,013 Naranjos Amatlán,Mujeres,383,379,4,504
30 Veracruz de Ignacio de la Llave,13,013 Naranjos Amatlán,Mujeres,443,440,3,506
30 Veracruz de Ignacio de la Llave,13,013 Naranjos Amatlán,Mujeres,460,459,1,538
30 Veracruz de Ignacio de la Llave,13,013 Naranjos Amatlán,Mujeres,428,426,2,494
30 Veracruz de Ignacio de la Llave,13,013 Naranjos Amatlán,Mujeres,340,338,2,474
30 Veracruz de Ignacio de la Llave,13,013 Naranjos Amatlán,Mujeres,195,194,1,446
30 Veracruz de Ignacio de la Llave,13,013 Naranjos Amatlán,Mujeres,147,147,0,408
30 Veracruz de Ignacio de la Llave,13,013 Naranjos Amatlán,Mujeres,72,72,0,410
30 Veracruz de Ignacio de la Llave,13,013 Naranjos Amatlán,Mujeres,58,58,0,357
30 Veracruz de Ignacio de la Llave,13,013 Naranjos Amatlán,Mujeres,21,21,0,241
30 Veracruz de Ignacio de la Llave,13,013 Naranjos Amatlán,Mujeres,8,8,0,179
30 Veracruz de Ignacio de la Llave,13,013 Naranjos Amatlán,Mujeres,2,2,0,145
30 Veracruz de Ignacio de la Llave,114,114 Nautla,Total,3576,3428,148,4401
30 Veracruz de Ignacio de la Llave,114,114 Nautla,Total,16,16,0,595
30 Veracruz de Ignacio de la Llave,114,114 Nautla,Total,226,210,16,743
30 Veracruz de Ignacio de la Llave,114,114 Nautla,Total,350,322,28,346
30 Veracruz de Ignacio de la Llave,114,114 Nautla,Total,314,302,12,207
30 Veracruz de Ignacio de la Llave,114,114 Nautla,Total,346,333,13,284
30 Veracruz de Ignacio de la Llave,114,114 Nautla,Total,414,404,10,279
30 Veracruz de Ignacio de la Llave,114,114 Nautla,Total,418,408,10,275
30 Veracruz de Ignacio de la Llave,114,114 Nautla,Total,380,360,20,237
30 Veracruz de Ignacio de la Llave,114,114 Nautla,Total,306,293,13,225
30 Veracruz de Ignacio de la Llave,114,114 Nautla,Total,215,208,7,208
30 Veracruz de Ignacio de la Llave,114,114 Nautla,Total,202,189,13,223
30 Veracruz de Ignacio de la Llave,114,114 Nautla,Total,166,163,3,242
30 Veracruz de Ignacio de la Llave,114,114 Nautla,Total,112,111,1,185
30 Veracruz de Ignacio de la Llave,114,114 Nautla,Total,60,59,1,151
30 Veracruz de Ignacio de la Llave,114,114 Nautla,Total,33,33,0,96
30 Veracruz de Ignacio de la Llave,114,114 Nautla,Total,18,17,1,105
30 Veracruz de Ignacio de la Llave,114,114 Nautla,Hombres,2776,2657,119,1073
30 Veracruz de Ignacio de la Llave,114,114 Nautla,Hombres,11,11,0,290
30 Veracruz de Ignacio de la Llave,114,114 Nautla,Hombres,178,168,10,298
30 Veracruz de Ignacio de la Llave,114,114 Nautla,Hombres,250,233,17,70
30 Veracruz de Ignacio de la Llave,114,114 Nautla,Hombres,235,227,8,14
30 Veracruz de Ignacio de la Llave,114,114 Nautla,Hombres,249,239,10,19
30 Veracruz de Ignacio de la Llave,114,114 Nautla,Hombres,309,300,9,15
30 Veracruz de Ignacio de la Llave,114,114 Nautla,Hombres,311,301,10,23
30 Veracruz de Ignacio de la Llave,114,114 Nautla,Hombres,288,269,19,24
30 Veracruz de Ignacio de la Llave,114,114 Nautla,Hombres,240,230,10,23
30 Veracruz de Ignacio de la Llave,114,114 Nautla,Hombres,177,170,7,25
30 Veracruz de Ignacio de la Llave,114,114 Nautla,Hombres,174,161,13,39
30 Veracruz de Ignacio de la Llave,114,114 Nautla,Hombres,145,142,3,48
30 Veracruz de Ignacio de la Llave,114,114 Nautla,Hombres,101,100,1,58
30 Veracruz de Ignacio de la Llave,114,114 Nautla,Hombres,57,56,1,45
30 Veracruz de Ignacio de la Llave,114,114 Nautla,Hombres,33,33,0,31
30 Veracruz de Ignacio de la Llave,114,114 Nautla,Hombres,18,17,1,51
30 Veracruz de Ignacio de la Llave,114,114 Nautla,Mujeres,800,771,29,3328
30 Veracruz de Ignacio de la Llave,114,114 Nautla,Mujeres,5,5,0,305
30 Veracruz de Ignacio de la Llave,114,114 Nautla,Mujeres,48,42,6,445
30 Veracruz de Ignacio de la Llave,114,114 Nautla,Mujeres,100,89,11,276
30 Veracruz de Ignacio de la Llave,114,114 Nautla,Mujeres,79,75,4,193
30 Veracruz de Ignacio de la Llave,114,114 Nautla,Mujeres,97,94,3,265
30 Veracruz de Ignacio de la Llave,114,114 Nautla,Mujeres,105,104,1,264
30 Veracruz de Ignacio de la Llave,114,114 Nautla,Mujeres,107,107,0,252
30 Veracruz de Ignacio de la Llave,114,114 Nautla,Mujeres,92,91,1,213
30 Veracruz de Ignacio de la Llave,114,114 Nautla,Mujeres,66,63,3,202
30 Veracruz de Ignacio de la Llave,114,114 Nautla,Mujeres,38,38,0,183
30 Veracruz de Ignacio de la Llave,114,114 Nautla,Mujeres,28,28,0,184
30 Veracruz de Ignacio de la Llave,114,114 Nautla,Mujeres,21,21,0,194
30 Veracruz de Ignacio de la Llave,114,114 Nautla,Mujeres,11,11,0,127
30 Veracruz de Ignacio de la Llave,114,114 Nautla,Mujeres,3,3,0,106
30 Veracruz de Ignacio de la Llave,114,114 Nautla,Mujeres,0,0,0,65
30 Veracruz de Ignacio de la Llave,114,114 Nautla,Mujeres,0,0,0,54
30 Veracruz de Ignacio de la Llave,115,115 Nogales,Total,13326,12455,871,13332
30 Veracruz de Ignacio de la Llave,115,115 Nogales,Total,78,66,12,1795
30 Veracruz de Ignacio de la Llave,115,115 Nogales,Total,852,751,101,2466
30 Veracruz de Ignacio de la Llave,115,115 Nogales,Total,1639,1476,163,1421
30 Veracruz de Ignacio de la Llave,115,115 Nogales,Total,1751,1604,147,874
30 Veracruz de Ignacio de la Llave,115,115 Nogales,Total,1695,1608,87,751
30 Veracruz de Ignacio de la Llave,115,115 Nogales,Total,1809,1732,77,669
30 Veracruz de Ignacio de la Llave,115,115 Nogales,Total,1456,1392,64,596
30 Veracruz de Ignacio de la Llave,115,115 Nogales,Total,1237,1176,61,587
30 Veracruz de Ignacio de la Llave,115,115 Nogales,Total,1055,996,59,597
30 Veracruz de Ignacio de la Llave,115,115 Nogales,Total,737,696,41,581
30 Veracruz de Ignacio de la Llave,115,115 Nogales,Total,439,407,32,699
30 Veracruz de Ignacio de la Llave,115,115 Nogales,Total,254,240,14,623
30 Veracruz de Ignacio de la Llave,115,115 Nogales,Total,160,157,3,591
30 Veracruz de Ignacio de la Llave,115,115 Nogales,Total,104,97,7,441
30 Veracruz de Ignacio de la Llave,115,115 Nogales,Total,37,36,1,320
30 Veracruz de Ignacio de la Llave,115,115 Nogales,Total,23,21,2,321
30 Veracruz de Ignacio de la Llave,115,115 Nogales,Hombres,8718,8012,706,3787
30 Veracruz de Ignacio de la Llave,115,115 Nogales,Hombres,57,47,10,906
30 Veracruz de Ignacio de la Llave,115,115 Nogales,Hombres,664,583,81,1009
30 Veracruz de Ignacio de la Llave,115,115 Nogales,Hombres,1110,993,117,365
30 Veracruz de Ignacio de la Llave,115,115 Nogales,Hombres,1144,1028,116,71
30 Veracruz de Ignacio de la Llave,115,115 Nogales,Hombres,1092,1019,73,41
30 Veracruz de Ignacio de la Llave,115,115 Nogales,Hombres,1087,1034,53,37
30 Veracruz de Ignacio de la Llave,115,115 Nogales,Hombres,892,840,52,41
30 Veracruz de Ignacio de la Llave,115,115 Nogales,Hombres,782,729,53,46
30 Veracruz de Ignacio de la Llave,115,115 Nogales,Hombres,661,605,56,87
30 Veracruz de Ignacio de la Llave,115,115 Nogales,Hombres,490,451,39,112
30 Veracruz de Ignacio de la Llave,115,115 Nogales,Hombres,323,293,30,215
30 Veracruz de Ignacio de la Llave,115,115 Nogales,Hombres,170,157,13,217
30 Veracruz de Ignacio de la Llave,115,115 Nogales,Hombres,119,116,3,214
30 Veracruz de Ignacio de la Llave,115,115 Nogales,Hombres,80,73,7,186
30 Veracruz de Ignacio de la Llave,115,115 Nogales,Hombres,31,30,1,117
30 Veracruz de Ignacio de la Llave,115,115 Nogales,Hombres,16,14,2,123
30 Veracruz de Ignacio de la Llave,115,115 Nogales,Mujeres,4608,4443,165,9545
30 Veracruz de Ignacio de la Llave,115,115 Nogales,Mujeres,21,19,2,889
30 Veracruz de Ignacio de la Llave,115,115 Nogales,Mujeres,188,168,20,1457
30 Veracruz de Ignacio de la Llave,115,115 Nogales,Mujeres,529,483,46,1056
30 Veracruz de Ignacio de la Llave,115,115 Nogales,Mujeres,607,576,31,803
30 Veracruz de Ignacio de la Llave,115,115 Nogales,Mujeres,603,589,14,710
30 Veracruz de Ignacio de la Llave,115,115 Nogales,Mujeres,722,698,24,632
30 Veracruz de Ignacio de la Llave,115,115 Nogales,Mujeres,564,552,12,555
30 Veracruz de Ignacio de la Llave,115,115 Nogales,Mujeres,455,447,8,541
30 Veracruz de Ignacio de la Llave,115,115 Nogales,Mujeres,394,391,3,510
30 Veracruz de Ignacio de la Llave,115,115 Nogales,Mujeres,247,245,2,469
30 Veracruz de Ignacio de la Llave,115,115 Nogales,Mujeres,116,114,2,484
30 Veracruz de Ignacio de la Llave,115,115 Nogales,Mujeres,84,83,1,406
30 Veracruz de Ignacio de la Llave,115,115 Nogales,Mujeres,41,41,0,377
30 Veracruz de Ignacio de la Llave,115,115 Nogales,Mujeres,24,24,0,255
30 Veracruz de Ignacio de la Llave,115,115 Nogales,Mujeres,6,6,0,203
30 Veracruz de Ignacio de la Llave,115,115 Nogales,Mujeres,7,7,0,198
30 Veracruz de Ignacio de la Llave,116,116 Oluta,Total,5839,5597,242,5634
30 Veracruz de Ignacio de la Llave,116,116 Oluta,Total,67,54,13,872
30 Veracruz de Ignacio de la Llave,116,116 Oluta,Total,461,418,43,1132
30 Veracruz de Ignacio de la Llave,116,116 Oluta,Total,760,726,34,542
30 Veracruz de Ignacio de la Llave,116,116 Oluta,Total,729,695,34,414
30 Veracruz de Ignacio de la Llave,116,116 Oluta,Total,653,632,21,387
30 Veracruz de Ignacio de la Llave,116,116 Oluta,Total,715,698,17,345
30 Veracruz de Ignacio de la Llave,116,116 Oluta,Total,618,604,14,309
30 Veracruz de Ignacio de la Llave,116,116 Oluta,Total,538,523,15,300
30 Veracruz de Ignacio de la Llave,116,116 Oluta,Total,432,418,14,254
30 Veracruz de Ignacio de la Llave,116,116 Oluta,Total,338,319,19,252
30 Veracruz de Ignacio de la Llave,116,116 Oluta,Total,192,188,4,205
30 Veracruz de Ignacio de la Llave,116,116 Oluta,Total,140,133,7,183
30 Veracruz de Ignacio de la Llave,116,116 Oluta,Total,108,104,4,146
30 Veracruz de Ignacio de la Llave,116,116 Oluta,Total,53,51,2,129
30 Veracruz de Ignacio de la Llave,116,116 Oluta,Total,20,19,1,72
30 Veracruz de Ignacio de la Llave,116,116 Oluta,Total,15,15,0,92
30 Veracruz de Ignacio de la Llave,116,116 Oluta,Hombres,4053,3862,191,1358
30 Veracruz de Ignacio de la Llave,116,116 Oluta,Hombres,47,39,8,430
30 Veracruz de Ignacio de la Llave,116,116 Oluta,Hombres,352,321,31,474
30 Veracruz de Ignacio de la Llave,116,116 Oluta,Hombres,506,484,22,124
30 Veracruz de Ignacio de la Llave,116,116 Oluta,Hombres,465,444,21,23
30 Veracruz de Ignacio de la Llave,116,116 Oluta,Hombres,420,403,17,9
30 Veracruz de Ignacio de la Llave,116,116 Oluta,Hombres,471,455,16,10
30 Veracruz de Ignacio de la Llave,116,116 Oluta,Hombres,412,400,12,12
30 Veracruz de Ignacio de la Llave,116,116 Oluta,Hombres,377,363,14,20
30 Veracruz de Ignacio de la Llave,116,116 Oluta,Hombres,330,317,13,19
30 Veracruz de Ignacio de la Llave,116,116 Oluta,Hombres,259,240,19,33
30 Veracruz de Ignacio de la Llave,116,116 Oluta,Hombres,137,133,4,36
30 Veracruz de Ignacio de la Llave,116,116 Oluta,Hombres,112,105,7,39
30 Veracruz de Ignacio de la Llave,116,116 Oluta,Hombres,91,87,4,28
30 Veracruz de Ignacio de la Llave,116,116 Oluta,Hombres,43,41,2,47
30 Veracruz de Ignacio de la Llave,116,116 Oluta,Hombres,18,17,1,21
30 Veracruz de Ignacio de la Llave,116,116 Oluta,Hombres,13,13,0,33
30 Veracruz de Ignacio de la Llave,116,116 Oluta,Mujeres,1786,1735,51,4276
30 Veracruz de Ignacio de la Llave,116,116 Oluta,Mujeres,20,15,5,442
30 Veracruz de Ignacio de la Llave,116,116 Oluta,Mujeres,109,97,12,658
30 Veracruz de Ignacio de la Llave,116,116 Oluta,Mujeres,254,242,12,418
30 Veracruz de Ignacio de la Llave,116,116 Oluta,Mujeres,264,251,13,391
30 Veracruz de Ignacio de la Llave,116,116 Oluta,Mujeres,233,229,4,378
30 Veracruz de Ignacio de la Llave,116,116 Oluta,Mujeres,244,243,1,335
30 Veracruz de Ignacio de la Llave,116,116 Oluta,Mujeres,206,204,2,297
30 Veracruz de Ignacio de la Llave,116,116 Oluta,Mujeres,161,160,1,280
30 Veracruz de Ignacio de la Llave,116,116 Oluta,Mujeres,102,101,1,235
30 Veracruz de Ignacio de la Llave,116,116 Oluta,Mujeres,79,79,0,219
30 Veracruz de Ignacio de la Llave,116,116 Oluta,Mujeres,55,55,0,169
30 Veracruz de Ignacio de la Llave,116,116 Oluta,Mujeres,28,28,0,144
30 Veracruz de Ignacio de la Llave,116,116 Oluta,Mujeres,17,17,0,118
30 Veracruz de Ignacio de la Llave,116,116 Oluta,Mujeres,10,10,0,82
30 Veracruz de Ignacio de la Llave,116,116 Oluta,Mujeres,2,2,0,51
30 Veracruz de Ignacio de la Llave,116,116 Oluta,Mujeres,2,2,0,59
30 Veracruz de Ignacio de la Llave,117,117 Omealca,Total,7383,7175,208,9810
30 Veracruz de Ignacio de la Llave,117,117 Omealca,Total,80,76,4,1261
30 Veracruz de Ignacio de la Llave,117,117 Omealca,Total,687,658,29,1586
30 Veracruz de Ignacio de la Llave,117,117 Omealca,Total,1032,992,40,947
30 Veracruz de Ignacio de la Llave,117,117 Omealca,Total,815,785,30,718
30 Veracruz de Ignacio de la Llave,117,117 Omealca,Total,845,822,23,743
30 Veracruz de Ignacio de la Llave,117,117 Omealca,Total,877,860,17,749
30 Veracruz de Ignacio de la Llave,117,117 Omealca,Total,749,731,18,607
30 Veracruz de Ignacio de la Llave,117,117 Omealca,Total,656,643,13,536
30 Veracruz de Ignacio de la Llave,117,117 Omealca,Total,517,502,15,496
30 Veracruz de Ignacio de la Llave,117,117 Omealca,Total,432,425,7,379
30 Veracruz de Ignacio de la Llave,117,117 Omealca,Total,259,259,0,419
30 Veracruz de Ignacio de la Llave,117,117 Omealca,Total,185,181,4,381
30 Veracruz de Ignacio de la Llave,117,117 Omealca,Total,128,124,4,389
30 Veracruz de Ignacio de la Llave,117,117 Omealca,Total,69,68,1,274
30 Veracruz de Ignacio de la Llave,117,117 Omealca,Total,38,36,2,172
30 Veracruz de Ignacio de la Llave,117,117 Omealca,Total,14,13,1,153
30 Veracruz de Ignacio de la Llave,117,117 Omealca,Hombres,5989,5818,171,2087
30 Veracruz de Ignacio de la Llave,117,117 Omealca,Hombres,74,70,4,596
30 Veracruz de Ignacio de la Llave,117,117 Omealca,Hombres,595,567,28,544
30 Veracruz de Ignacio de la Llave,117,117 Omealca,Hombres,779,757,22,118
30 Veracruz de Ignacio de la Llave,117,117 Omealca,Hombres,653,628,25,45
30 Veracruz de Ignacio de la Llave,117,117 Omealca,Hombres,660,644,16,38
30 Veracruz de Ignacio de la Llave,117,117 Omealca,Hombres,710,695,15,32
30 Veracruz de Ignacio de la Llave,117,117 Omealca,Hombres,599,583,16,29
30 Veracruz de Ignacio de la Llave,117,117 Omealca,Hombres,521,509,12,27
30 Veracruz de Ignacio de la Llave,117,117 Omealca,Hombres,424,410,14,39
30 Veracruz de Ignacio de la Llave,117,117 Omealca,Hombres,366,359,7,40
30 Veracruz de Ignacio de la Llave,117,117 Omealca,Hombres,219,219,0,93
30 Veracruz de Ignacio de la Llave,117,117 Omealca,Hombres,159,155,4,121
30 Veracruz de Ignacio de la Llave,117,117 Omealca,Hombres,117,113,4,133
30 Veracruz de Ignacio de la Llave,117,117 Omealca,Hombres,64,63,1,102
30 Veracruz de Ignacio de la Llave,117,117 Omealca,Hombres,35,33,2,70
30 Veracruz de Ignacio de la Llave,117,117 Omealca,Hombres,14,13,1,60
30 Veracruz de Ignacio de la Llave,117,117 Omealca,Mujeres,1394,1357,37,7723
30 Veracruz de Ignacio de la Llave,117,117 Omealca,Mujeres,6,6,0,665
30 Veracruz de Ignacio de la Llave,117,117 Omealca,Mujeres,92,91,1,1042
30 Veracruz de Ignacio de la Llave,117,117 Omealca,Mujeres,253,235,18,829
30 Veracruz de Ignacio de la Llave,117,117 Omealca,Mujeres,162,157,5,673
30 Veracruz de Ignacio de la Llave,117,117 Omealca,Mujeres,185,178,7,705
30 Veracruz de Ignacio de la Llave,117,117 Omealca,Mujeres,167,165,2,717
30 Veracruz de Ignacio de la Llave,117,117 Omealca,Mujeres,150,148,2,578
30 Veracruz de Ignacio de la Llave,117,117 Omealca,Mujeres,135,134,1,509
30 Veracruz de Ignacio de la Llave,117,117 Omealca,Mujeres,93,92,1,457
30 Veracruz de Ignacio de la Llave,117,117 Omealca,Mujeres,66,66,0,339
30 Veracruz de Ignacio de la Llave,117,117 Omealca,Mujeres,40,40,0,326
30 Veracruz de Ignacio de la Llave,117,117 Omealca,Mujeres,26,26,0,260
30 Veracruz de Ignacio de la Llave,117,117 Omealca,Mujeres,11,11,0,256
30 Veracruz de Ignacio de la Llave,117,117 Omealca,Mujeres,5,5,0,172
30 Veracruz de Ignacio de la Llave,117,117 Omealca,Mujeres,3,3,0,102
30 Veracruz de Ignacio de la Llave,117,117 Omealca,Mujeres,0,0,0,93
30 Veracruz de Ignacio de la Llave,118,118 Orizaba,Total,51013,48377,2636,45686
30 Veracruz de Ignacio de la Llave,118,118 Orizaba,Total,131,116,15,5374
30 Veracruz de Ignacio de la Llave,118,118 Orizaba,Total,1987,1748,239,8019
30 Veracruz de Ignacio de la Llave,118,118 Orizaba,Total,5225,4680,545,4814
30 Veracruz de Ignacio de la Llave,118,118 Orizaba,Total,6781,6272,509,2259
30 Veracruz de Ignacio de la Llave,118,118 Orizaba,Total,6619,6358,261,1964
30 Veracruz de Ignacio de la Llave,118,118 Orizaba,Total,6850,6603,247,1977
30 Veracruz de Ignacio de la Llave,118,118 Orizaba,Total,6118,5917,201,1812
30 Veracruz de Ignacio de la Llave,118,118 Orizaba,Total,5352,5173,179,1940
30 Veracruz de Ignacio de la Llave,118,118 Orizaba,Total,4749,4584,165,2323
30 Veracruz de Ignacio de la Llave,118,118 Orizaba,Total,3300,3156,144,2463
30 Veracruz de Ignacio de la Llave,118,118 Orizaba,Total,1799,1724,75,2980
30 Veracruz de Ignacio de la Llave,118,118 Orizaba,Total,949,923,26,2529
30 Veracruz de Ignacio de la Llave,118,118 Orizaba,Total,609,593,16,2401
30 Veracruz de Ignacio de la Llave,118,118 Orizaba,Total,305,296,9,1892
30 Veracruz de Ignacio de la Llave,118,118 Orizaba,Total,162,159,3,1549
30 Veracruz de Ignacio de la Llave,118,118 Orizaba,Total,77,75,2,1390
30 Veracruz de Ignacio de la Llave,118,118 Orizaba,Hombres,29435,27561,1874,14157
30 Veracruz de Ignacio de la Llave,118,118 Orizaba,Hombres,98,85,13,2662
30 Veracruz de Ignacio de la Llave,118,118 Orizaba,Hombres,1325,1137,188,3648
30 Veracruz de Ignacio de la Llave,118,118 Orizaba,Hombres,3067,2738,329,1776
30 Veracruz de Ignacio de la Llave,118,118 Orizaba,Hombres,3825,3487,338,354
30 Veracruz de Ignacio de la Llave,118,118 Orizaba,Hombres,3660,3480,180,133
30 Veracruz de Ignacio de la Llave,118,118 Orizaba,Hombres,3781,3626,155,119
30 Veracruz de Ignacio de la Llave,118,118 Orizaba,Hombres,3433,3288,145,119
30 Veracruz de Ignacio de la Llave,118,118 Orizaba,Hombres,2997,2859,138,176
30 Veracruz de Ignacio de la Llave,118,118 Orizaba,Hombres,2812,2675,137,284
30 Veracruz de Ignacio de la Llave,118,118 Orizaba,Hombres,2061,1929,132,440
30 Veracruz de Ignacio de la Llave,118,118 Orizaba,Hombres,1096,1027,69,966
30 Veracruz de Ignacio de la Llave,118,118 Orizaba,Hombres,580,558,22,905
30 Veracruz de Ignacio de la Llave,118,118 Orizaba,Hombres,364,349,15,874
30 Veracruz de Ignacio de la Llave,118,118 Orizaba,Hombres,192,184,8,670
30 Veracruz de Ignacio de la Llave,118,118 Orizaba,Hombres,95,92,3,536
30 Veracruz de Ignacio de la Llave,118,118 Orizaba,Hombres,49,47,2,495
30 Veracruz de Ignacio de la Llave,118,118 Orizaba,Mujeres,21578,20816,762,31529
30 Veracruz de Ignacio de la Llave,118,118 Orizaba,Mujeres,33,31,2,2712
30 Veracruz de Ignacio de la Llave,118,118 Orizaba,Mujeres,662,611,51,4371
30 Veracruz de Ignacio de la Llave,118,118 Orizaba,Mujeres,2158,1942,216,3038
30 Veracruz de Ignacio de la Llave,118,118 Orizaba,Mujeres,2956,2785,171,1905
30 Veracruz de Ignacio de la Llave,118,118 Orizaba,Mujeres,2959,2878,81,1831
30 Veracruz de Ignacio de la Llave,118,118 Orizaba,Mujeres,3069,2977,92,1858
30 Veracruz de Ignacio de la Llave,118,118 Orizaba,Mujeres,2685,2629,56,1693
30 Veracruz de Ignacio de la Llave,118,118 Orizaba,Mujeres,2355,2314,41,1764
30 Veracruz de Ignacio de la Llave,118,118 Orizaba,Mujeres,1937,1909,28,2039
30 Veracruz de Ignacio de la Llave,118,118 Orizaba,Mujeres,1239,1227,12,2023
30 Veracruz de Ignacio de la Llave,118,118 Orizaba,Mujeres,703,697,6,2014
30 Veracruz de Ignacio de la Llave,118,118 Orizaba,Mujeres,369,365,4,1624
30 Veracruz de Ignacio de la Llave,118,118 Orizaba,Mujeres,245,244,1,1527
30 Veracruz de Ignacio de la Llave,118,118 Orizaba,Mujeres,113,112,1,1222
30 Veracruz de Ignacio de la Llave,118,118 Orizaba,Mujeres,67,67,0,1013
30 Veracruz de Ignacio de la Llave,118,118 Orizaba,Mujeres,28,28,0,895
30 Veracruz de Ignacio de la Llave,119,119 Otatitlán,Total,1999,1936,63,2146
30 Veracruz de Ignacio de la Llave,119,119 Otatitlán,Total,15,14,1,234
30 Veracruz de Ignacio de la Llave,119,119 Otatitlán,Total,127,117,10,370
30 Veracruz de Ignacio de la Llave,119,119 Otatitlán,Total,209,201,8,179
30 Veracruz de Ignacio de la Llave,119,119 Otatitlán,Total,209,201,8,146
30 Veracruz de Ignacio de la Llave,119,119 Otatitlán,Total,218,214,4,121
30 Veracruz de Ignacio de la Llave,119,119 Otatitlán,Total,249,242,7,138
30 Veracruz de Ignacio de la Llave,119,119 Otatitlán,Total,226,218,8,139
30 Veracruz de Ignacio de la Llave,119,119 Otatitlán,Total,220,219,1,123
30 Veracruz de Ignacio de la Llave,119,119 Otatitlán,Total,146,142,4,114
30 Veracruz de Ignacio de la Llave,119,119 Otatitlán,Total,136,132,4,119
30 Veracruz de Ignacio de la Llave,119,119 Otatitlán,Total,91,91,0,96
30 Veracruz de Ignacio de la Llave,119,119 Otatitlán,Total,56,53,3,83
30 Veracruz de Ignacio de la Llave,119,119 Otatitlán,Total,59,55,4,114
30 Veracruz de Ignacio de la Llave,119,119 Otatitlán,Total,25,25,0,63
30 Veracruz de Ignacio de la Llave,119,119 Otatitlán,Total,12,11,1,54
30 Veracruz de Ignacio de la Llave,119,119 Otatitlán,Total,1,1,0,53
30 Veracruz de Ignacio de la Llave,119,119 Otatitlán,Hombres,1451,1398,53,485
30 Veracruz de Ignacio de la Llave,119,119 Otatitlán,Hombres,11,10,1,104
30 Veracruz de Ignacio de la Llave,119,119 Otatitlán,Hombres,98,89,9,152
30 Veracruz de Ignacio de la Llave,119,119 Otatitlán,Hombres,149,143,6,34
30 Veracruz de Ignacio de la Llave,119,119 Otatitlán,Hombres,143,138,5,12
30 Veracruz de Ignacio de la Llave,119,119 Otatitlán,Hombres,152,149,3,5
30 Veracruz de Ignacio de la Llave,119,119 Otatitlán,Hombres,175,168,7,4
30 Veracruz de Ignacio de la Llave,119,119 Otatitlán,Hombres,162,155,7,14
30 Veracruz de Ignacio de la Llave,119,119 Otatitlán,Hombres,161,160,1,12
30 Veracruz de Ignacio de la Llave,119,119 Otatitlán,Hombres,102,98,4,15
30 Veracruz de Ignacio de la Llave,119,119 Otatitlán,Hombres,104,100,4,18
30 Veracruz de Ignacio de la Llave,119,119 Otatitlán,Hombres,71,71,0,14
30 Veracruz de Ignacio de la Llave,119,119 Otatitlán,Hombres,45,42,3,19
30 Veracruz de Ignacio de la Llave,119,119 Otatitlán,Hombres,48,46,2,25
30 Veracruz de Ignacio de la Llave,119,119 Otatitlán,Hombres,21,21,0,23
30 Veracruz de Ignacio de la Llave,119,119 Otatitlán,Hombres,8,7,1,20
30 Veracruz de Ignacio de la Llave,119,119 Otatitlán,Hombres,1,1,0,14
30 Veracruz de Ignacio de la Llave,119,119 Otatitlán,Mujeres,548,538,10,1661
30 Veracruz de Ignacio de la Llave,119,119 Otatitlán,Mujeres,4,4,0,130
30 Veracruz de Ignacio de la Llave,119,119 Otatitlán,Mujeres,29,28,1,218
30 Veracruz de Ignacio de la Llave,119,119 Otatitlán,Mujeres,60,58,2,145
30 Veracruz de Ignacio de la Llave,119,119 Otatitlán,Mujeres,66,63,3,134
30 Veracruz de Ignacio de la Llave,119,119 Otatitlán,Mujeres,66,65,1,116
30 Veracruz de Ignacio de la Llave,119,119 Otatitlán,Mujeres,74,74,0,134
30 Veracruz de Ignacio de la Llave,119,119 Otatitlán,Mujeres,64,63,1,125
30 Veracruz de Ignacio de la Llave,119,119 Otatitlán,Mujeres,59,59,0,111
30 Veracruz de Ignacio de la Llave,119,119 Otatitlán,Mujeres,44,44,0,99
30 Veracruz de Ignacio de la Llave,119,119 Otatitlán,Mujeres,32,32,0,101
30 Veracruz de Ignacio de la Llave,119,119 Otatitlán,Mujeres,20,20,0,82
30 Veracruz de Ignacio de la Llave,119,119 Otatitlán,Mujeres,11,11,0,64
30 Veracruz de Ignacio de la Llave,119,119 Otatitlán,Mujeres,11,9,2,89
30 Veracruz de Ignacio de la Llave,119,119 Otatitlán,Mujeres,4,4,0,40
30 Veracruz de Ignacio de la Llave,119,119 Otatitlán,Mujeres,4,4,0,34
30 Veracruz de Ignacio de la Llave,119,119 Otatitlán,Mujeres,0,0,0,39
30 Veracruz de Ignacio de la Llave,120,120 Oteapan,Total,5613,5263,350,5812
30 Veracruz de Ignacio de la Llave,120,120 Oteapan,Total,23,20,3,873
30 Veracruz de Ignacio de la Llave,120,120 Oteapan,Total,471,395,76,1171
30 Veracruz de Ignacio de la Llave,120,120 Oteapan,Total,823,754,69,633
30 Veracruz de Ignacio de la Llave,120,120 Oteapan,Total,782,747,35,556
30 Veracruz de Ignacio de la Llave,120,120 Oteapan,Total,715,690,25,467
30 Veracruz de Ignacio de la Llave,120,120 Oteapan,Total,680,651,29,417
30 Veracruz de Ignacio de la Llave,120,120 Oteapan,Total,590,574,16,310
30 Veracruz de Ignacio de la Llave,120,120 Oteapan,Total,493,468,25,262
30 Veracruz de Ignacio de la Llave,120,120 Oteapan,Total,371,349,22,264
30 Veracruz de Ignacio de la Llave,120,120 Oteapan,Total,265,248,17,191
30 Veracruz de Ignacio de la Llave,120,120 Oteapan,Total,167,150,17,173
30 Veracruz de Ignacio de la Llave,120,120 Oteapan,Total,85,76,9,152
30 Veracruz de Ignacio de la Llave,120,120 Oteapan,Total,82,81,1,146
30 Veracruz de Ignacio de la Llave,120,120 Oteapan,Total,45,43,2,105
30 Veracruz de Ignacio de la Llave,120,120 Oteapan,Total,18,15,3,54
30 Veracruz de Ignacio de la Llave,120,120 Oteapan,Total,3,2,1,38
30 Veracruz de Ignacio de la Llave,120,120 Oteapan,Hombres,4166,3850,316,1264
30 Veracruz de Ignacio de la Llave,120,120 Oteapan,Hombres,19,16,3,442
30 Veracruz de Ignacio de la Llave,120,120 Oteapan,Hombres,371,302,69,450
30 Veracruz de Ignacio de la Llave,120,120 Oteapan,Hombres,609,552,57,86
30 Veracruz de Ignacio de la Llave,120,120 Oteapan,Hombres,610,582,28,27
30 Veracruz de Ignacio de la Llave,120,120 Oteapan,Hombres,509,487,22,14
30 Veracruz de Ignacio de la Llave,120,120 Oteapan,Hombres,490,463,27,14
30 Veracruz de Ignacio de la Llave,120,120 Oteapan,Hombres,423,408,15,14
30 Veracruz de Ignacio de la Llave,120,120 Oteapan,Hombres,340,316,24,12
30 Veracruz de Ignacio de la Llave,120,120 Oteapan,Hombres,258,236,22,18
30 Veracruz de Ignacio de la Llave,120,120 Oteapan,Hombres,204,187,17,11
30 Veracruz de Ignacio de la Llave,120,120 Oteapan,Hombres,135,119,16,22
30 Veracruz de Ignacio de la Llave,120,120 Oteapan,Hombres,74,65,9,38
30 Veracruz de Ignacio de la Llave,120,120 Oteapan,Hombres,66,65,1,38
30 Veracruz de Ignacio de la Llave,120,120 Oteapan,Hombres,37,35,2,31
30 Veracruz de Ignacio de la Llave,120,120 Oteapan,Hombres,18,15,3,29
30 Veracruz de Ignacio de la Llave,120,120 Oteapan,Hombres,3,2,1,18
30 Veracruz de Ignacio de la Llave,120,120 Oteapan,Mujeres,1447,1413,34,4548
30 Veracruz de Ignacio de la Llave,120,120 Oteapan,Mujeres,4,4,0,431
30 Veracruz de Ignacio de la Llave,120,120 Oteapan,Mujeres,100,93,7,721
30 Veracruz de Ignacio de la Llave,120,120 Oteapan,Mujeres,214,202,12,547
30 Veracruz de Ignacio de la Llave,120,120 Oteapan,Mujeres,172,165,7,529
30 Veracruz de Ignacio de la Llave,120,120 Oteapan,Mujeres,206,203,3,453
30 Veracruz de Ignacio de la Llave,120,120 Oteapan,Mujeres,190,188,2,403
30 Veracruz de Ignacio de la Llave,120,120 Oteapan,Mujeres,167,166,1,296
30 Veracruz de Ignacio de la Llave,120,120 Oteapan,Mujeres,153,152,1,250
30 Veracruz de Ignacio de la Llave,120,120 Oteapan,Mujeres,113,113,0,246
30 Veracruz de Ignacio de la Llave,120,120 Oteapan,Mujeres,61,61,0,180
30 Veracruz de Ignacio de la Llave,120,120 Oteapan,Mujeres,32,31,1,151
30 Veracruz de Ignacio de la Llave,120,120 Oteapan,Mujeres,11,11,0,114
30 Veracruz de Ignacio de la Llave,120,120 Oteapan,Mujeres,16,16,0,108
30 Veracruz de Ignacio de la Llave,120,120 Oteapan,Mujeres,8,8,0,74
30 Veracruz de Ignacio de la Llave,120,120 Oteapan,Mujeres,0,0,0,25
30 Veracruz de Ignacio de la Llave,120,120 Oteapan,Mujeres,0,0,0,20
30 Veracruz de Ignacio de la Llave,121,121 Ozuluama de Mascareñas,Total,8608,8408,200,9515
30 Veracruz de Ignacio de la Llave,121,121 Ozuluama de Mascareñas,Total,63,62,1,1267
30 Veracruz de Ignacio de la Llave,121,121 Ozuluama de Mascareñas,Total,654,625,29,1520
30 Veracruz de Ignacio de la Llave,121,121 Ozuluama de Mascareñas,Total,887,862,25,693
30 Veracruz de Ignacio de la Llave,121,121 Ozuluama de Mascareñas,Total,847,836,11,617
30 Veracruz de Ignacio de la Llave,121,121 Ozuluama de Mascareñas,Total,825,813,12,588
30 Veracruz de Ignacio de la Llave,121,121 Ozuluama de Mascareñas,Total,916,897,19,721
30 Veracruz de Ignacio de la Llave,121,121 Ozuluama de Mascareñas,Total,955,930,25,636
30 Veracruz de Ignacio de la Llave,121,121 Ozuluama de Mascareñas,Total,841,821,20,586
30 Veracruz de Ignacio de la Llave,121,121 Ozuluama de Mascareñas,Total,681,665,16,531
30 Veracruz de Ignacio de la Llave,121,121 Ozuluama de Mascareñas,Total,555,541,14,501
30 Veracruz de Ignacio de la Llave,121,121 Ozuluama de Mascareñas,Total,462,452,10,460
30 Veracruz de Ignacio de la Llave,121,121 Ozuluama de Mascareñas,Total,377,368,9,405
30 Veracruz de Ignacio de la Llave,121,121 Ozuluama de Mascareñas,Total,305,300,5,361
30 Veracruz de Ignacio de la Llave,121,121 Ozuluama de Mascareñas,Total,128,124,4,255
30 Veracruz de Ignacio de la Llave,121,121 Ozuluama de Mascareñas,Total,70,70,0,172
30 Veracruz de Ignacio de la Llave,121,121 Ozuluama de Mascareñas,Total,42,42,0,202
30 Veracruz de Ignacio de la Llave,121,121 Ozuluama de Mascareñas,Hombres,7323,7136,187,2004
30 Veracruz de Ignacio de la Llave,121,121 Ozuluama de Mascareñas,Hombres,54,53,1,649
30 Veracruz de Ignacio de la Llave,121,121 Ozuluama de Mascareñas,Hombres,543,520,23,594
30 Veracruz de Ignacio de la Llave,121,121 Ozuluama de Mascareñas,Hombres,703,682,21,88
30 Veracruz de Ignacio de la Llave,121,121 Ozuluama de Mascareñas,Hombres,692,682,10,32
30 Veracruz de Ignacio de la Llave,121,121 Ozuluama de Mascareñas,Hombres,671,659,12,26
30 Veracruz de Ignacio de la Llave,121,121 Ozuluama de Mascareñas,Hombres,767,748,19,24
30 Veracruz de Ignacio de la Llave,121,121 Ozuluama de Mascareñas,Hombres,797,773,24,18
30 Veracruz de Ignacio de la Llave,121,121 Ozuluama de Mascareñas,Hombres,715,695,20,27
30 Veracruz de Ignacio de la Llave,121,121 Ozuluama de Mascareñas,Hombres,601,585,16,41
30 Veracruz de Ignacio de la Llave,121,121 Ozuluama de Mascareñas,Hombres,497,484,13,55
30 Veracruz de Ignacio de la Llave,121,121 Ozuluama de Mascareñas,Hombres,421,411,10,65
30 Veracruz de Ignacio de la Llave,121,121 Ozuluama de Mascareñas,Hombres,350,341,9,64
30 Veracruz de Ignacio de la Llave,121,121 Ozuluama de Mascareñas,Hombres,286,281,5,87
30 Veracruz de Ignacio de la Llave,121,121 Ozuluama de Mascareñas,Hombres,122,118,4,74
30 Veracruz de Ignacio de la Llave,121,121 Ozuluama de Mascareñas,Hombres,65,65,0,73
30 Veracruz de Ignacio de la Llave,121,121 Ozuluama de Mascareñas,Hombres,39,39,0,87
30 Veracruz de Ignacio de la Llave,121,121 Ozuluama de Mascareñas,Mujeres,1285,1272,13,7511
30 Veracruz de Ignacio de la Llave,121,121 Ozuluama de Mascareñas,Mujeres,9,9,0,618
30 Veracruz de Ignacio de la Llave,121,121 Ozuluama de Mascareñas,Mujeres,111,105,6,926
30 Veracruz de Ignacio de la Llave,121,121 Ozuluama de Mascareñas,Mujeres,184,180,4,605
30 Veracruz de Ignacio de la Llave,121,121 Ozuluama de Mascareñas,Mujeres,155,154,1,585
30 Veracruz de Ignacio de la Llave,121,121 Ozuluama de Mascareñas,Mujeres,154,154,0,562
30 Veracruz de Ignacio de la Llave,121,121 Ozuluama de Mascareñas,Mujeres,149,149,0,697
30 Veracruz de Ignacio de la Llave,121,121 Ozuluama de Mascareñas,Mujeres,158,157,1,618
30 Veracruz de Ignacio de la Llave,121,121 Ozuluama de Mascareñas,Mujeres,126,126,0,559
30 Veracruz de Ignacio de la Llave,121,121 Ozuluama de Mascareñas,Mujeres,80,80,0,490
30 Veracruz de Ignacio de la Llave,121,121 Ozuluama de Mascareñas,Mujeres,58,57,1,446
30 Veracruz de Ignacio de la Llave,121,121 Ozuluama de Mascareñas,Mujeres,41,41,0,395
30 Veracruz de Ignacio de la Llave,121,121 Ozuluama de Mascareñas,Mujeres,27,27,0,341
30 Veracruz de Ignacio de la Llave,121,121 Ozuluama de Mascareñas,Mujeres,19,19,0,274
30 Veracruz de Ignacio de la Llave,121,121 Ozuluama de Mascareñas,Mujeres,6,6,0,181
30 Veracruz de Ignacio de la Llave,121,121 Ozuluama de Mascareñas,Mujeres,5,5,0,99
30 Veracruz de Ignacio de la Llave,121,121 Ozuluama de Mascareñas,Mujeres,3,3,0,115
30 Veracruz de Ignacio de la Llave,122,122 Pajapan,Total,5674,5429,245,6549
30 Veracruz de Ignacio de la Llave,122,122 Pajapan,Total,100,93,7,1074
30 Veracruz de Ignacio de la Llave,122,122 Pajapan,Total,640,603,37,1350
30 Veracruz de Ignacio de la Llave,122,122 Pajapan,Total,854,824,30,720
30 Veracruz de Ignacio de la Llave,122,122 Pajapan,Total,657,618,39,552
30 Veracruz de Ignacio de la Llave,122,122 Pajapan,Total,679,654,25,545
30 Veracruz de Ignacio de la Llave,122,122 Pajapan,Total,632,607,25,453
30 Veracruz de Ignacio de la Llave,122,122 Pajapan,Total,503,481,22,316
30 Veracruz de Ignacio de la Llave,122,122 Pajapan,Total,438,419,19,316
30 Veracruz de Ignacio de la Llave,122,122 Pajapan,Total,320,303,17,273
30 Veracruz de Ignacio de la Llave,122,122 Pajapan,Total,272,262,10,214
30 Veracruz de Ignacio de la Llave,122,122 Pajapan,Total,227,219,8,193
30 Veracruz de Ignacio de la Llave,122,122 Pajapan,Total,159,154,5,166
30 Veracruz de Ignacio de la Llave,122,122 Pajapan,Total,103,103,0,146
30 Veracruz de Ignacio de la Llave,122,122 Pajapan,Total,58,57,1,86
30 Veracruz de Ignacio de la Llave,122,122 Pajapan,Total,25,25,0,80
30 Veracruz de Ignacio de la Llave,122,122 Pajapan,Total,7,7,0,65
30 Veracruz de Ignacio de la Llave,122,122 Pajapan,Hombres,4581,4350,231,1446
30 Veracruz de Ignacio de la Llave,122,122 Pajapan,Hombres,79,72,7,500
30 Veracruz de Ignacio de la Llave,122,122 Pajapan,Hombres,500,464,36,517
30 Veracruz de Ignacio de la Llave,122,122 Pajapan,Hombres,667,640,27,100
30 Veracruz de Ignacio de la Llave,122,122 Pajapan,Hombres,534,499,35,39
30 Veracruz de Ignacio de la Llave,122,122 Pajapan,Hombres,545,521,24,28
30 Veracruz de Ignacio de la Llave,122,122 Pajapan,Hombres,496,474,22,25
30 Veracruz de Ignacio de la Llave,122,122 Pajapan,Hombres,394,372,22,15
30 Veracruz de Ignacio de la Llave,122,122 Pajapan,Hombres,370,352,18,23
30 Veracruz de Ignacio de la Llave,122,122 Pajapan,Hombres,255,238,17,20
30 Veracruz de Ignacio de la Llave,122,122 Pajapan,Hombres,233,223,10,23
30 Veracruz de Ignacio de la Llave,122,122 Pajapan,Hombres,193,186,7,20
30 Veracruz de Ignacio de la Llave,122,122 Pajapan,Hombres,136,131,5,17
30 Veracruz de Ignacio de la Llave,122,122 Pajapan,Hombres,93,93,0,34
30 Veracruz de Ignacio de la Llave,122,122 Pajapan,Hombres,57,56,1,20
30 Veracruz de Ignacio de la Llave,122,122 Pajapan,Hombres,23,23,0,39
30 Veracruz de Ignacio de la Llave,122,122 Pajapan,Hombres,6,6,0,26
30 Veracruz de Ignacio de la Llave,122,122 Pajapan,Mujeres,1093,1079,14,5103
30 Veracruz de Ignacio de la Llave,122,122 Pajapan,Mujeres,21,21,0,574
30 Veracruz de Ignacio de la Llave,122,122 Pajapan,Mujeres,140,139,1,833
30 Veracruz de Ignacio de la Llave,122,122 Pajapan,Mujeres,187,184,3,620
30 Veracruz de Ignacio de la Llave,122,122 Pajapan,Mujeres,123,119,4,513
30 Veracruz de Ignacio de la Llave,122,122 Pajapan,Mujeres,134,133,1,517
30 Veracruz de Ignacio de la Llave,122,122 Pajapan,Mujeres,136,133,3,428
30 Veracruz de Ignacio de la Llave,122,122 Pajapan,Mujeres,109,109,0,301
30 Veracruz de Ignacio de la Llave,122,122 Pajapan,Mujeres,68,67,1,293
30 Veracruz de Ignacio de la Llave,122,122 Pajapan,Mujeres,65,65,0,253
30 Veracruz de Ignacio de la Llave,122,122 Pajapan,Mujeres,39,39,0,191
30 Veracruz de Ignacio de la Llave,122,122 Pajapan,Mujeres,34,33,1,173
30 Veracruz de Ignacio de la Llave,122,122 Pajapan,Mujeres,23,23,0,149
30 Veracruz de Ignacio de la Llave,122,122 Pajapan,Mujeres,10,10,0,112
30 Veracruz de Ignacio de la Llave,122,122 Pajapan,Mujeres,1,1,0,66
30 Veracruz de Ignacio de la Llave,122,122 Pajapan,Mujeres,2,2,0,41
30 Veracruz de Ignacio de la Llave,122,122 Pajapan,Mujeres,1,1,0,39
30 Veracruz de Ignacio de la Llave,123,123 Pánuco,Total,35932,34337,1595,39206
30 Veracruz de Ignacio de la Llave,123,123 Pánuco,Total,224,197,27,5510
30 Veracruz de Ignacio de la Llave,123,123 Pánuco,Total,2493,2267,226,7129
30 Veracruz de Ignacio de la Llave,123,123 Pánuco,Total,4344,4032,312,3547
30 Veracruz de Ignacio de la Llave,123,123 Pánuco,Total,4256,4039,217,2483
30 Veracruz de Ignacio de la Llave,123,123 Pánuco,Total,4126,3966,160,2586
30 Veracruz de Ignacio de la Llave,123,123 Pánuco,Total,4402,4282,120,2641
30 Veracruz de Ignacio de la Llave,123,123 Pánuco,Total,4038,3912,126,2397
30 Veracruz de Ignacio de la Llave,123,123 Pánuco,Total,3610,3478,132,2206
30 Veracruz de Ignacio de la Llave,123,123 Pánuco,Total,2832,2757,75,2052
30 Veracruz de Ignacio de la Llave,123,123 Pánuco,Total,2062,1990,72,1748
30 Veracruz de Ignacio de la Llave,123,123 Pánuco,Total,1396,1352,44,1799
30 Veracruz de Ignacio de la Llave,123,123 Pánuco,Total,909,875,34,1543
30 Veracruz de Ignacio de la Llave,123,123 Pánuco,Total,688,656,32,1368
30 Veracruz de Ignacio de la Llave,123,123 Pánuco,Total,341,332,9,948
30 Veracruz de Ignacio de la Llave,123,123 Pánuco,Total,133,127,6,628
30 Veracruz de Ignacio de la Llave,123,123 Pánuco,Total,78,75,3,621
30 Veracruz de Ignacio de la Llave,123,123 Pánuco,Hombres,27415,26043,1372,9581
30 Veracruz de Ignacio de la Llave,123,123 Pánuco,Hombres,185,161,24,2749
30 Veracruz de Ignacio de la Llave,123,123 Pánuco,Hombres,1972,1780,192,2940
30 Veracruz de Ignacio de la Llave,123,123 Pánuco,Hombres,3153,2911,242,800
30 Veracruz de Ignacio de la Llave,123,123 Pánuco,Hombres,3130,2954,176,121
30 Veracruz de Ignacio de la Llave,123,123 Pánuco,Hombres,3009,2874,135,108
30 Veracruz de Ignacio de la Llave,123,123 Pánuco,Hombres,3182,3075,107,79
30 Veracruz de Ignacio de la Llave,123,123 Pánuco,Hombres,3027,2909,118,97
30 Veracruz de Ignacio de la Llave,123,123 Pánuco,Hombres,2703,2583,120,115
30 Veracruz de Ignacio de la Llave,123,123 Pánuco,Hombres,2215,2144,71,193
30 Veracruz de Ignacio de la Llave,123,123 Pánuco,Hombres,1712,1644,68,219
30 Veracruz de Ignacio de la Llave,123,123 Pánuco,Hombres,1181,1139,42,399
30 Veracruz de Ignacio de la Llave,123,123 Pánuco,Hombres,816,785,31,437
30 Veracruz de Ignacio de la Llave,123,123 Pánuco,Hombres,621,590,31,446
30 Veracruz de Ignacio de la Llave,123,123 Pánuco,Hombres,321,313,8,366
30 Veracruz de Ignacio de la Llave,123,123 Pánuco,Hombres,115,110,5,253
30 Veracruz de Ignacio de la Llave,123,123 Pánuco,Hombres,73,71,2,259
30 Veracruz de Ignacio de la Llave,123,123 Pánuco,Mujeres,8517,8294,223,29625
30 Veracruz de Ignacio de la Llave,123,123 Pánuco,Mujeres,39,36,3,2761
30 Veracruz de Ignacio de la Llave,123,123 Pánuco,Mujeres,521,487,34,4189
30 Veracruz de Ignacio de la Llave,123,123 Pánuco,Mujeres,1191,1121,70,2747
30 Veracruz de Ignacio de la Llave,123,123 Pánuco,Mujeres,1126,1085,41,2362
30 Veracruz de Ignacio de la Llave,123,123 Pánuco,Mujeres,1117,1092,25,2478
30 Veracruz de Ignacio de la Llave,123,123 Pánuco,Mujeres,1220,1207,13,2562
30 Veracruz de Ignacio de la Llave,123,123 Pánuco,Mujeres,1011,1003,8,2300
30 Veracruz de Ignacio de la Llave,123,123 Pánuco,Mujeres,907,895,12,2091
30 Veracruz de Ignacio de la Llave,123,123 Pánuco,Mujeres,617,613,4,1859
30 Veracruz de Ignacio de la Llave,123,123 Pánuco,Mujeres,350,346,4,1529
30 Veracruz de Ignacio de la Llave,123,123 Pánuco,Mujeres,215,213,2,1400
30 Veracruz de Ignacio de la Llave,123,123 Pánuco,Mujeres,93,90,3,1106
30 Veracruz de Ignacio de la Llave,123,123 Pánuco,Mujeres,67,66,1,922
30 Veracruz de Ignacio de la Llave,123,123 Pánuco,Mujeres,20,19,1,582
30 Veracruz de Ignacio de la Llave,123,123 Pánuco,Mujeres,18,17,1,375
30 Veracruz de Ignacio de la Llave,123,123 Pánuco,Mujeres,5,4,1,362
30 Veracruz de Ignacio de la Llave,124,124 Papantla,Total,59765,58796,969,62725
30 Veracruz de Ignacio de la Llave,124,124 Papantla,Total,399,392,7,8716
30 Veracruz de Ignacio de la Llave,124,124 Papantla,Total,4340,4214,126,12584
30 Veracruz de Ignacio de la Llave,124,124 Papantla,Total,7074,6873,201,5775
30 Veracruz de Ignacio de la Llave,124,124 Papantla,Total,6659,6511,148,4260
30 Veracruz de Ignacio de la Llave,124,124 Papantla,Total,6602,6532,70,3787
30 Veracruz de Ignacio de la Llave,124,124 Papantla,Total,7224,7137,87,4104
30 Veracruz de Ignacio de la Llave,124,124 Papantla,Total,6508,6429,79,3621
30 Veracruz de Ignacio de la Llave,124,124 Papantla,Total,5502,5443,59,3169
30 Veracruz de Ignacio de la Llave,124,124 Papantla,Total,4478,4426,52,3087
30 Veracruz de Ignacio de la Llave,124,124 Papantla,Total,3569,3516,53,2930
30 Veracruz de Ignacio de la Llave,124,124 Papantla,Total,2763,2726,37,2829
30 Veracruz de Ignacio de la Llave,124,124 Papantla,Total,2123,2098,25,2426
30 Veracruz de Ignacio de la Llave,124,124 Papantla,Total,1332,1319,13,2018
30 Veracruz de Ignacio de la Llave,124,124 Papantla,Total,655,647,8,1353
30 Veracruz de Ignacio de la Llave,124,124 Papantla,Total,325,322,3,973
30 Veracruz de Ignacio de la Llave,124,124 Papantla,Total,212,211,1,1093
30 Veracruz de Ignacio de la Llave,124,124 Papantla,Hombres,45018,44227,791,13675
30 Veracruz de Ignacio de la Llave,124,124 Papantla,Hombres,331,324,7,4333
30 Veracruz de Ignacio de la Llave,124,124 Papantla,Hombres,3491,3384,107,5122
30 Veracruz de Ignacio de la Llave,124,124 Papantla,Hombres,5181,5055,126,1013
30 Veracruz de Ignacio de la Llave,124,124 Papantla,Hombres,4776,4665,111,195
30 Veracruz de Ignacio de la Llave,124,124 Papantla,Hombres,4770,4714,56,113
30 Veracruz de Ignacio de la Llave,124,124 Papantla,Hombres,5137,5060,77,112
30 Veracruz de Ignacio de la Llave,124,124 Papantla,Hombres,4652,4583,69,102
30 Veracruz de Ignacio de la Llave,124,124 Papantla,Hombres,4003,3947,56,117
30 Veracruz de Ignacio de la Llave,124,124 Papantla,Hombres,3362,3314,48,176
30 Veracruz de Ignacio de la Llave,124,124 Papantla,Hombres,2828,2778,50,259
30 Veracruz de Ignacio de la Llave,124,124 Papantla,Hombres,2336,2302,34,375
30 Veracruz de Ignacio de la Llave,124,124 Papantla,Hombres,1849,1824,25,381
30 Veracruz de Ignacio de la Llave,124,124 Papantla,Hombres,1196,1183,13,387
30 Veracruz de Ignacio de la Llave,124,124 Papantla,Hombres,601,593,8,340
30 Veracruz de Ignacio de la Llave,124,124 Papantla,Hombres,304,301,3,280
30 Veracruz de Ignacio de la Llave,124,124 Papantla,Hombres,201,200,1,370
30 Veracruz de Ignacio de la Llave,124,124 Papantla,Mujeres,14747,14569,178,49050
30 Veracruz de Ignacio de la Llave,124,124 Papantla,Mujeres,68,68,0,4383
30 Veracruz de Ignacio de la Llave,124,124 Papantla,Mujeres,849,830,19,7462
30 Veracruz de Ignacio de la Llave,124,124 Papantla,Mujeres,1893,1818,75,4762
30 Veracruz de Ignacio de la Llave,124,124 Papantla,Mujeres,1883,1846,37,4065
30 Veracruz de Ignacio de la Llave,124,124 Papantla,Mujeres,1832,1818,14,3674
30 Veracruz de Ignacio de la Llave,124,124 Papantla,Mujeres,2087,2077,10,3992
30 Veracruz de Ignacio de la Llave,124,124 Papantla,Mujeres,1856,1846,10,3519
30 Veracruz de Ignacio de la Llave,124,124 Papantla,Mujeres,1499,1496,3,3052
30 Veracruz de Ignacio de la Llave,124,124 Papantla,Mujeres,1116,1112,4,2911
30 Veracruz de Ignacio de la Llave,124,124 Papantla,Mujeres,741,738,3,2671
30 Veracruz de Ignacio de la Llave,124,124 Papantla,Mujeres,427,424,3,2454
30 Veracruz de Ignacio de la Llave,124,124 Papantla,Mujeres,274,274,0,2045
30 Veracruz de Ignacio de la Llave,124,124 Papantla,Mujeres,136,136,0,1631
30 Veracruz de Ignacio de la Llave,124,124 Papantla,Mujeres,54,54,0,1013
30 Veracruz de Ignacio de la Llave,124,124 Papantla,Mujeres,21,21,0,693
30 Veracruz de Ignacio de la Llave,124,124 Papantla,Mujeres,11,11,0,723
30 Veracruz de Ignacio de la Llave,126,126 Paso de Ovejas,Total,12187,11547,640,13822
30 Veracruz de Ignacio de la Llave,126,126 Paso de Ovejas,Total,58,52,6,1653
30 Veracruz de Ignacio de la Llave,126,126 Paso de Ovejas,Total,766,692,74,2268
30 Veracruz de Ignacio de la Llave,126,126 Paso de Ovejas,Total,1482,1346,136,1178
30 Veracruz de Ignacio de la Llave,126,126 Paso de Ovejas,Total,1359,1278,81,864
30 Veracruz de Ignacio de la Llave,126,126 Paso de Ovejas,Total,1378,1319,59,960
30 Veracruz de Ignacio de la Llave,126,126 Paso de Ovejas,Total,1490,1439,51,996
30 Veracruz de Ignacio de la Llave,126,126 Paso de Ovejas,Total,1378,1333,45,915
30 Veracruz de Ignacio de la Llave,126,126 Paso de Ovejas,Total,1197,1147,50,860
30 Veracruz de Ignacio de la Llave,126,126 Paso de Ovejas,Total,962,923,39,721
30 Veracruz de Ignacio de la Llave,126,126 Paso de Ovejas,Total,809,769,40,680
30 Veracruz de Ignacio de la Llave,126,126 Paso de Ovejas,Total,524,498,26,634
30 Veracruz de Ignacio de la Llave,126,126 Paso de Ovejas,Total,350,332,18,577
30 Veracruz de Ignacio de la Llave,126,126 Paso de Ovejas,Total,210,206,4,581
30 Veracruz de Ignacio de la Llave,126,126 Paso de Ovejas,Total,132,125,7,415
30 Veracruz de Ignacio de la Llave,126,126 Paso de Ovejas,Total,55,51,4,266
30 Veracruz de Ignacio de la Llave,126,126 Paso de Ovejas,Total,37,37,0,254
30 Veracruz de Ignacio de la Llave,126,126 Paso de Ovejas,Hombres,9699,9136,563,3134
30 Veracruz de Ignacio de la Llave,126,126 Paso de Ovejas,Hombres,41,36,5,841
30 Veracruz de Ignacio de la Llave,126,126 Paso de Ovejas,Hombres,585,519,66,973
30 Veracruz de Ignacio de la Llave,126,126 Paso de Ovejas,Hombres,1130,1025,105,207
30 Veracruz de Ignacio de la Llave,126,126 Paso de Ovejas,Hombres,1019,951,68,43
30 Veracruz de Ignacio de la Llave,126,126 Paso de Ovejas,Hombres,1063,1011,52,40
30 Veracruz de Ignacio de la Llave,126,126 Paso de Ovejas,Hombres,1157,1111,46,31
30 Veracruz de Ignacio de la Llave,126,126 Paso de Ovejas,Hombres,1083,1043,40,43
30 Veracruz de Ignacio de la Llave,126,126 Paso de Ovejas,Hombres,971,924,47,47
30 Veracruz de Ignacio de la Llave,126,126 Paso de Ovejas,Hombres,797,760,37,39
30 Veracruz de Ignacio de la Llave,126,126 Paso de Ovejas,Hombres,682,643,39,68
30 Veracruz de Ignacio de la Llave,126,126 Paso de Ovejas,Hombres,469,443,26,136
30 Veracruz de Ignacio de la Llave,126,126 Paso de Ovejas,Hombres,309,291,18,161
30 Veracruz de Ignacio de la Llave,126,126 Paso de Ovejas,Hombres,184,180,4,181
30 Veracruz de Ignacio de la Llave,126,126 Paso de Ovejas,Hombres,122,115,7,125
30 Veracruz de Ignacio de la Llave,126,126 Paso de Ovejas,Hombres,53,50,3,96
30 Veracruz de Ignacio de la Llave,126,126 Paso de Ovejas,Hombres,34,34,0,103
30 Veracruz de Ignacio de la Llave,126,126 Paso de Ovejas,Mujeres,2488,2411,77,10688
30 Veracruz de Ignacio de la Llave,126,126 Paso de Ovejas,Mujeres,17,16,1,812
30 Veracruz de Ignacio de la Llave,126,126 Paso de Ovejas,Mujeres,181,173,8,1295
30 Veracruz de Ignacio de la Llave,126,126 Paso de Ovejas,Mujeres,352,321,31,971
30 Veracruz de Ignacio de la Llave,126,126 Paso de Ovejas,Mujeres,340,327,13,821
30 Veracruz de Ignacio de la Llave,126,126 Paso de Ovejas,Mujeres,315,308,7,920
30 Veracruz de Ignacio de la Llave,126,126 Paso de Ovejas,Mujeres,333,328,5,965
30 Veracruz de Ignacio de la Llave,126,126 Paso de Ovejas,Mujeres,295,290,5,872
30 Veracruz de Ignacio de la Llave,126,126 Paso de Ovejas,Mujeres,226,223,3,813
30 Veracruz de Ignacio de la Llave,126,126 Paso de Ovejas,Mujeres,165,163,2,682
30 Veracruz de Ignacio de la Llave,126,126 Paso de Ovejas,Mujeres,127,126,1,612
30 Veracruz de Ignacio de la Llave,126,126 Paso de Ovejas,Mujeres,55,55,0,498
30 Veracruz de Ignacio de la Llave,126,126 Paso de Ovejas,Mujeres,41,41,0,416
30 Veracruz de Ignacio de la Llave,126,126 Paso de Ovejas,Mujeres,26,26,0,400
30 Veracruz de Ignacio de la Llave,126,126 Paso de Ovejas,Mujeres,10,10,0,290
30 Veracruz de Ignacio de la Llave,126,126 Paso de Ovejas,Mujeres,2,1,1,170
30 Veracruz de Ignacio de la Llave,126,126 Paso de Ovejas,Mujeres,3,3,0,151
30 Veracruz de Ignacio de la Llave,125,125 Paso del Macho,Total,11209,10896,313,11105
30 Veracruz de Ignacio de la Llave,125,125 Paso del Macho,Total,205,199,6,1464
30 Veracruz de Ignacio de la Llave,125,125 Paso del Macho,Total,1122,1069,53,1755
30 Veracruz de Ignacio de la Llave,125,125 Paso del Macho,Total,1556,1483,73,1184
30 Veracruz de Ignacio de la Llave,125,125 Paso del Macho,Total,1407,1364,43,885
30 Veracruz de Ignacio de la Llave,125,125 Paso del Macho,Total,1299,1263,36,859
30 Veracruz de Ignacio de la Llave,125,125 Paso del Macho,Total,1345,1315,30,872
30 Veracruz de Ignacio de la Llave,125,125 Paso del Macho,Total,1112,1095,17,693
30 Veracruz de Ignacio de la Llave,125,125 Paso del Macho,Total,990,974,16,594
30 Veracruz de Ignacio de la Llave,125,125 Paso del Macho,Total,712,694,18,500
30 Veracruz de Ignacio de la Llave,125,125 Paso del Macho,Total,576,569,7,402
30 Veracruz de Ignacio de la Llave,125,125 Paso del Macho,Total,381,375,6,480
30 Veracruz de Ignacio de la Llave,125,125 Paso del Macho,Total,225,222,3,372
30 Veracruz de Ignacio de la Llave,125,125 Paso del Macho,Total,149,146,3,362
30 Veracruz de Ignacio de la Llave,125,125 Paso del Macho,Total,78,76,2,308
30 Veracruz de Ignacio de la Llave,125,125 Paso del Macho,Total,37,37,0,199
30 Veracruz de Ignacio de la Llave,125,125 Paso del Macho,Total,15,15,0,176
30 Veracruz de Ignacio de la Llave,125,125 Paso del Macho,Hombres,8497,8235,262,2379
30 Veracruz de Ignacio de la Llave,125,125 Paso del Macho,Hombres,159,154,5,681
30 Veracruz de Ignacio de la Llave,125,125 Paso del Macho,Hombres,873,828,45,583
30 Veracruz de Ignacio de la Llave,125,125 Paso del Macho,Hombres,1157,1103,54,166
30 Veracruz de Ignacio de la Llave,125,125 Paso del Macho,Hombres,1027,992,35,44
30 Veracruz de Ignacio de la Llave,125,125 Paso del Macho,Hombres,968,938,30,33
30 Veracruz de Ignacio de la Llave,125,125 Paso del Macho,Hombres,991,964,27,48
30 Veracruz de Ignacio de la Llave,125,125 Paso del Macho,Hombres,855,842,13,38
30 Veracruz de Ignacio de la Llave,125,125 Paso del Macho,Hombres,738,723,15,37
30 Veracruz de Ignacio de la Llave,125,125 Paso del Macho,Hombres,543,526,17,37
30 Veracruz de Ignacio de la Llave,125,125 Paso del Macho,Hombres,467,460,7,30
30 Veracruz de Ignacio de la Llave,125,125 Paso del Macho,Hombres,303,297,6,119
30 Veracruz de Ignacio de la Llave,125,125 Paso del Macho,Hombres,194,191,3,130
30 Veracruz de Ignacio de la Llave,125,125 Paso del Macho,Hombres,119,116,3,138
30 Veracruz de Ignacio de la Llave,125,125 Paso del Macho,Hombres,60,58,2,114
30 Veracruz de Ignacio de la Llave,125,125 Paso del Macho,Hombres,31,31,0,96
30 Veracruz de Ignacio de la Llave,125,125 Paso del Macho,Hombres,12,12,0,85
30 Veracruz de Ignacio de la Llave,125,125 Paso del Macho,Mujeres,2712,2661,51,8726
30 Veracruz de Ignacio de la Llave,125,125 Paso del Macho,Mujeres,46,45,1,783
30 Veracruz de Ignacio de la Llave,125,125 Paso del Macho,Mujeres,249,241,8,1172
30 Veracruz de Ignacio de la Llave,125,125 Paso del Macho,Mujeres,399,380,19,1018
30 Veracruz de Ignacio de la Llave,125,125 Paso del Macho,Mujeres,380,372,8,841
30 Veracruz de Ignacio de la Llave,125,125 Paso del Macho,Mujeres,331,325,6,826
30 Veracruz de Ignacio de la Llave,125,125 Paso del Macho,Mujeres,354,351,3,824
30 Veracruz de Ignacio de la Llave,125,125 Paso del Macho,Mujeres,257,253,4,655
30 Veracruz de Ignacio de la Llave,125,125 Paso del Macho,Mujeres,252,251,1,557
30 Veracruz de Ignacio de la Llave,125,125 Paso del Macho,Mujeres,169,168,1,463
30 Veracruz de Ignacio de la Llave,125,125 Paso del Macho,Mujeres,109,109,0,372
30 Veracruz de Ignacio de la Llave,125,125 Paso del Macho,Mujeres,78,78,0,361
30 Veracruz de Ignacio de la Llave,125,125 Paso del Macho,Mujeres,31,31,0,242
30 Veracruz de Ignacio de la Llave,125,125 Paso del Macho,Mujeres,30,30,0,224
30 Veracruz de Ignacio de la Llave,125,125 Paso del Macho,Mujeres,18,18,0,194
30 Veracruz de Ignacio de la Llave,125,125 Paso del Macho,Mujeres,6,6,0,103
30 Veracruz de Ignacio de la Llave,125,125 Paso del Macho,Mujeres,3,3,0,91
30 Veracruz de Ignacio de la Llave,128,128 Perote,Total,23571,22658,913,24272
30 Veracruz de Ignacio de la Llave,128,128 Perote,Total,282,252,30,3903
30 Veracruz de Ignacio de la Llave,128,128 Perote,Total,2160,1987,173,4732
30 Veracruz de Ignacio de la Llave,128,128 Perote,Total,3293,3141,152,2694
30 Veracruz de Ignacio de la Llave,128,128 Perote,Total,3242,3128,114,2074
30 Veracruz de Ignacio de la Llave,128,128 Perote,Total,3284,3178,106,1895
30 Veracruz de Ignacio de la Llave,128,128 Perote,Total,2897,2805,92,1596
30 Veracruz de Ignacio de la Llave,128,128 Perote,Total,2260,2193,67,1360
30 Veracruz de Ignacio de la Llave,128,128 Perote,Total,1908,1850,58,1128
30 Veracruz de Ignacio de la Llave,128,128 Perote,Total,1482,1442,40,959
30 Veracruz de Ignacio de la Llave,128,128 Perote,Total,1080,1048,32,847
30 Veracruz de Ignacio de la Llave,128,128 Perote,Total,700,678,22,750
30 Veracruz de Ignacio de la Llave,128,128 Perote,Total,428,414,14,652
30 Veracruz de Ignacio de la Llave,128,128 Perote,Total,278,272,6,636
30 Veracruz de Ignacio de la Llave,128,128 Perote,Total,161,159,2,403
30 Veracruz de Ignacio de la Llave,128,128 Perote,Total,71,68,3,327
30 Veracruz de Ignacio de la Llave,128,128 Perote,Total,45,43,2,316
30 Veracruz de Ignacio de la Llave,128,128 Perote,Hombres,17263,16484,779,5347
30 Veracruz de Ignacio de la Llave,128,128 Perote,Hombres,226,196,30,1889
30 Veracruz de Ignacio de la Llave,128,128 Perote,Hombres,1642,1501,141,1757
30 Veracruz de Ignacio de la Llave,128,128 Perote,Hombres,2409,2293,116,434
30 Veracruz de Ignacio de la Llave,128,128 Perote,Hombres,2377,2287,90,88
30 Veracruz de Ignacio de la Llave,128,128 Perote,Hombres,2343,2253,90,68
30 Veracruz de Ignacio de la Llave,128,128 Perote,Hombres,2049,1966,83,48
30 Veracruz de Ignacio de la Llave,128,128 Perote,Hombres,1621,1561,60,68
30 Veracruz de Ignacio de la Llave,128,128 Perote,Hombres,1364,1311,53,66
30 Veracruz de Ignacio de la Llave,128,128 Perote,Hombres,1086,1049,37,71
30 Veracruz de Ignacio de la Llave,128,128 Perote,Hombres,807,777,30,65
30 Veracruz de Ignacio de la Llave,128,128 Perote,Hombres,547,525,22,135
30 Veracruz de Ignacio de la Llave,128,128 Perote,Hombres,336,322,14,157
30 Veracruz de Ignacio de la Llave,128,128 Perote,Hombres,226,220,6,164
30 Veracruz de Ignacio de la Llave,128,128 Perote,Hombres,134,132,2,105
30 Veracruz de Ignacio de la Llave,128,128 Perote,Hombres,59,56,3,121
30 Veracruz de Ignacio de la Llave,128,128 Perote,Hombres,37,35,2,111
30 Veracruz de Ignacio de la Llave,128,128 Perote,Mujeres,6308,6174,134,18925
30 Veracruz de Ignacio de la Llave,128,128 Perote,Mujeres,56,56,0,2014
30 Veracruz de Ignacio de la Llave,128,128 Perote,Mujeres,518,486,32,2975
30 Veracruz de Ignacio de la Llave,128,128 Perote,Mujeres,884,848,36,2260
30 Veracruz de Ignacio de la Llave,128,128 Perote,Mujeres,865,841,24,1986
30 Veracruz de Ignacio de la Llave,128,128 Perote,Mujeres,941,925,16,1827
30 Veracruz de Ignacio de la Llave,128,128 Perote,Mujeres,848,839,9,1548
30 Veracruz de Ignacio de la Llave,128,128 Perote,Mujeres,639,632,7,1292
30 Veracruz de Ignacio de la Llave,128,128 Perote,Mujeres,544,539,5,1062
30 Veracruz de Ignacio de la Llave,128,128 Perote,Mujeres,396,393,3,888
30 Veracruz de Ignacio de la Llave,128,128 Perote,Mujeres,273,271,2,782
30 Veracruz de Ignacio de la Llave,128,128 Perote,Mujeres,153,153,0,615
30 Veracruz de Ignacio de la Llave,128,128 Perote,Mujeres,92,92,0,495
30 Veracruz de Ignacio de la Llave,128,128 Perote,Mujeres,52,52,0,472
30 Veracruz de Ignacio de la Llave,128,128 Perote,Mujeres,27,27,0,298
30 Veracruz de Ignacio de la Llave,128,128 Perote,Mujeres,12,12,0,206
30 Veracruz de Ignacio de la Llave,128,128 Perote,Mujeres,8,8,0,205
30 Veracruz de Ignacio de la Llave,129,129 Platón Sánchez,Total,6099,5874,225,7448
30 Veracruz de Ignacio de la Llave,129,129 Platón Sánchez,Total,29,25,4,1284
30 Veracruz de Ignacio de la Llave,129,129 Platón Sánchez,Total,432,403,29,1423
30 Veracruz de Ignacio de la Llave,129,129 Platón Sánchez,Total,572,543,29,541
30 Veracruz de Ignacio de la Llave,129,129 Platón Sánchez,Total,579,557,22,421
30 Veracruz de Ignacio de la Llave,129,129 Platón Sánchez,Total,639,619,20,404
30 Veracruz de Ignacio de la Llave,129,129 Platón Sánchez,Total,693,679,14,385
30 Veracruz de Ignacio de la Llave,129,129 Platón Sánchez,Total,622,607,15,413
30 Veracruz de Ignacio de la Llave,129,129 Platón Sánchez,Total,542,525,17,409
30 Veracruz de Ignacio de la Llave,129,129 Platón Sánchez,Total,501,490,11,414
30 Veracruz de Ignacio de la Llave,129,129 Platón Sánchez,Total,433,425,8,356
30 Veracruz de Ignacio de la Llave,129,129 Platón Sánchez,Total,378,367,11,316
30 Veracruz de Ignacio de la Llave,129,129 Platón Sánchez,Total,251,238,13,284
30 Veracruz de Ignacio de la Llave,129,129 Platón Sánchez,Total,217,203,14,322
30 Veracruz de Ignacio de la Llave,129,129 Platón Sánchez,Total,122,112,10,195
30 Veracruz de Ignacio de la Llave,129,129 Platón Sánchez,Total,54,50,4,134
30 Veracruz de Ignacio de la Llave,129,129 Platón Sánchez,Total,35,31,4,147
30 Veracruz de Ignacio de la Llave,129,129 Platón Sánchez,Hombres,4726,4522,204,1848
30 Veracruz de Ignacio de la Llave,129,129 Platón Sánchez,Hombres,24,20,4,639
30 Veracruz de Ignacio de la Llave,129,129 Platón Sánchez,Hombres,341,316,25,627
30 Veracruz de Ignacio de la Llave,129,129 Platón Sánchez,Hombres,421,396,25,129
30 Veracruz de Ignacio de la Llave,129,129 Platón Sánchez,Hombres,410,396,14,31
30 Veracruz de Ignacio de la Llave,129,129 Platón Sánchez,Hombres,454,435,19,14
30 Veracruz de Ignacio de la Llave,129,129 Platón Sánchez,Hombres,515,502,13,17
30 Veracruz de Ignacio de la Llave,129,129 Platón Sánchez,Hombres,461,448,13,28
30 Veracruz de Ignacio de la Llave,129,129 Platón Sánchez,Hombres,408,391,17,31
30 Veracruz de Ignacio de la Llave,129,129 Platón Sánchez,Hombres,398,387,11,23
30 Veracruz de Ignacio de la Llave,129,129 Platón Sánchez,Hombres,362,354,8,30
30 Veracruz de Ignacio de la Llave,129,129 Platón Sánchez,Hombres,329,318,11,36
30 Veracruz de Ignacio de la Llave,129,129 Platón Sánchez,Hombres,220,208,12,53
30 Veracruz de Ignacio de la Llave,129,129 Platón Sánchez,Hombres,193,179,14,65
30 Veracruz de Ignacio de la Llave,129,129 Platón Sánchez,Hombres,110,100,10,37
30 Veracruz de Ignacio de la Llave,129,129 Platón Sánchez,Hombres,50,46,4,40
30 Veracruz de Ignacio de la Llave,129,129 Platón Sánchez,Hombres,30,26,4,48
30 Veracruz de Ignacio de la Llave,129,129 Platón Sánchez,Mujeres,1373,1352,21,5600
30 Veracruz de Ignacio de la Llave,129,129 Platón Sánchez,Mujeres,5,5,0,645
30 Veracruz de Ignacio de la Llave,129,129 Platón Sánchez,Mujeres,91,87,4,796
30 Veracruz de Ignacio de la Llave,129,129 Platón Sánchez,Mujeres,151,147,4,412
30 Veracruz de Ignacio de la Llave,129,129 Platón Sánchez,Mujeres,169,161,8,390
30 Veracruz de Ignacio de la Llave,129,129 Platón Sánchez,Mujeres,185,184,1,390
30 Veracruz de Ignacio de la Llave,129,129 Platón Sánchez,Mujeres,178,177,1,368
30 Veracruz de Ignacio de la Llave,129,129 Platón Sánchez,Mujeres,161,159,2,385
30 Veracruz de Ignacio de la Llave,129,129 Platón Sánchez,Mujeres,134,134,0,378
30 Veracruz de Ignacio de la Llave,129,129 Platón Sánchez,Mujeres,103,103,0,391
30 Veracruz de Ignacio de la Llave,129,129 Platón Sánchez,Mujeres,71,71,0,326
30 Veracruz de Ignacio de la Llave,129,129 Platón Sánchez,Mujeres,49,49,0,280
30 Veracruz de Ignacio de la Llave,129,129 Platón Sánchez,Mujeres,31,30,1,231
30 Veracruz de Ignacio de la Llave,129,129 Platón Sánchez,Mujeres,24,24,0,257
30 Veracruz de Ignacio de la Llave,129,129 Platón Sánchez,Mujeres,12,12,0,158
30 Veracruz de Ignacio de la Llave,129,129 Platón Sánchez,Mujeres,4,4,0,94
30 Veracruz de Ignacio de la Llave,129,129 Platón Sánchez,Mujeres,5,5,0,99
30 Veracruz de Ignacio de la Llave,130,130 Playa Vicente,Total,14136,13234,902,16926
30 Veracruz de Ignacio de la Llave,130,130 Playa Vicente,Total,170,156,14,2540
30 Veracruz de Ignacio de la Llave,130,130 Playa Vicente,Total,1308,1141,167,3149
30 Veracruz de Ignacio de la Llave,130,130 Playa Vicente,Total,1620,1492,128,1403
30 Veracruz de Ignacio de la Llave,130,130 Playa Vicente,Total,1422,1321,101,1119
30 Veracruz de Ignacio de la Llave,130,130 Playa Vicente,Total,1480,1393,87,1202
30 Veracruz de Ignacio de la Llave,130,130 Playa Vicente,Total,1603,1511,92,1145
30 Veracruz de Ignacio de la Llave,130,130 Playa Vicente,Total,1472,1382,90,1010
30 Veracruz de Ignacio de la Llave,130,130 Playa Vicente,Total,1169,1132,37,900
30 Veracruz de Ignacio de la Llave,130,130 Playa Vicente,Total,998,936,62,893
30 Veracruz de Ignacio de la Llave,130,130 Playa Vicente,Total,886,842,44,841
30 Veracruz de Ignacio de la Llave,130,130 Playa Vicente,Total,611,584,27,674
30 Veracruz de Ignacio de la Llave,130,130 Playa Vicente,Total,551,538,13,587
30 Veracruz de Ignacio de la Llave,130,130 Playa Vicente,Total,448,427,21,594
30 Veracruz de Ignacio de la Llave,130,130 Playa Vicente,Total,221,212,9,361
30 Veracruz de Ignacio de la Llave,130,130 Playa Vicente,Total,106,101,5,241
30 Veracruz de Ignacio de la Llave,130,130 Playa Vicente,Total,71,66,5,267
30 Veracruz de Ignacio de la Llave,130,130 Playa Vicente,Hombres,11362,10536,826,3288
30 Veracruz de Ignacio de la Llave,130,130 Playa Vicente,Hombres,156,142,14,1204
30 Veracruz de Ignacio de la Llave,130,130 Playa Vicente,Hombres,1084,936,148,1082
30 Veracruz de Ignacio de la Llave,130,130 Playa Vicente,Hombres,1192,1088,104,149
30 Veracruz de Ignacio de la Llave,130,130 Playa Vicente,Hombres,1023,938,85,52
30 Veracruz de Ignacio de la Llave,130,130 Playa Vicente,Hombres,1156,1073,83,51
30 Veracruz de Ignacio de la Llave,130,130 Playa Vicente,Hombres,1245,1158,87,43
30 Veracruz de Ignacio de la Llave,130,130 Playa Vicente,Hombres,1165,1080,85,42
30 Veracruz de Ignacio de la Llave,130,130 Playa Vicente,Hombres,911,877,34,37
30 Veracruz de Ignacio de la Llave,130,130 Playa Vicente,Hombres,808,746,62,53
30 Veracruz de Ignacio de la Llave,130,130 Playa Vicente,Hombres,762,718,44,81
30 Veracruz de Ignacio de la Llave,130,130 Playa Vicente,Hombres,553,526,27,71
30 Veracruz de Ignacio de la Llave,130,130 Playa Vicente,Hombres,504,491,13,67
30 Veracruz de Ignacio de la Llave,130,130 Playa Vicente,Hombres,418,397,21,107
30 Veracruz de Ignacio de la Llave,130,130 Playa Vicente,Hombres,215,206,9,82
30 Veracruz de Ignacio de la Llave,130,130 Playa Vicente,Hombres,102,97,5,68
30 Veracruz de Ignacio de la Llave,130,130 Playa Vicente,Hombres,68,63,5,99
30 Veracruz de Ignacio de la Llave,130,130 Playa Vicente,Mujeres,2774,2698,76,13638
30 Veracruz de Ignacio de la Llave,130,130 Playa Vicente,Mujeres,14,14,0,1336
30 Veracruz de Ignacio de la Llave,130,130 Playa Vicente,Mujeres,224,205,19,2067
30 Veracruz de Ignacio de la Llave,130,130 Playa Vicente,Mujeres,428,404,24,1254
30 Veracruz de Ignacio de la Llave,130,130 Playa Vicente,Mujeres,399,383,16,1067
30 Veracruz de Ignacio de la Llave,130,130 Playa Vicente,Mujeres,324,320,4,1151
30 Veracruz de Ignacio de la Llave,130,130 Playa Vicente,Mujeres,358,353,5,1102
30 Veracruz de Ignacio de la Llave,130,130 Playa Vicente,Mujeres,307,302,5,968
30 Veracruz de Ignacio de la Llave,130,130 Playa Vicente,Mujeres,258,255,3,863
30 Veracruz de Ignacio de la Llave,130,130 Playa Vicente,Mujeres,190,190,0,840
30 Veracruz de Ignacio de la Llave,130,130 Playa Vicente,Mujeres,124,124,0,760
30 Veracruz de Ignacio de la Llave,130,130 Playa Vicente,Mujeres,58,58,0,603
30 Veracruz de Ignacio de la Llave,130,130 Playa Vicente,Mujeres,47,47,0,520
30 Veracruz de Ignacio de la Llave,130,130 Playa Vicente,Mujeres,30,30,0,487
30 Veracruz de Ignacio de la Llave,130,130 Playa Vicente,Mujeres,6,6,0,279
30 Veracruz de Ignacio de la Llave,130,130 Playa Vicente,Mujeres,4,4,0,173
30 Veracruz de Ignacio de la Llave,130,130 Playa Vicente,Mujeres,3,3,0,168
30 Veracruz de Ignacio de la Llave,131,131 Poza Rica de Hidalgo,Total,80179,77897,2282,69991
30 Veracruz de Ignacio de la Llave,131,131 Poza Rica de Hidalgo,Total,199,172,27,8927
30 Veracruz de Ignacio de la Llave,131,131 Poza Rica de Hidalgo,Total,3224,2979,245,12389
30 Veracruz de Ignacio de la Llave,131,131 Poza Rica de Hidalgo,Total,8684,8118,566,7109
30 Veracruz de Ignacio de la Llave,131,131 Poza Rica de Hidalgo,Total,11096,10642,454,3956
30 Veracruz de Ignacio de la Llave,131,131 Poza Rica de Hidalgo,Total,10588,10356,232,3726
30 Veracruz de Ignacio de la Llave,131,131 Poza Rica de Hidalgo,Total,11313,11124,189,3724
30 Veracruz de Ignacio de la Llave,131,131 Poza Rica de Hidalgo,Total,9991,9839,152,3329
30 Veracruz de Ignacio de la Llave,131,131 Poza Rica de Hidalgo,Total,8465,8349,116,3108
30 Veracruz de Ignacio de la Llave,131,131 Poza Rica de Hidalgo,Total,6361,6270,91,3501
30 Veracruz de Ignacio de la Llave,131,131 Poza Rica de Hidalgo,Total,4250,4173,77,3835
30 Veracruz de Ignacio de la Llave,131,131 Poza Rica de Hidalgo,Total,2785,2742,43,4111
30 Veracruz de Ignacio de la Llave,131,131 Poza Rica de Hidalgo,Total,1598,1554,44,3689
30 Veracruz de Ignacio de la Llave,131,131 Poza Rica de Hidalgo,Total,910,886,24,3457
30 Veracruz de Ignacio de la Llave,131,131 Poza Rica de Hidalgo,Total,407,394,13,2353
30 Veracruz de Ignacio de la Llave,131,131 Poza Rica de Hidalgo,Total,198,191,7,1537
30 Veracruz de Ignacio de la Llave,131,131 Poza Rica de Hidalgo,Total,110,108,2,1240
30 Veracruz de Ignacio de la Llave,131,131 Poza Rica de Hidalgo,Hombres,49937,48232,1705,19629
30 Veracruz de Ignacio de la Llave,131,131 Poza Rica de Hidalgo,Hombres,137,116,21,4456
30 Veracruz de Ignacio de la Llave,131,131 Poza Rica de Hidalgo,Hombres,2185,1990,195,5499
30 Veracruz de Ignacio de la Llave,131,131 Poza Rica de Hidalgo,Hombres,5258,4887,371,2204
30 Veracruz de Ignacio de la Llave,131,131 Poza Rica de Hidalgo,Hombres,6753,6439,314,328
30 Veracruz de Ignacio de la Llave,131,131 Poza Rica de Hidalgo,Hombres,6439,6273,166,115
30 Veracruz de Ignacio de la Llave,131,131 Poza Rica de Hidalgo,Hombres,6777,6631,146,136
30 Veracruz de Ignacio de la Llave,131,131 Poza Rica de Hidalgo,Hombres,6094,5979,115,140
30 Veracruz de Ignacio de la Llave,131,131 Poza Rica de Hidalgo,Hombres,5207,5113,94,172
30 Veracruz de Ignacio de la Llave,131,131 Poza Rica de Hidalgo,Hombres,4021,3939,82,437
30 Veracruz de Ignacio de la Llave,131,131 Poza Rica de Hidalgo,Hombres,2824,2750,74,750
30 Veracruz de Ignacio de la Llave,131,131 Poza Rica de Hidalgo,Hombres,1884,1843,41,1149
30 Veracruz de Ignacio de la Llave,131,131 Poza Rica de Hidalgo,Hombres,1141,1099,42,1110
30 Veracruz de Ignacio de la Llave,131,131 Poza Rica de Hidalgo,Hombres,681,658,23,1233
30 Veracruz de Ignacio de la Llave,131,131 Poza Rica de Hidalgo,Hombres,307,294,13,865
30 Veracruz de Ignacio de la Llave,131,131 Poza Rica de Hidalgo,Hombres,143,137,6,582
30 Veracruz de Ignacio de la Llave,131,131 Poza Rica de Hidalgo,Hombres,86,84,2,453
30 Veracruz de Ignacio de la Llave,131,131 Poza Rica de Hidalgo,Mujeres,30242,29665,577,50362
30 Veracruz de Ignacio de la Llave,131,131 Poza Rica de Hidalgo,Mujeres,62,56,6,4471
30 Veracruz de Ignacio de la Llave,131,131 Poza Rica de Hidalgo,Mujeres,1039,989,50,6890
30 Veracruz de Ignacio de la Llave,131,131 Poza Rica de Hidalgo,Mujeres,3426,3231,195,4905
30 Veracruz de Ignacio de la Llave,131,131 Poza Rica de Hidalgo,Mujeres,4343,4203,140,3628
30 Veracruz de Ignacio de la Llave,131,131 Poza Rica de Hidalgo,Mujeres,4149,4083,66,3611
30 Veracruz de Ignacio de la Llave,131,131 Poza Rica de Hidalgo,Mujeres,4536,4493,43,3588
30 Veracruz de Ignacio de la Llave,131,131 Poza Rica de Hidalgo,Mujeres,3897,3860,37,3189
30 Veracruz de Ignacio de la Llave,131,131 Poza Rica de Hidalgo,Mujeres,3258,3236,22,2936
30 Veracruz de Ignacio de la Llave,131,131 Poza Rica de Hidalgo,Mujeres,2340,2331,9,3064
30 Veracruz de Ignacio de la Llave,131,131 Poza Rica de Hidalgo,Mujeres,1426,1423,3,3085
30 Veracruz de Ignacio de la Llave,131,131 Poza Rica de Hidalgo,Mujeres,901,899,2,2962
30 Veracruz de Ignacio de la Llave,131,131 Poza Rica de Hidalgo,Mujeres,457,455,2,2579
30 Veracruz de Ignacio de la Llave,131,131 Poza Rica de Hidalgo,Mujeres,229,228,1,2224
30 Veracruz de Ignacio de la Llave,131,131 Poza Rica de Hidalgo,Mujeres,100,100,0,1488
30 Veracruz de Ignacio de la Llave,131,131 Poza Rica de Hidalgo,Mujeres,55,54,1,955
30 Veracruz de Ignacio de la Llave,131,131 Poza Rica de Hidalgo,Mujeres,24,24,0,787
30 Veracruz de Ignacio de la Llave,133,133 Pueblo Viejo,Total,22106,20917,1189,20269
30 Veracruz de Ignacio de la Llave,133,133 Pueblo Viejo,Total,78,69,9,3043
30 Veracruz de Ignacio de la Llave,133,133 Pueblo Viejo,Total,1546,1363,183,3761
30 Veracruz de Ignacio de la Llave,133,133 Pueblo Viejo,Total,2967,2769,198,1906
30 Veracruz de Ignacio de la Llave,133,133 Pueblo Viejo,Total,2816,2678,138,1427
30 Veracruz de Ignacio de la Llave,133,133 Pueblo Viejo,Total,2651,2514,137,1299
30 Veracruz de Ignacio de la Llave,133,133 Pueblo Viejo,Total,2822,2716,106,1298
30 Veracruz de Ignacio de la Llave,133,133 Pueblo Viejo,Total,2641,2546,95,1249
30 Veracruz de Ignacio de la Llave,133,133 Pueblo Viejo,Total,2235,2149,86,1100
30 Veracruz de Ignacio de la Llave,133,133 Pueblo Viejo,Total,1661,1581,80,974
30 Veracruz de Ignacio de la Llave,133,133 Pueblo Viejo,Total,1147,1075,72,792
30 Veracruz de Ignacio de la Llave,133,133 Pueblo Viejo,Total,679,645,34,877
30 Veracruz de Ignacio de la Llave,133,133 Pueblo Viejo,Total,413,390,23,775
30 Veracruz de Ignacio de la Llave,133,133 Pueblo Viejo,Total,268,251,17,694
30 Veracruz de Ignacio de la Llave,133,133 Pueblo Viejo,Total,110,103,7,490
30 Veracruz de Ignacio de la Llave,133,133 Pueblo Viejo,Total,48,45,3,316
30 Veracruz de Ignacio de la Llave,133,133 Pueblo Viejo,Total,24,23,1,268
30 Veracruz de Ignacio de la Llave,133,133 Pueblo Viejo,Hombres,15728,14684,1044,5363
30 Veracruz de Ignacio de la Llave,133,133 Pueblo Viejo,Hombres,53,46,7,1547
30 Veracruz de Ignacio de la Llave,133,133 Pueblo Viejo,Hombres,1128,981,147,1586
30 Veracruz de Ignacio de la Llave,133,133 Pueblo Viejo,Hombres,2082,1934,148,366
30 Veracruz de Ignacio de la Llave,133,133 Pueblo Viejo,Hombres,1996,1873,123,117
30 Veracruz de Ignacio de la Llave,133,133 Pueblo Viejo,Hombres,1819,1695,124,56
30 Veracruz de Ignacio de la Llave,133,133 Pueblo Viejo,Hombres,1973,1876,97,63
30 Veracruz de Ignacio de la Llave,133,133 Pueblo Viejo,Hombres,1832,1741,91,89
30 Veracruz de Ignacio de la Llave,133,133 Pueblo Viejo,Hombres,1562,1482,80,82
30 Veracruz de Ignacio de la Llave,133,133 Pueblo Viejo,Hombres,1209,1135,74,133
30 Veracruz de Ignacio de la Llave,133,133 Pueblo Viejo,Hombres,869,799,70,117
30 Veracruz de Ignacio de la Llave,133,133 Pueblo Viejo,Hombres,523,491,32,251
30 Veracruz de Ignacio de la Llave,133,133 Pueblo Viejo,Hombres,325,302,23,266
30 Veracruz de Ignacio de la Llave,133,133 Pueblo Viejo,Hombres,213,196,17,251
30 Veracruz de Ignacio de la Llave,133,133 Pueblo Viejo,Hombres,86,79,7,208
30 Veracruz de Ignacio de la Llave,133,133 Pueblo Viejo,Hombres,40,37,3,132
30 Veracruz de Ignacio de la Llave,133,133 Pueblo Viejo,Hombres,18,17,1,99
30 Veracruz de Ignacio de la Llave,133,133 Pueblo Viejo,Mujeres,6378,6233,145,14906
30 Veracruz de Ignacio de la Llave,133,133 Pueblo Viejo,Mujeres,25,23,2,1496
30 Veracruz de Ignacio de la Llave,133,133 Pueblo Viejo,Mujeres,418,382,36,2175
30 Veracruz de Ignacio de la Llave,133,133 Pueblo Viejo,Mujeres,885,835,50,1540
30 Veracruz de Ignacio de la Llave,133,133 Pueblo Viejo,Mujeres,820,805,15,1310
30 Veracruz de Ignacio de la Llave,133,133 Pueblo Viejo,Mujeres,832,819,13,1243
30 Veracruz de Ignacio de la Llave,133,133 Pueblo Viejo,Mujeres,849,840,9,1235
30 Veracruz de Ignacio de la Llave,133,133 Pueblo Viejo,Mujeres,809,805,4,1160
30 Veracruz de Ignacio de la Llave,133,133 Pueblo Viejo,Mujeres,673,667,6,1018
30 Veracruz de Ignacio de la Llave,133,133 Pueblo Viejo,Mujeres,452,446,6,841
30 Veracruz de Ignacio de la Llave,133,133 Pueblo Viejo,Mujeres,278,276,2,675
30 Veracruz de Ignacio de la Llave,133,133 Pueblo Viejo,Mujeres,156,154,2,626
30 Veracruz de Ignacio de la Llave,133,133 Pueblo Viejo,Mujeres,88,88,0,509
30 Veracruz de Ignacio de la Llave,133,133 Pueblo Viejo,Mujeres,55,55,0,443
30 Veracruz de Ignacio de la Llave,133,133 Pueblo Viejo,Mujeres,24,24,0,282
30 Veracruz de Ignacio de la Llave,133,133 Pueblo Viejo,Mujeres,8,8,0,184
30 Veracruz de Ignacio de la Llave,133,133 Pueblo Viejo,Mujeres,6,6,0,169
30 Veracruz de Ignacio de la Llave,134,134 Puente Nacional,Total,8528,8078,450,8395
30 Veracruz de Ignacio de la Llave,134,134 Puente Nacional,Total,82,70,12,1021
30 Veracruz de Ignacio de la Llave,134,134 Puente Nacional,Total,612,552,60,1448
30 Veracruz de Ignacio de la Llave,134,134 Puente Nacional,Total,1020,945,75,772
30 Veracruz de Ignacio de la Llave,134,134 Puente Nacional,Total,952,908,44,560
30 Veracruz de Ignacio de la Llave,134,134 Puente Nacional,Total,969,921,48,587
30 Veracruz de Ignacio de la Llave,134,134 Puente Nacional,Total,1031,994,37,599
30 Veracruz de Ignacio de la Llave,134,134 Puente Nacional,Total,976,944,32,562
30 Veracruz de Ignacio de la Llave,134,134 Puente Nacional,Total,847,820,27,498
30 Veracruz de Ignacio de la Llave,134,134 Puente Nacional,Total,643,602,41,475
30 Veracruz de Ignacio de la Llave,134,134 Puente Nacional,Total,499,478,21,415
30 Veracruz de Ignacio de la Llave,134,134 Puente Nacional,Total,334,313,21,389
30 Veracruz de Ignacio de la Llave,134,134 Puente Nacional,Total,250,237,13,296
30 Veracruz de Ignacio de la Llave,134,134 Puente Nacional,Total,164,155,9,264
30 Veracruz de Ignacio de la Llave,134,134 Puente Nacional,Total,101,96,5,219
30 Veracruz de Ignacio de la Llave,134,134 Puente Nacional,Total,32,31,1,134
30 Veracruz de Ignacio de la Llave,134,134 Puente Nacional,Total,16,12,4,156
30 Veracruz de Ignacio de la Llave,134,134 Puente Nacional,Hombres,6328,5948,380,1915
30 Veracruz de Ignacio de la Llave,134,134 Puente Nacional,Hombres,61,52,9,530
30 Veracruz de Ignacio de la Llave,134,134 Puente Nacional,Hombres,444,401,43,584
30 Veracruz de Ignacio de la Llave,134,134 Puente Nacional,Hombres,708,653,55,149
30 Veracruz de Ignacio de la Llave,134,134 Puente Nacional,Hombres,660,629,31,37
30 Veracruz de Ignacio de la Llave,134,134 Puente Nacional,Hombres,679,638,41,26
30 Veracruz de Ignacio de la Llave,134,134 Puente Nacional,Hombres,725,691,34,32
30 Veracruz de Ignacio de la Llave,134,134 Puente Nacional,Hombres,709,678,31,27
30 Veracruz de Ignacio de la Llave,134,134 Puente Nacional,Hombres,663,636,27,25
30 Veracruz de Ignacio de la Llave,134,134 Puente Nacional,Hombres,497,459,38,41
30 Veracruz de Ignacio de la Llave,134,134 Puente Nacional,Hombres,415,394,21,57
30 Veracruz de Ignacio de la Llave,134,134 Puente Nacional,Hombres,281,262,19,86
30 Veracruz de Ignacio de la Llave,134,134 Puente Nacional,Hombres,218,205,13,62
30 Veracruz de Ignacio de la Llave,134,134 Puente Nacional,Hombres,141,132,9,75
30 Veracruz de Ignacio de la Llave,134,134 Puente Nacional,Hombres,88,84,4,73
30 Veracruz de Ignacio de la Llave,134,134 Puente Nacional,Hombres,27,26,1,42
30 Veracruz de Ignacio de la Llave,134,134 Puente Nacional,Hombres,12,8,4,69
30 Veracruz de Ignacio de la Llave,134,134 Puente Nacional,Mujeres,2200,2130,70,6480
30 Veracruz de Ignacio de la Llave,134,134 Puente Nacional,Mujeres,21,18,3,491
30 Veracruz de Ignacio de la Llave,134,134 Puente Nacional,Mujeres,168,151,17,864
30 Veracruz de Ignacio de la Llave,134,134 Puente Nacional,Mujeres,312,292,20,623
30 Veracruz de Ignacio de la Llave,134,134 Puente Nacional,Mujeres,292,279,13,523
30 Veracruz de Ignacio de la Llave,134,134 Puente Nacional,Mujeres,290,283,7,561
30 Veracruz de Ignacio de la Llave,134,134 Puente Nacional,Mujeres,306,303,3,567
30 Veracruz de Ignacio de la Llave,134,134 Puente Nacional,Mujeres,267,266,1,535
30 Veracruz de Ignacio de la Llave,134,134 Puente Nacional,Mujeres,184,184,0,473
30 Veracruz de Ignacio de la Llave,134,134 Puente Nacional,Mujeres,146,143,3,434
30 Veracruz de Ignacio de la Llave,134,134 Puente Nacional,Mujeres,84,84,0,358
30 Veracruz de Ignacio de la Llave,134,134 Puente Nacional,Mujeres,53,51,2,303
30 Veracruz de Ignacio de la Llave,134,134 Puente Nacional,Mujeres,32,32,0,234
30 Veracruz de Ignacio de la Llave,134,134 Puente Nacional,Mujeres,23,23,0,189
30 Veracruz de Ignacio de la Llave,134,134 Puente Nacional,Mujeres,13,12,1,146
30 Veracruz de Ignacio de la Llave,134,134 Puente Nacional,Mujeres,5,5,0,92
30 Veracruz de Ignacio de la Llave,134,134 Puente Nacional,Mujeres,4,4,0,87
30 Veracruz de Ignacio de la Llave,135,135 Rafael Delgado,Total,7665,7349,316,6695
30 Veracruz de Ignacio de la Llave,135,135 Rafael Delgado,Total,69,59,10,1153
30 Veracruz de Ignacio de la Llave,135,135 Rafael Delgado,Total,661,592,69,1387
30 Veracruz de Ignacio de la Llave,135,135 Rafael Delgado,Total,1196,1127,69,816
30 Veracruz de Ignacio de la Llave,135,135 Rafael Delgado,Total,1179,1130,49,576
30 Veracruz de Ignacio de la Llave,135,135 Rafael Delgado,Total,1060,1026,34,516
30 Veracruz de Ignacio de la Llave,135,135 Rafael Delgado,Total,931,908,23,421
30 Veracruz de Ignacio de la Llave,135,135 Rafael Delgado,Total,735,722,13,281
30 Veracruz de Ignacio de la Llave,135,135 Rafael Delgado,Total,608,587,21,285
30 Veracruz de Ignacio de la Llave,135,135 Rafael Delgado,Total,416,406,10,236
30 Veracruz de Ignacio de la Llave,135,135 Rafael Delgado,Total,331,324,7,238
30 Veracruz de Ignacio de la Llave,135,135 Rafael Delgado,Total,180,177,3,201
30 Veracruz de Ignacio de la Llave,135,135 Rafael Delgado,Total,119,115,4,182
30 Veracruz de Ignacio de la Llave,135,135 Rafael Delgado,Total,93,89,4,159
30 Veracruz de Ignacio de la Llave,135,135 Rafael Delgado,Total,55,55,0,106
30 Veracruz de Ignacio de la Llave,135,135 Rafael Delgado,Total,19,19,0,65
30 Veracruz de Ignacio de la Llave,135,135 Rafael Delgado,Total,13,13,0,73
30 Veracruz de Ignacio de la Llave,135,135 Rafael Delgado,Hombres,5369,5098,271,1572
30 Veracruz de Ignacio de la Llave,135,135 Rafael Delgado,Hombres,57,48,9,561
30 Veracruz de Ignacio de la Llave,135,135 Rafael Delgado,Hombres,499,440,59,495
30 Veracruz de Ignacio de la Llave,135,135 Rafael Delgado,Hombres,841,786,55,135
30 Veracruz de Ignacio de la Llave,135,135 Rafael Delgado,Hombres,827,788,39,33
30 Veracruz de Ignacio de la Llave,135,135 Rafael Delgado,Hombres,728,698,30,21
30 Veracruz de Ignacio de la Llave,135,135 Rafael Delgado,Hombres,605,584,21,24
30 Veracruz de Ignacio de la Llave,135,135 Rafael Delgado,Hombres,477,467,10,15
30 Veracruz de Ignacio de la Llave,135,135 Rafael Delgado,Hombres,424,403,21,19
30 Veracruz de Ignacio de la Llave,135,135 Rafael Delgado,Hombres,294,285,9,23
30 Veracruz de Ignacio de la Llave,135,135 Rafael Delgado,Hombres,241,234,7,37
30 Veracruz de Ignacio de la Llave,135,135 Rafael Delgado,Hombres,133,130,3,36
30 Veracruz de Ignacio de la Llave,135,135 Rafael Delgado,Hombres,95,91,4,42
30 Veracruz de Ignacio de la Llave,135,135 Rafael Delgado,Hombres,73,69,4,48
30 Veracruz de Ignacio de la Llave,135,135 Rafael Delgado,Hombres,46,46,0,33
30 Veracruz de Ignacio de la Llave,135,135 Rafael Delgado,Hombres,17,17,0,25
30 Veracruz de Ignacio de la Llave,135,135 Rafael Delgado,Hombres,12,12,0,25
30 Veracruz de Ignacio de la Llave,135,135 Rafael Delgado,Mujeres,2296,2251,45,5123
30 Veracruz de Ignacio de la Llave,135,135 Rafael Delgado,Mujeres,12,11,1,592
30 Veracruz de Ignacio de la Llave,135,135 Rafael Delgado,Mujeres,162,152,10,892
30 Veracruz de Ignacio de la Llave,135,135 Rafael Delgado,Mujeres,355,341,14,681
30 Veracruz de Ignacio de la Llave,135,135 Rafael Delgado,Mujeres,352,342,10,543
30 Veracruz de Ignacio de la Llave,135,135 Rafael Delgado,Mujeres,332,328,4,495
30 Veracruz de Ignacio de la Llave,135,135 Rafael Delgado,Mujeres,326,324,2,397
30 Veracruz de Ignacio de la Llave,135,135 Rafael Delgado,Mujeres,258,255,3,266
30 Veracruz de Ignacio de la Llave,135,135 Rafael Delgado,Mujeres,184,184,0,266
30 Veracruz de Ignacio de la Llave,135,135 Rafael Delgado,Mujeres,122,121,1,213
30 Veracruz de Ignacio de la Llave,135,135 Rafael Delgado,Mujeres,90,90,0,201
30 Veracruz de Ignacio de la Llave,135,135 Rafael Delgado,Mujeres,47,47,0,165
30 Veracruz de Ignacio de la Llave,135,135 Rafael Delgado,Mujeres,24,24,0,140
30 Veracruz de Ignacio de la Llave,135,135 Rafael Delgado,Mujeres,20,20,0,111
30 Veracruz de Ignacio de la Llave,135,135 Rafael Delgado,Mujeres,9,9,0,73
30 Veracruz de Ignacio de la Llave,135,135 Rafael Delgado,Mujeres,2,2,0,40
30 Veracruz de Ignacio de la Llave,135,135 Rafael Delgado,Mujeres,1,1,0,48
30 Veracruz de Ignacio de la Llave,136,136 Rafael Lucio,Total,2760,2695,65,2394
30 Veracruz de Ignacio de la Llave,136,136 Rafael Lucio,Total,26,22,4,371
30 Veracruz de Ignacio de la Llave,136,136 Rafael Lucio,Total,218,210,8,495
30 Veracruz de Ignacio de la Llave,136,136 Rafael Lucio,Total,405,389,16,267
30 Veracruz de Ignacio de la Llave,136,136 Rafael Lucio,Total,384,372,12,180
30 Veracruz de Ignacio de la Llave,136,136 Rafael Lucio,Total,393,389,4,181
30 Veracruz de Ignacio de la Llave,136,136 Rafael Lucio,Total,341,336,5,151
30 Veracruz de Ignacio de la Llave,136,136 Rafael Lucio,Total,277,271,6,145
30 Veracruz de Ignacio de la Llave,136,136 Rafael Lucio,Total,216,213,3,114
30 Veracruz de Ignacio de la Llave,136,136 Rafael Lucio,Total,168,163,5,94
30 Veracruz de Ignacio de la Llave,136,136 Rafael Lucio,Total,120,119,1,93
30 Veracruz de Ignacio de la Llave,136,136 Rafael Lucio,Total,85,85,0,65
30 Veracruz de Ignacio de la Llave,136,136 Rafael Lucio,Total,60,59,1,61
30 Veracruz de Ignacio de la Llave,136,136 Rafael Lucio,Total,29,29,0,70
30 Veracruz de Ignacio de la Llave,136,136 Rafael Lucio,Total,28,28,0,40
30 Veracruz de Ignacio de la Llave,136,136 Rafael Lucio,Total,6,6,0,35
30 Veracruz de Ignacio de la Llave,136,136 Rafael Lucio,Total,4,4,0,32
30 Veracruz de Ignacio de la Llave,136,136 Rafael Lucio,Hombres,1927,1869,58,537
30 Veracruz de Ignacio de la Llave,136,136 Rafael Lucio,Hombres,23,19,4,184
30 Veracruz de Ignacio de la Llave,136,136 Rafael Lucio,Hombres,153,145,8,183
30 Veracruz de Ignacio de la Llave,136,136 Rafael Lucio,Hombres,274,261,13,25
30 Veracruz de Ignacio de la Llave,136,136 Rafael Lucio,Hombres,265,255,10,16
30 Veracruz de Ignacio de la Llave,136,136 Rafael Lucio,Hombres,278,275,3,7
30 Veracruz de Ignacio de la Llave,136,136 Rafael Lucio,Hombres,227,222,5,6
30 Veracruz de Ignacio de la Llave,136,136 Rafael Lucio,Hombres,200,194,6,16
30 Veracruz de Ignacio de la Llave,136,136 Rafael Lucio,Hombres,141,138,3,8
30 Veracruz de Ignacio de la Llave,136,136 Rafael Lucio,Hombres,117,113,4,9
30 Veracruz de Ignacio de la Llave,136,136 Rafael Lucio,Hombres,85,84,1,14
30 Veracruz de Ignacio de la Llave,136,136 Rafael Lucio,Hombres,61,61,0,12
30 Veracruz de Ignacio de la Llave,136,136 Rafael Lucio,Hombres,46,45,1,10
30 Veracruz de Ignacio de la Llave,136,136 Rafael Lucio,Hombres,23,23,0,16
30 Veracruz de Ignacio de la Llave,136,136 Rafael Lucio,Hombres,24,24,0,13
30 Veracruz de Ignacio de la Llave,136,136 Rafael Lucio,Hombres,6,6,0,10
30 Veracruz de Ignacio de la Llave,136,136 Rafael Lucio,Hombres,4,4,0,8
30 Veracruz de Ignacio de la Llave,136,136 Rafael Lucio,Mujeres,833,826,7,1857
30 Veracruz de Ignacio de la Llave,136,136 Rafael Lucio,Mujeres,3,3,0,187
30 Veracruz de Ignacio de la Llave,136,136 Rafael Lucio,Mujeres,65,65,0,312
30 Veracruz de Ignacio de la Llave,136,136 Rafael Lucio,Mujeres,131,128,3,242
30 Veracruz de Ignacio de la Llave,136,136 Rafael Lucio,Mujeres,119,117,2,164
30 Veracruz de Ignacio de la Llave,136,136 Rafael Lucio,Mujeres,115,114,1,174
30 Veracruz de Ignacio de la Llave,136,136 Rafael Lucio,Mujeres,114,114,0,145
30 Veracruz de Ignacio de la Llave,136,136 Rafael Lucio,Mujeres,77,77,0,129
30 Veracruz de Ignacio de la Llave,136,136 Rafael Lucio,Mujeres,75,75,0,106
30 Veracruz de Ignacio de la Llave,136,136 Rafael Lucio,Mujeres,51,50,1,85
30 Veracruz de Ignacio de la Llave,136,136 Rafael Lucio,Mujeres,35,35,0,79
30 Veracruz de Ignacio de la Llave,136,136 Rafael Lucio,Mujeres,24,24,0,53
30 Veracruz de Ignacio de la Llave,136,136 Rafael Lucio,Mujeres,14,14,0,51
30 Veracruz de Ignacio de la Llave,136,136 Rafael Lucio,Mujeres,6,6,0,54
30 Veracruz de Ignacio de la Llave,136,136 Rafael Lucio,Mujeres,4,4,0,27
30 Veracruz de Ignacio de la Llave,136,136 Rafael Lucio,Mujeres,0,0,0,25
30 Veracruz de Ignacio de la Llave,136,136 Rafael Lucio,Mujeres,0,0,0,24
30 Veracruz de Ignacio de la Llave,138,138 Río Blanco,Total,16466,15449,1017,15519
30 Veracruz de Ignacio de la Llave,138,138 Río Blanco,Total,35,32,3,1911
30 Veracruz de Ignacio de la Llave,138,138 Río Blanco,Total,683,584,99,2755
30 Veracruz de Ignacio de la Llave,138,138 Río Blanco,Total,1720,1514,206,1610
30 Veracruz de Ignacio de la Llave,138,138 Río Blanco,Total,2223,2014,209,820
30 Veracruz de Ignacio de la Llave,138,138 Río Blanco,Total,2159,2062,97,733
30 Veracruz de Ignacio de la Llave,138,138 Río Blanco,Total,2242,2151,91,746
30 Veracruz de Ignacio de la Llave,138,138 Río Blanco,Total,1985,1928,57,696
30 Veracruz de Ignacio de la Llave,138,138 Río Blanco,Total,1795,1714,81,644
30 Veracruz de Ignacio de la Llave,138,138 Río Blanco,Total,1480,1420,60,785
30 Veracruz de Ignacio de la Llave,138,138 Río Blanco,Total,993,942,51,752
30 Veracruz de Ignacio de la Llave,138,138 Río Blanco,Total,545,515,30,976
30 Veracruz de Ignacio de la Llave,138,138 Río Blanco,Total,281,265,16,786
30 Veracruz de Ignacio de la Llave,138,138 Río Blanco,Total,152,147,5,794
30 Veracruz de Ignacio de la Llave,138,138 Río Blanco,Total,95,88,7,660
30 Veracruz de Ignacio de la Llave,138,138 Río Blanco,Total,51,46,5,464
30 Veracruz de Ignacio de la Llave,138,138 Río Blanco,Total,27,27,0,387
30 Veracruz de Ignacio de la Llave,138,138 Río Blanco,Hombres,9988,9252,736,4688
30 Veracruz de Ignacio de la Llave,138,138 Río Blanco,Hombres,29,26,3,996
30 Veracruz de Ignacio de la Llave,138,138 Río Blanco,Hombres,490,419,71,1216
30 Veracruz de Ignacio de la Llave,138,138 Río Blanco,Hombres,1085,954,131,518
30 Veracruz de Ignacio de la Llave,138,138 Río Blanco,Hombres,1297,1174,123,96
30 Veracruz de Ignacio de la Llave,138,138 Río Blanco,Hombres,1253,1188,65,46
30 Veracruz de Ignacio de la Llave,138,138 Río Blanco,Hombres,1311,1243,68,43
30 Veracruz de Ignacio de la Llave,138,138 Río Blanco,Hombres,1128,1079,49,43
30 Veracruz de Ignacio de la Llave,138,138 Río Blanco,Hombres,1053,987,66,55
30 Veracruz de Ignacio de la Llave,138,138 Río Blanco,Hombres,926,872,54,99
30 Veracruz de Ignacio de la Llave,138,138 Río Blanco,Hombres,666,619,47,123
30 Veracruz de Ignacio de la Llave,138,138 Río Blanco,Hombres,345,318,27,317
30 Veracruz de Ignacio de la Llave,138,138 Río Blanco,Hombres,186,170,16,276
30 Veracruz de Ignacio de la Llave,138,138 Río Blanco,Hombres,101,96,5,268
30 Veracruz de Ignacio de la Llave,138,138 Río Blanco,Hombres,61,54,7,278
30 Veracruz de Ignacio de la Llave,138,138 Río Blanco,Hombres,37,33,4,173
30 Veracruz de Ignacio de la Llave,138,138 Río Blanco,Hombres,20,20,0,141
30 Veracruz de Ignacio de la Llave,138,138 Río Blanco,Mujeres,6478,6197,281,10831
30 Veracruz de Ignacio de la Llave,138,138 Río Blanco,Mujeres,6,6,0,915
30 Veracruz de Ignacio de la Llave,138,138 Río Blanco,Mujeres,193,165,28,1539
30 Veracruz de Ignacio de la Llave,138,138 Río Blanco,Mujeres,635,560,75,1092
30 Veracruz de Ignacio de la Llave,138,138 Río Blanco,Mujeres,926,840,86,724
30 Veracruz de Ignacio de la Llave,138,138 Río Blanco,Mujeres,906,874,32,687
30 Veracruz de Ignacio de la Llave,138,138 Río Blanco,Mujeres,931,908,23,703
30 Veracruz de Ignacio de la Llave,138,138 Río Blanco,Mujeres,857,849,8,653
30 Veracruz de Ignacio de la Llave,138,138 Río Blanco,Mujeres,742,727,15,589
30 Veracruz de Ignacio de la Llave,138,138 Río Blanco,Mujeres,554,548,6,686
30 Veracruz de Ignacio de la Llave,138,138 Río Blanco,Mujeres,327,323,4,629
30 Veracruz de Ignacio de la Llave,138,138 Río Blanco,Mujeres,200,197,3,659
30 Veracruz de Ignacio de la Llave,138,138 Río Blanco,Mujeres,95,95,0,510
30 Veracruz de Ignacio de la Llave,138,138 Río Blanco,Mujeres,51,51,0,526
30 Veracruz de Ignacio de la Llave,138,138 Río Blanco,Mujeres,34,34,0,382
30 Veracruz de Ignacio de la Llave,138,138 Río Blanco,Mujeres,14,13,1,291
30 Veracruz de Ignacio de la Llave,138,138 Río Blanco,Mujeres,7,7,0,246
30 Veracruz de Ignacio de la Llave,139,139 Saltabarranca,Total,1963,1859,104,2765
30 Veracruz de Ignacio de la Llave,139,139 Saltabarranca,Total,5,5,0,308
30 Veracruz de Ignacio de la Llave,139,139 Saltabarranca,Total,124,110,14,410
30 Veracruz de Ignacio de la Llave,139,139 Saltabarranca,Total,222,203,19,197
30 Veracruz de Ignacio de la Llave,139,139 Saltabarranca,Total,210,198,12,159
30 Veracruz de Ignacio de la Llave,139,139 Saltabarranca,Total,215,198,17,173
30 Veracruz de Ignacio de la Llave,139,139 Saltabarranca,Total,240,231,9,175
30 Veracruz de Ignacio de la Llave,139,139 Saltabarranca,Total,225,217,8,172
30 Veracruz de Ignacio de la Llave,139,139 Saltabarranca,Total,201,195,6,177
30 Veracruz de Ignacio de la Llave,139,139 Saltabarranca,Total,164,161,3,174
30 Veracruz de Ignacio de la Llave,139,139 Saltabarranca,Total,169,161,8,160
30 Veracruz de Ignacio de la Llave,139,139 Saltabarranca,Total,76,73,3,151
30 Veracruz de Ignacio de la Llave,139,139 Saltabarranca,Total,62,61,1,158
30 Veracruz de Ignacio de la Llave,139,139 Saltabarranca,Total,27,24,3,126
30 Veracruz de Ignacio de la Llave,139,139 Saltabarranca,Total,13,12,1,86
30 Veracruz de Ignacio de la Llave,139,139 Saltabarranca,Total,5,5,0,77
30 Veracruz de Ignacio de la Llave,139,139 Saltabarranca,Total,5,5,0,62
30 Veracruz de Ignacio de la Llave,139,139 Saltabarranca,Hombres,1564,1477,87,686
30 Veracruz de Ignacio de la Llave,139,139 Saltabarranca,Hombres,3,3,0,142
30 Veracruz de Ignacio de la Llave,139,139 Saltabarranca,Hombres,106,94,12,168
30 Veracruz de Ignacio de la Llave,139,139 Saltabarranca,Hombres,165,148,17,44
30 Veracruz de Ignacio de la Llave,139,139 Saltabarranca,Hombres,159,151,8,18
30 Veracruz de Ignacio de la Llave,139,139 Saltabarranca,Hombres,163,149,14,15
30 Veracruz de Ignacio de la Llave,139,139 Saltabarranca,Hombres,188,182,6,13
30 Veracruz de Ignacio de la Llave,139,139 Saltabarranca,Hombres,173,166,7,17
30 Veracruz de Ignacio de la Llave,139,139 Saltabarranca,Hombres,165,161,4,11
30 Veracruz de Ignacio de la Llave,139,139 Saltabarranca,Hombres,134,131,3,14
30 Veracruz de Ignacio de la Llave,139,139 Saltabarranca,Hombres,139,131,8,16
30 Veracruz de Ignacio de la Llave,139,139 Saltabarranca,Hombres,66,63,3,38
30 Veracruz de Ignacio de la Llave,139,139 Saltabarranca,Hombres,55,54,1,55
30 Veracruz de Ignacio de la Llave,139,139 Saltabarranca,Hombres,27,24,3,48
30 Veracruz de Ignacio de la Llave,139,139 Saltabarranca,Hombres,12,11,1,28
30 Veracruz de Ignacio de la Llave,139,139 Saltabarranca,Hombres,5,5,0,34
30 Veracruz de Ignacio de la Llave,139,139 Saltabarranca,Hombres,4,4,0,25
30 Veracruz de Ignacio de la Llave,139,139 Saltabarranca,Mujeres,399,382,17,2079
30 Veracruz de Ignacio de la Llave,139,139 Saltabarranca,Mujeres,2,2,0,166
30 Veracruz de Ignacio de la Llave,139,139 Saltabarranca,Mujeres,18,16,2,242
30 Veracruz de Ignacio de la Llave,139,139 Saltabarranca,Mujeres,57,55,2,153
30 Veracruz de Ignacio de la Llave,139,139 Saltabarranca,Mujeres,51,47,4,141
30 Veracruz de Ignacio de la Llave,139,139 Saltabarranca,Mujeres,52,49,3,158
30 Veracruz de Ignacio de la Llave,139,139 Saltabarranca,Mujeres,52,49,3,162
30 Veracruz de Ignacio de la Llave,139,139 Saltabarranca,Mujeres,52,51,1,155
30 Veracruz de Ignacio de la Llave,139,139 Saltabarranca,Mujeres,36,34,2,166
30 Veracruz de Ignacio de la Llave,139,139 Saltabarranca,Mujeres,30,30,0,160
30 Veracruz de Ignacio de la Llave,139,139 Saltabarranca,Mujeres,30,30,0,144
30 Veracruz de Ignacio de la Llave,139,139 Saltabarranca,Mujeres,10,10,0,113
30 Veracruz de Ignacio de la Llave,139,139 Saltabarranca,Mujeres,7,7,0,103
30 Veracruz de Ignacio de la Llave,139,139 Saltabarranca,Mujeres,0,0,0,78
30 Veracruz de Ignacio de la Llave,139,139 Saltabarranca,Mujeres,1,1,0,58
30 Veracruz de Ignacio de la Llave,139,139 Saltabarranca,Mujeres,0,0,0,43
30 Veracruz de Ignacio de la Llave,139,139 Saltabarranca,Mujeres,1,1,0,37
30 Veracruz de Ignacio de la Llave,140,140 San Andrés Tenejapan,Total,896,847,49,1062
30 Veracruz de Ignacio de la Llave,140,140 San Andrés Tenejapan,Total,7,6,1,184
30 Veracruz de Ignacio de la Llave,140,140 San Andrés Tenejapan,Total,90,80,10,222
30 Veracruz de Ignacio de la Llave,140,140 San Andrés Tenejapan,Total,166,153,13,140
30 Veracruz de Ignacio de la Llave,140,140 San Andrés Tenejapan,Total,136,129,7,108
30 Veracruz de Ignacio de la Llave,140,140 San Andrés Tenejapan,Total,123,118,5,74
30 Veracruz de Ignacio de la Llave,140,140 San Andrés Tenejapan,Total,95,91,4,62
30 Veracruz de Ignacio de la Llave,140,140 San Andrés Tenejapan,Total,69,68,1,43
30 Veracruz de Ignacio de la Llave,140,140 San Andrés Tenejapan,Total,67,66,1,42
30 Veracruz de Ignacio de la Llave,140,140 San Andrés Tenejapan,Total,44,41,3,42
30 Veracruz de Ignacio de la Llave,140,140 San Andrés Tenejapan,Total,41,39,2,34
30 Veracruz de Ignacio de la Llave,140,140 San Andrés Tenejapan,Total,19,18,1,18
30 Veracruz de Ignacio de la Llave,140,140 San Andrés Tenejapan,Total,19,18,1,22
30 Veracruz de Ignacio de la Llave,140,140 San Andrés Tenejapan,Total,9,9,0,23
30 Veracruz de Ignacio de la Llave,140,140 San Andrés Tenejapan,Total,4,4,0,21
30 Veracruz de Ignacio de la Llave,140,140 San Andrés Tenejapan,Total,3,3,0,13
30 Veracruz de Ignacio de la Llave,140,140 San Andrés Tenejapan,Total,4,4,0,14
30 Veracruz de Ignacio de la Llave,140,140 San Andrés Tenejapan,Hombres,655,611,44,250
30 Veracruz de Ignacio de la Llave,140,140 San Andrés Tenejapan,Hombres,6,5,1,92
30 Veracruz de Ignacio de la Llave,140,140 San Andrés Tenejapan,Hombres,68,59,9,73
30 Veracruz de Ignacio de la Llave,140,140 San Andrés Tenejapan,Hombres,127,114,13,25
30 Veracruz de Ignacio de la Llave,140,140 San Andrés Tenejapan,Hombres,100,94,6,3
30 Veracruz de Ignacio de la Llave,140,140 San Andrés Tenejapan,Hombres,87,83,4,5
30 Veracruz de Ignacio de la Llave,140,140 San Andrés Tenejapan,Hombres,70,68,2,1
30 Veracruz de Ignacio de la Llave,140,140 San Andrés Tenejapan,Hombres,47,46,1,4
30 Veracruz de Ignacio de la Llave,140,140 San Andrés Tenejapan,Hombres,42,41,1,2
30 Veracruz de Ignacio de la Llave,140,140 San Andrés Tenejapan,Hombres,34,31,3,6
30 Veracruz de Ignacio de la Llave,140,140 San Andrés Tenejapan,Hombres,31,29,2,7
30 Veracruz de Ignacio de la Llave,140,140 San Andrés Tenejapan,Hombres,15,14,1,7
30 Veracruz de Ignacio de la Llave,140,140 San Andrés Tenejapan,Hombres,14,13,1,3
30 Veracruz de Ignacio de la Llave,140,140 San Andrés Tenejapan,Hombres,6,6,0,4
30 Veracruz de Ignacio de la Llave,140,140 San Andrés Tenejapan,Hombres,2,2,0,6
30 Veracruz de Ignacio de la Llave,140,140 San Andrés Tenejapan,Hombres,2,2,0,8
30 Veracruz de Ignacio de la Llave,140,140 San Andrés Tenejapan,Hombres,4,4,0,4
30 Veracruz de Ignacio de la Llave,140,140 San Andrés Tenejapan,Mujeres,241,236,5,812
30 Veracruz de Ignacio de la Llave,140,140 San Andrés Tenejapan,Mujeres,1,1,0,92
30 Veracruz de Ignacio de la Llave,140,140 San Andrés Tenejapan,Mujeres,22,21,1,149
30 Veracruz de Ignacio de la Llave,140,140 San Andrés Tenejapan,Mujeres,39,39,0,115
30 Veracruz de Ignacio de la Llave,140,140 San Andrés Tenejapan,Mujeres,36,35,1,105
30 Veracruz de Ignacio de la Llave,140,140 San Andrés Tenejapan,Mujeres,36,35,1,69
30 Veracruz de Ignacio de la Llave,140,140 San Andrés Tenejapan,Mujeres,25,23,2,61
30 Veracruz de Ignacio de la Llave,140,140 San Andrés Tenejapan,Mujeres,22,22,0,39
30 Veracruz de Ignacio de la Llave,140,140 San Andrés Tenejapan,Mujeres,25,25,0,40
30 Veracruz de Ignacio de la Llave,140,140 San Andrés Tenejapan,Mujeres,10,10,0,36
30 Veracruz de Ignacio de la Llave,140,140 San Andrés Tenejapan,Mujeres,10,10,0,27
30 Veracruz de Ignacio de la Llave,140,140 San Andrés Tenejapan,Mujeres,4,4,0,11
30 Veracruz de Ignacio de la Llave,140,140 San Andrés Tenejapan,Mujeres,5,5,0,19
30 Veracruz de Ignacio de la Llave,140,140 San Andrés Tenejapan,Mujeres,3,3,0,19
30 Veracruz de Ignacio de la Llave,140,140 San Andrés Tenejapan,Mujeres,2,2,0,15
30 Veracruz de Ignacio de la Llave,140,140 San Andrés Tenejapan,Mujeres,1,1,0,5
30 Veracruz de Ignacio de la Llave,140,140 San Andrés Tenejapan,Mujeres,0,0,0,10
30 Veracruz de Ignacio de la Llave,141,141 San Andrés Tuxtla,Total,54813,52755,2058,63842
30 Veracruz de Ignacio de la Llave,141,141 San Andrés Tuxtla,Total,609,566,43,9438
30 Veracruz de Ignacio de la Llave,141,141 San Andrés Tuxtla,Total,4665,4337,328,11767
30 Veracruz de Ignacio de la Llave,141,141 San Andrés Tuxtla,Total,6660,6336,324,6407
30 Veracruz de Ignacio de la Llave,141,141 San Andrés Tuxtla,Total,6440,6182,258,5027
30 Veracruz de Ignacio de la Llave,141,141 San Andrés Tuxtla,Total,6317,6110,207,4658
30 Veracruz de Ignacio de la Llave,141,141 San Andrés Tuxtla,Total,6495,6325,170,4325
30 Veracruz de Ignacio de la Llave,141,141 San Andrés Tuxtla,Total,5911,5738,173,3821
30 Veracruz de Ignacio de la Llave,141,141 San Andrés Tuxtla,Total,5105,4943,162,3429
30 Veracruz de Ignacio de la Llave,141,141 San Andrés Tuxtla,Total,3887,3758,129,2903
30 Veracruz de Ignacio de la Llave,141,141 San Andrés Tuxtla,Total,3149,3051,98,2792
30 Veracruz de Ignacio de la Llave,141,141 San Andrés Tuxtla,Total,2126,2072,54,2410
30 Veracruz de Ignacio de la Llave,141,141 San Andrés Tuxtla,Total,1510,1456,54,1947
30 Veracruz de Ignacio de la Llave,141,141 San Andrés Tuxtla,Total,1046,1014,32,1904
30 Veracruz de Ignacio de la Llave,141,141 San Andrés Tuxtla,Total,521,508,13,1205
30 Veracruz de Ignacio de la Llave,141,141 San Andrés Tuxtla,Total,236,229,7,920
30 Veracruz de Ignacio de la Llave,141,141 San Andrés Tuxtla,Total,136,130,6,889
30 Veracruz de Ignacio de la Llave,141,141 San Andrés Tuxtla,Hombres,42119,40317,1802,13566
30 Veracruz de Ignacio de la Llave,141,141 San Andrés Tuxtla,Hombres,519,482,37,4628
30 Veracruz de Ignacio de la Llave,141,141 San Andrés Tuxtla,Hombres,3837,3549,288,4182
30 Veracruz de Ignacio de la Llave,141,141 San Andrés Tuxtla,Hombres,5036,4783,253,926
30 Veracruz de Ignacio de la Llave,141,141 San Andrés Tuxtla,Hombres,4749,4543,206,265
30 Veracruz de Ignacio de la Llave,141,141 San Andrés Tuxtla,Hombres,4595,4419,176,181
30 Veracruz de Ignacio de la Llave,141,141 San Andrés Tuxtla,Hombres,4778,4632,146,185
30 Veracruz de Ignacio de la Llave,141,141 San Andrés Tuxtla,Hombres,4363,4199,164,189
30 Veracruz de Ignacio de la Llave,141,141 San Andrés Tuxtla,Hombres,3864,3713,151,180
30 Veracruz de Ignacio de la Llave,141,141 San Andrés Tuxtla,Hombres,3046,2924,122,229
30 Veracruz de Ignacio de la Llave,141,141 San Andrés Tuxtla,Hombres,2502,2406,96,284
30 Veracruz de Ignacio de la Llave,141,141 San Andrés Tuxtla,Hombres,1791,1739,52,366
30 Veracruz de Ignacio de la Llave,141,141 San Andrés Tuxtla,Hombres,1309,1256,53,403
30 Veracruz de Ignacio de la Llave,141,141 San Andrés Tuxtla,Hombres,930,898,32,484
30 Veracruz de Ignacio de la Llave,141,141 San Andrés Tuxtla,Hombres,469,456,13,366
30 Veracruz de Ignacio de la Llave,141,141 San Andrés Tuxtla,Hombres,211,204,7,345
30 Veracruz de Ignacio de la Llave,141,141 San Andrés Tuxtla,Hombres,120,114,6,353
30 Veracruz de Ignacio de la Llave,141,141 San Andrés Tuxtla,Mujeres,12694,12438,256,50276
30 Veracruz de Ignacio de la Llave,141,141 San Andrés Tuxtla,Mujeres,90,84,6,4810
30 Veracruz de Ignacio de la Llave,141,141 San Andrés Tuxtla,Mujeres,828,788,40,7585
30 Veracruz de Ignacio de la Llave,141,141 San Andrés Tuxtla,Mujeres,1624,1553,71,5481
30 Veracruz de Ignacio de la Llave,141,141 San Andrés Tuxtla,Mujeres,1691,1639,52,4762
30 Veracruz de Ignacio de la Llave,141,141 San Andrés Tuxtla,Mujeres,1722,1691,31,4477
30 Veracruz de Ignacio de la Llave,141,141 San Andrés Tuxtla,Mujeres,1717,1693,24,4140
30 Veracruz de Ignacio de la Llave,141,141 San Andrés Tuxtla,Mujeres,1548,1539,9,3632
30 Veracruz de Ignacio de la Llave,141,141 San Andrés Tuxtla,Mujeres,1241,1230,11,3249
30 Veracruz de Ignacio de la Llave,141,141 San Andrés Tuxtla,Mujeres,841,834,7,2674
30 Veracruz de Ignacio de la Llave,141,141 San Andrés Tuxtla,Mujeres,647,645,2,2508
30 Veracruz de Ignacio de la Llave,141,141 San Andrés Tuxtla,Mujeres,335,333,2,2044
30 Veracruz de Ignacio de la Llave,141,141 San Andrés Tuxtla,Mujeres,201,200,1,1544
30 Veracruz de Ignacio de la Llave,141,141 San Andrés Tuxtla,Mujeres,116,116,0,1420
30 Veracruz de Ignacio de la Llave,141,141 San Andrés Tuxtla,Mujeres,52,52,0,839
30 Veracruz de Ignacio de la Llave,141,141 San Andrés Tuxtla,Mujeres,25,25,0,575
30 Veracruz de Ignacio de la Llave,141,141 San Andrés Tuxtla,Mujeres,16,16,0,536
30 Veracruz de Ignacio de la Llave,142,142 San Juan Evangelista,Total,11061,10796,265,14586
30 Veracruz de Ignacio de la Llave,142,142 San Juan Evangelista,Total,110,103,7,2110
30 Veracruz de Ignacio de la Llave,142,142 San Juan Evangelista,Total,945,921,24,2812
30 Veracruz de Ignacio de la Llave,142,142 San Juan Evangelista,Total,1374,1332,42,1350
30 Veracruz de Ignacio de la Llave,142,142 San Juan Evangelista,Total,1183,1149,34,1011
30 Veracruz de Ignacio de la Llave,142,142 San Juan Evangelista,Total,1210,1180,30,1084
30 Veracruz de Ignacio de la Llave,142,142 San Juan Evangelista,Total,1173,1145,28,1073
30 Veracruz de Ignacio de la Llave,142,142 San Juan Evangelista,Total,1130,1102,28,958
30 Veracruz de Ignacio de la Llave,142,142 San Juan Evangelista,Total,987,960,27,806
30 Veracruz de Ignacio de la Llave,142,142 San Juan Evangelista,Total,827,809,18,712
30 Veracruz de Ignacio de la Llave,142,142 San Juan Evangelista,Total,624,610,14,570
30 Veracruz de Ignacio de la Llave,142,142 San Juan Evangelista,Total,453,449,4,495
30 Veracruz de Ignacio de la Llave,142,142 San Juan Evangelista,Total,359,354,5,431
30 Veracruz de Ignacio de la Llave,142,142 San Juan Evangelista,Total,330,327,3,463
30 Veracruz de Ignacio de la Llave,142,142 San Juan Evangelista,Total,199,198,1,293
30 Veracruz de Ignacio de la Llave,142,142 San Juan Evangelista,Total,98,98,0,203
30 Veracruz de Ignacio de la Llave,142,142 San Juan Evangelista,Total,59,59,0,215
30 Veracruz de Ignacio de la Llave,142,142 San Juan Evangelista,Hombres,9609,9358,251,2856
30 Veracruz de Ignacio de la Llave,142,142 San Juan Evangelista,Hombres,102,95,7,1031
30 Veracruz de Ignacio de la Llave,142,142 San Juan Evangelista,Hombres,830,806,24,1073
30 Veracruz de Ignacio de la Llave,142,142 San Juan Evangelista,Hombres,1137,1099,38,148
30 Veracruz de Ignacio de la Llave,142,142 San Juan Evangelista,Hombres,991,960,31,29
30 Veracruz de Ignacio de la Llave,142,142 San Juan Evangelista,Hombres,1030,1003,27,28
30 Veracruz de Ignacio de la Llave,142,142 San Juan Evangelista,Hombres,974,947,27,24
30 Veracruz de Ignacio de la Llave,142,142 San Juan Evangelista,Hombres,956,930,26,28
30 Veracruz de Ignacio de la Llave,142,142 San Juan Evangelista,Hombres,870,843,27,26
30 Veracruz de Ignacio de la Llave,142,142 San Juan Evangelista,Hombres,737,719,18,37
30 Veracruz de Ignacio de la Llave,142,142 San Juan Evangelista,Hombres,568,554,14,37
30 Veracruz de Ignacio de la Llave,142,142 San Juan Evangelista,Hombres,426,422,4,41
30 Veracruz de Ignacio de la Llave,142,142 San Juan Evangelista,Hombres,339,334,5,54
30 Veracruz de Ignacio de la Llave,142,142 San Juan Evangelista,Hombres,309,306,3,76
30 Veracruz de Ignacio de la Llave,142,142 San Juan Evangelista,Hombres,190,190,0,80
30 Veracruz de Ignacio de la Llave,142,142 San Juan Evangelista,Hombres,94,94,0,65
30 Veracruz de Ignacio de la Llave,142,142 San Juan Evangelista,Hombres,56,56,0,79
30 Veracruz de Ignacio de la Llave,142,142 San Juan Evangelista,Mujeres,1452,1438,14,11730
30 Veracruz de Ignacio de la Llave,142,142 San Juan Evangelista,Mujeres,8,8,0,1079
30 Veracruz de Ignacio de la Llave,142,142 San Juan Evangelista,Mujeres,115,115,0,1739
30 Veracruz de Ignacio de la Llave,142,142 San Juan Evangelista,Mujeres,237,233,4,1202
30 Veracruz de Ignacio de la Llave,142,142 San Juan Evangelista,Mujeres,192,189,3,982
30 Veracruz de Ignacio de la Llave,142,142 San Juan Evangelista,Mujeres,180,177,3,1056
30 Veracruz de Ignacio de la Llave,142,142 San Juan Evangelista,Mujeres,199,198,1,1049
30 Veracruz de Ignacio de la Llave,142,142 San Juan Evangelista,Mujeres,174,172,2,930
30 Veracruz de Ignacio de la Llave,142,142 San Juan Evangelista,Mujeres,117,117,0,780
30 Veracruz de Ignacio de la Llave,142,142 San Juan Evangelista,Mujeres,90,90,0,675
30 Veracruz de Ignacio de la Llave,142,142 San Juan Evangelista,Mujeres,56,56,0,533
30 Veracruz de Ignacio de la Llave,142,142 San Juan Evangelista,Mujeres,27,27,0,454
30 Veracruz de Ignacio de la Llave,142,142 San Juan Evangelista,Mujeres,20,20,0,377
30 Veracruz de Ignacio de la Llave,142,142 San Juan Evangelista,Mujeres,21,21,0,387
30 Veracruz de Ignacio de la Llave,142,142 San Juan Evangelista,Mujeres,9,8,1,213
30 Veracruz de Ignacio de la Llave,142,142 San Juan Evangelista,Mujeres,4,4,0,138
30 Veracruz de Ignacio de la Llave,142,142 San Juan Evangelista,Mujeres,3,3,0,136
30 Veracruz de Ignacio de la Llave,211,211 San Rafael,Total,11354,11143,211,11436
30 Veracruz de Ignacio de la Llave,211,211 San Rafael,Total,92,88,4,1604
30 Veracruz de Ignacio de la Llave,211,211 San Rafael,Total,741,715,26,1972
30 Veracruz de Ignacio de la Llave,211,211 San Rafael,Total,1213,1184,29,873
30 Veracruz de Ignacio de la Llave,211,211 San Rafael,Total,1122,1098,24,674
30 Veracruz de Ignacio de la Llave,211,211 San Rafael,Total,1205,1187,18,763
30 Veracruz de Ignacio de la Llave,211,211 San Rafael,Total,1398,1374,24,845
30 Veracruz de Ignacio de la Llave,211,211 San Rafael,Total,1301,1281,20,747
30 Veracruz de Ignacio de la Llave,211,211 San Rafael,Total,1124,1108,16,675
30 Veracruz de Ignacio de la Llave,211,211 San Rafael,Total,937,922,15,630
30 Veracruz de Ignacio de la Llave,211,211 San Rafael,Total,737,724,13,525
30 Veracruz de Ignacio de la Llave,211,211 San Rafael,Total,510,503,7,542
30 Veracruz de Ignacio de la Llave,211,211 San Rafael,Total,422,413,9,477
30 Veracruz de Ignacio de la Llave,211,211 San Rafael,Total,287,283,4,401
30 Veracruz de Ignacio de la Llave,211,211 San Rafael,Total,145,143,2,274
30 Veracruz de Ignacio de la Llave,211,211 San Rafael,Total,70,70,0,200
30 Veracruz de Ignacio de la Llave,211,211 San Rafael,Total,50,50,0,234
30 Veracruz de Ignacio de la Llave,211,211 San Rafael,Hombres,8625,8437,188,2281
30 Veracruz de Ignacio de la Llave,211,211 San Rafael,Hombres,70,66,4,768
30 Veracruz de Ignacio de la Llave,211,211 San Rafael,Hombres,586,567,19,771
30 Veracruz de Ignacio de la Llave,211,211 San Rafael,Hombres,851,829,22,120
30 Veracruz de Ignacio de la Llave,211,211 San Rafael,Hombres,795,774,21,31
30 Veracruz de Ignacio de la Llave,211,211 San Rafael,Hombres,885,868,17,22
30 Veracruz de Ignacio de la Llave,211,211 San Rafael,Hombres,1032,1010,22,22
30 Veracruz de Ignacio de la Llave,211,211 San Rafael,Hombres,946,926,20,25
30 Veracruz de Ignacio de la Llave,211,211 San Rafael,Hombres,829,815,14,17
30 Veracruz de Ignacio de la Llave,211,211 San Rafael,Hombres,733,719,14,37
30 Veracruz de Ignacio de la Llave,211,211 San Rafael,Hombres,587,574,13,42
30 Veracruz de Ignacio de la Llave,211,211 San Rafael,Hombres,431,424,7,58
30 Veracruz de Ignacio de la Llave,211,211 San Rafael,Hombres,382,373,9,54
30 Veracruz de Ignacio de la Llave,211,211 San Rafael,Hombres,251,247,4,69
30 Veracruz de Ignacio de la Llave,211,211 San Rafael,Hombres,132,130,2,80
30 Veracruz de Ignacio de la Llave,211,211 San Rafael,Hombres,66,66,0,63
30 Veracruz de Ignacio de la Llave,211,211 San Rafael,Hombres,49,49,0,102
30 Veracruz de Ignacio de la Llave,211,211 San Rafael,Mujeres,2729,2706,23,9155
30 Veracruz de Ignacio de la Llave,211,211 San Rafael,Mujeres,22,22,0,836
30 Veracruz de Ignacio de la Llave,211,211 San Rafael,Mujeres,155,148,7,1201
30 Veracruz de Ignacio de la Llave,211,211 San Rafael,Mujeres,362,355,7,753
30 Veracruz de Ignacio de la Llave,211,211 San Rafael,Mujeres,327,324,3,643
30 Veracruz de Ignacio de la Llave,211,211 San Rafael,Mujeres,320,319,1,741
30 Veracruz de Ignacio de la Llave,211,211 San Rafael,Mujeres,366,364,2,823
30 Veracruz de Ignacio de la Llave,211,211 San Rafael,Mujeres,355,355,0,722
30 Veracruz de Ignacio de la Llave,211,211 San Rafael,Mujeres,295,293,2,658
30 Veracruz de Ignacio de la Llave,211,211 San Rafael,Mujeres,204,203,1,593
30 Veracruz de Ignacio de la Llave,211,211 San Rafael,Mujeres,150,150,0,483
30 Veracruz de Ignacio de la Llave,211,211 San Rafael,Mujeres,79,79,0,484
30 Veracruz de Ignacio de la Llave,211,211 San Rafael,Mujeres,40,40,0,423
30 Veracruz de Ignacio de la Llave,211,211 San Rafael,Mujeres,36,36,0,332
30 Veracruz de Ignacio de la Llave,211,211 San Rafael,Mujeres,13,13,0,194
30 Veracruz de Ignacio de la Llave,211,211 San Rafael,Mujeres,4,4,0,137
30 Veracruz de Ignacio de la Llave,211,211 San Rafael,Mujeres,1,1,0,132
30 Veracruz de Ignacio de la Llave,212,212 Santiago Sochiapan,Total,3496,3425,71,5695
30 Veracruz de Ignacio de la Llave,212,212 Santiago Sochiapan,Total,50,47,3,941
30 Veracruz de Ignacio de la Llave,212,212 Santiago Sochiapan,Total,350,339,11,1201
30 Veracruz de Ignacio de la Llave,212,212 Santiago Sochiapan,Total,414,398,16,490
30 Veracruz de Ignacio de la Llave,212,212 Santiago Sochiapan,Total,355,348,7,355
30 Veracruz de Ignacio de la Llave,212,212 Santiago Sochiapan,Total,336,334,2,405
30 Veracruz de Ignacio de la Llave,212,212 Santiago Sochiapan,Total,388,376,12,398
30 Veracruz de Ignacio de la Llave,212,212 Santiago Sochiapan,Total,331,325,6,368
30 Veracruz de Ignacio de la Llave,212,212 Santiago Sochiapan,Total,334,328,6,347
30 Veracruz de Ignacio de la Llave,212,212 Santiago Sochiapan,Total,245,243,2,255
30 Veracruz de Ignacio de la Llave,212,212 Santiago Sochiapan,Total,197,193,4,260
30 Veracruz de Ignacio de la Llave,212,212 Santiago Sochiapan,Total,169,167,2,160
30 Veracruz de Ignacio de la Llave,212,212 Santiago Sochiapan,Total,121,121,0,161
30 Veracruz de Ignacio de la Llave,212,212 Santiago Sochiapan,Total,120,120,0,152
30 Veracruz de Ignacio de la Llave,212,212 Santiago Sochiapan,Total,51,51,0,91
30 Veracruz de Ignacio de la Llave,212,212 Santiago Sochiapan,Total,24,24,0,51
30 Veracruz de Ignacio de la Llave,212,212 Santiago Sochiapan,Total,11,11,0,60
30 Veracruz de Ignacio de la Llave,212,212 Santiago Sochiapan,Hombres,3149,3082,67,1187
30 Veracruz de Ignacio de la Llave,212,212 Santiago Sochiapan,Hombres,48,45,3,456
30 Veracruz de Ignacio de la Llave,212,212 Santiago Sochiapan,Hombres,319,308,11,403
30 Veracruz de Ignacio de la Llave,212,212 Santiago Sochiapan,Hombres,338,324,14,48
30 Veracruz de Ignacio de la Llave,212,212 Santiago Sochiapan,Hombres,301,294,7,21
30 Veracruz de Ignacio de la Llave,212,212 Santiago Sochiapan,Hombres,298,296,2,18
30 Veracruz de Ignacio de la Llave,212,212 Santiago Sochiapan,Hombres,341,331,10,27
30 Veracruz de Ignacio de la Llave,212,212 Santiago Sochiapan,Hombres,298,292,6,27
30 Veracruz de Ignacio de la Llave,212,212 Santiago Sochiapan,Hombres,310,304,6,21
30 Veracruz de Ignacio de la Llave,212,212 Santiago Sochiapan,Hombres,233,231,2,14
30 Veracruz de Ignacio de la Llave,212,212 Santiago Sochiapan,Hombres,188,184,4,21
30 Veracruz de Ignacio de la Llave,212,212 Santiago Sochiapan,Hombres,160,158,2,16
30 Veracruz de Ignacio de la Llave,212,212 Santiago Sochiapan,Hombres,114,114,0,18
30 Veracruz de Ignacio de la Llave,212,212 Santiago Sochiapan,Hombres,116,116,0,40
30 Veracruz de Ignacio de la Llave,212,212 Santiago Sochiapan,Hombres,50,50,0,17
30 Veracruz de Ignacio de la Llave,212,212 Santiago Sochiapan,Hombres,24,24,0,13
30 Veracruz de Ignacio de la Llave,212,212 Santiago Sochiapan,Hombres,11,11,0,27
30 Veracruz de Ignacio de la Llave,212,212 Santiago Sochiapan,Mujeres,347,343,4,4508
30 Veracruz de Ignacio de la Llave,212,212 Santiago Sochiapan,Mujeres,2,2,0,485
30 Veracruz de Ignacio de la Llave,212,212 Santiago Sochiapan,Mujeres,31,31,0,798
30 Veracruz de Ignacio de la Llave,212,212 Santiago Sochiapan,Mujeres,76,74,2,442
30 Veracruz de Ignacio de la Llave,212,212 Santiago Sochiapan,Mujeres,54,54,0,334
30 Veracruz de Ignacio de la Llave,212,212 Santiago Sochiapan,Mujeres,38,38,0,387
30 Veracruz de Ignacio de la Llave,212,212 Santiago Sochiapan,Mujeres,47,45,2,371
30 Veracruz de Ignacio de la Llave,212,212 Santiago Sochiapan,Mujeres,33,33,0,341
30 Veracruz de Ignacio de la Llave,212,212 Santiago Sochiapan,Mujeres,24,24,0,326
30 Veracruz de Ignacio de la Llave,212,212 Santiago Sochiapan,Mujeres,12,12,0,241
30 Veracruz de Ignacio de la Llave,212,212 Santiago Sochiapan,Mujeres,9,9,0,239
30 Veracruz de Ignacio de la Llave,212,212 Santiago Sochiapan,Mujeres,9,9,0,144
30 Veracruz de Ignacio de la Llave,212,212 Santiago Sochiapan,Mujeres,7,7,0,143
30 Veracruz de Ignacio de la Llave,212,212 Santiago Sochiapan,Mujeres,4,4,0,112
30 Veracruz de Ignacio de la Llave,212,212 Santiago Sochiapan,Mujeres,1,1,0,74
30 Veracruz de Ignacio de la Llave,212,212 Santiago Sochiapan,Mujeres,0,0,0,38
30 Veracruz de Ignacio de la Llave,212,212 Santiago Sochiapan,Mujeres,0,0,0,33
30 Veracruz de Ignacio de la Llave,143,143 Santiago Tuxtla,Total,18881,17967,914,24967
30 Veracruz de Ignacio de la Llave,143,143 Santiago Tuxtla,Total,164,147,17,3375
30 Veracruz de Ignacio de la Llave,143,143 Santiago Tuxtla,Total,1337,1218,119,4411
30 Veracruz de Ignacio de la Llave,143,143 Santiago Tuxtla,Total,1982,1834,148,2249
30 Veracruz de Ignacio de la Llave,143,143 Santiago Tuxtla,Total,2096,1952,144,1821
30 Veracruz de Ignacio de la Llave,143,143 Santiago Tuxtla,Total,2193,2100,93,1808
30 Veracruz de Ignacio de la Llave,143,143 Santiago Tuxtla,Total,2147,2076,71,1825
30 Veracruz de Ignacio de la Llave,143,143 Santiago Tuxtla,Total,2085,2002,83,1639
30 Veracruz de Ignacio de la Llave,143,143 Santiago Tuxtla,Total,1782,1711,71,1448
30 Veracruz de Ignacio de la Llave,143,143 Santiago Tuxtla,Total,1492,1444,48,1216
30 Veracruz de Ignacio de la Llave,143,143 Santiago Tuxtla,Total,1243,1196,47,1183
30 Veracruz de Ignacio de la Llave,143,143 Santiago Tuxtla,Total,887,854,33,963
30 Veracruz de Ignacio de la Llave,143,143 Santiago Tuxtla,Total,648,629,19,845
30 Veracruz de Ignacio de la Llave,143,143 Santiago Tuxtla,Total,477,464,13,886
30 Veracruz de Ignacio de la Llave,143,143 Santiago Tuxtla,Total,184,179,5,492
30 Veracruz de Ignacio de la Llave,143,143 Santiago Tuxtla,Total,105,104,1,384
30 Veracruz de Ignacio de la Llave,143,143 Santiago Tuxtla,Total,59,57,2,422
30 Veracruz de Ignacio de la Llave,143,143 Santiago Tuxtla,Hombres,15680,14864,816,5146
30 Veracruz de Ignacio de la Llave,143,143 Santiago Tuxtla,Hombres,146,130,16,1626
30 Veracruz de Ignacio de la Llave,143,143 Santiago Tuxtla,Hombres,1122,1017,105,1750
30 Veracruz de Ignacio de la Llave,143,143 Santiago Tuxtla,Hombres,1593,1477,116,295
30 Veracruz de Ignacio de la Llave,143,143 Santiago Tuxtla,Hombres,1653,1532,121,80
30 Veracruz de Ignacio de la Llave,143,143 Santiago Tuxtla,Hombres,1766,1683,83,69
30 Veracruz de Ignacio de la Llave,143,143 Santiago Tuxtla,Hombres,1744,1676,68,61
30 Veracruz de Ignacio de la Llave,143,143 Santiago Tuxtla,Hombres,1703,1626,77,93
30 Veracruz de Ignacio de la Llave,143,143 Santiago Tuxtla,Hombres,1456,1392,64,82
30 Veracruz de Ignacio de la Llave,143,143 Santiago Tuxtla,Hombres,1265,1217,48,75
30 Veracruz de Ignacio de la Llave,143,143 Santiago Tuxtla,Hombres,1086,1041,45,86
30 Veracruz de Ignacio de la Llave,143,143 Santiago Tuxtla,Hombres,780,747,33,120
30 Veracruz de Ignacio de la Llave,143,143 Santiago Tuxtla,Hombres,599,580,19,155
30 Veracruz de Ignacio de la Llave,143,143 Santiago Tuxtla,Hombres,444,431,13,221
30 Veracruz de Ignacio de la Llave,143,143 Santiago Tuxtla,Hombres,171,166,5,155
30 Veracruz de Ignacio de la Llave,143,143 Santiago Tuxtla,Hombres,95,94,1,131
30 Veracruz de Ignacio de la Llave,143,143 Santiago Tuxtla,Hombres,57,55,2,147
30 Veracruz de Ignacio de la Llave,143,143 Santiago Tuxtla,Mujeres,3201,3103,98,19821
30 Veracruz de Ignacio de la Llave,143,143 Santiago Tuxtla,Mujeres,18,17,1,1749
30 Veracruz de Ignacio de la Llave,143,143 Santiago Tuxtla,Mujeres,215,201,14,2661
30 Veracruz de Ignacio de la Llave,143,143 Santiago Tuxtla,Mujeres,389,357,32,1954
30 Veracruz de Ignacio de la Llave,143,143 Santiago Tuxtla,Mujeres,443,420,23,1741
30 Veracruz de Ignacio de la Llave,143,143 Santiago Tuxtla,Mujeres,427,417,10,1739
30 Veracruz de Ignacio de la Llave,143,143 Santiago Tuxtla,Mujeres,403,400,3,1764
30 Veracruz de Ignacio de la Llave,143,143 Santiago Tuxtla,Mujeres,382,376,6,1546
30 Veracruz de Ignacio de la Llave,143,143 Santiago Tuxtla,Mujeres,326,319,7,1366
30 Veracruz de Ignacio de la Llave,143,143 Santiago Tuxtla,Mujeres,227,227,0,1141
30 Veracruz de Ignacio de la Llave,143,143 Santiago Tuxtla,Mujeres,157,155,2,1097
30 Veracruz de Ignacio de la Llave,143,143 Santiago Tuxtla,Mujeres,107,107,0,843
30 Veracruz de Ignacio de la Llave,143,143 Santiago Tuxtla,Mujeres,49,49,0,690
30 Veracruz de Ignacio de la Llave,143,143 Santiago Tuxtla,Mujeres,33,33,0,665
30 Veracruz de Ignacio de la Llave,143,143 Santiago Tuxtla,Mujeres,13,13,0,337
30 Veracruz de Ignacio de la Llave,143,143 Santiago Tuxtla,Mujeres,10,10,0,253
30 Veracruz de Ignacio de la Llave,143,143 Santiago Tuxtla,Mujeres,2,2,0,275
30 Veracruz de Ignacio de la Llave,144,144 Sayula de Alemán,Total,11136,10716,420,12781
30 Veracruz de Ignacio de la Llave,144,144 Sayula de Alemán,Total,97,93,4,1923
30 Veracruz de Ignacio de la Llave,144,144 Sayula de Alemán,Total,838,779,59,2702
30 Veracruz de Ignacio de la Llave,144,144 Sayula de Alemán,Total,1410,1316,94,1351
30 Veracruz de Ignacio de la Llave,144,144 Sayula de Alemán,Total,1328,1266,62,1029
30 Veracruz de Ignacio de la Llave,144,144 Sayula de Alemán,Total,1292,1256,36,913
30 Veracruz de Ignacio de la Llave,144,144 Sayula de Alemán,Total,1284,1248,36,889
30 Veracruz de Ignacio de la Llave,144,144 Sayula de Alemán,Total,1143,1107,36,708
30 Veracruz de Ignacio de la Llave,144,144 Sayula de Alemán,Total,1016,995,21,596
30 Veracruz de Ignacio de la Llave,144,144 Sayula de Alemán,Total,763,745,18,538
30 Veracruz de Ignacio de la Llave,144,144 Sayula de Alemán,Total,648,634,14,479
30 Veracruz de Ignacio de la Llave,144,144 Sayula de Alemán,Total,408,392,16,405
30 Veracruz de Ignacio de la Llave,144,144 Sayula de Alemán,Total,353,345,8,338
30 Veracruz de Ignacio de la Llave,144,144 Sayula de Alemán,Total,260,253,7,324
30 Veracruz de Ignacio de la Llave,144,144 Sayula de Alemán,Total,178,174,4,238
30 Veracruz de Ignacio de la Llave,144,144 Sayula de Alemán,Total,73,71,2,167
30 Veracruz de Ignacio de la Llave,144,144 Sayula de Alemán,Total,45,42,3,181
30 Veracruz de Ignacio de la Llave,144,144 Sayula de Alemán,Hombres,8591,8215,376,2955
30 Veracruz de Ignacio de la Llave,144,144 Sayula de Alemán,Hombres,80,76,4,955
30 Veracruz de Ignacio de la Llave,144,144 Sayula de Alemán,Hombres,706,659,47,1105
30 Veracruz de Ignacio de la Llave,144,144 Sayula de Alemán,Hombres,1074,995,79,241
30 Veracruz de Ignacio de la Llave,144,144 Sayula de Alemán,Hombres,985,936,49,62
30 Veracruz de Ignacio de la Llave,144,144 Sayula de Alemán,Hombres,964,928,36,44
30 Veracruz de Ignacio de la Llave,144,144 Sayula de Alemán,Hombres,930,897,33,27
30 Veracruz de Ignacio de la Llave,144,144 Sayula de Alemán,Hombres,847,811,36,24
30 Veracruz de Ignacio de la Llave,144,144 Sayula de Alemán,Hombres,771,751,20,35
30 Veracruz de Ignacio de la Llave,144,144 Sayula de Alemán,Hombres,577,559,18,40
30 Veracruz de Ignacio de la Llave,144,144 Sayula de Alemán,Hombres,504,490,14,40
30 Veracruz de Ignacio de la Llave,144,144 Sayula de Alemán,Hombres,345,329,16,50
30 Veracruz de Ignacio de la Llave,144,144 Sayula de Alemán,Hombres,307,299,8,56
30 Veracruz de Ignacio de la Llave,144,144 Sayula de Alemán,Hombres,229,222,7,62
30 Veracruz de Ignacio de la Llave,144,144 Sayula de Alemán,Hombres,165,161,4,80
30 Veracruz de Ignacio de la Llave,144,144 Sayula de Alemán,Hombres,66,64,2,60
30 Veracruz de Ignacio de la Llave,144,144 Sayula de Alemán,Hombres,41,38,3,74
30 Veracruz de Ignacio de la Llave,144,144 Sayula de Alemán,Mujeres,2545,2501,44,9826
30 Veracruz de Ignacio de la Llave,144,144 Sayula de Alemán,Mujeres,17,17,0,968
30 Veracruz de Ignacio de la Llave,144,144 Sayula de Alemán,Mujeres,132,120,12,1597
30 Veracruz de Ignacio de la Llave,144,144 Sayula de Alemán,Mujeres,336,321,15,1110
30 Veracruz de Ignacio de la Llave,144,144 Sayula de Alemán,Mujeres,343,330,13,967
30 Veracruz de Ignacio de la Llave,144,144 Sayula de Alemán,Mujeres,328,328,0,869
30 Veracruz de Ignacio de la Llave,144,144 Sayula de Alemán,Mujeres,354,351,3,862
30 Veracruz de Ignacio de la Llave,144,144 Sayula de Alemán,Mujeres,296,296,0,684
30 Veracruz de Ignacio de la Llave,144,144 Sayula de Alemán,Mujeres,245,244,1,561
30 Veracruz de Ignacio de la Llave,144,144 Sayula de Alemán,Mujeres,186,186,0,498
30 Veracruz de Ignacio de la Llave,144,144 Sayula de Alemán,Mujeres,144,144,0,439
30 Veracruz de Ignacio de la Llave,144,144 Sayula de Alemán,Mujeres,63,63,0,355
30 Veracruz de Ignacio de la Llave,144,144 Sayula de Alemán,Mujeres,46,46,0,282
30 Veracruz de Ignacio de la Llave,144,144 Sayula de Alemán,Mujeres,31,31,0,262
30 Veracruz de Ignacio de la Llave,144,144 Sayula de Alemán,Mujeres,13,13,0,158
30 Veracruz de Ignacio de la Llave,144,144 Sayula de Alemán,Mujeres,7,7,0,107
30 Veracruz de Ignacio de la Llave,144,144 Sayula de Alemán,Mujeres,4,4,0,107
30 Veracruz de Ignacio de la Llave,146,146 Sochiapa,Total,1147,1095,52,1374
30 Veracruz de Ignacio de la Llave,146,146 Sochiapa,Total,19,17,2,234
30 Veracruz de Ignacio de la Llave,146,146 Sochiapa,Total,148,134,14,227
30 Veracruz de Ignacio de la Llave,146,146 Sochiapa,Total,200,192,8,156
30 Veracruz de Ignacio de la Llave,146,146 Sochiapa,Total,159,155,4,129
30 Veracruz de Ignacio de la Llave,146,146 Sochiapa,Total,131,126,5,119
30 Veracruz de Ignacio de la Llave,146,146 Sochiapa,Total,112,108,4,88
30 Veracruz de Ignacio de la Llave,146,146 Sochiapa,Total,97,95,2,77
30 Veracruz de Ignacio de la Llave,146,146 Sochiapa,Total,79,72,7,64
30 Veracruz de Ignacio de la Llave,146,146 Sochiapa,Total,57,57,0,52
30 Veracruz de Ignacio de la Llave,146,146 Sochiapa,Total,47,44,3,48
30 Veracruz de Ignacio de la Llave,146,146 Sochiapa,Total,41,40,1,38
30 Veracruz de Ignacio de la Llave,146,146 Sochiapa,Total,18,17,1,26
30 Veracruz de Ignacio de la Llave,146,146 Sochiapa,Total,15,15,0,34
30 Veracruz de Ignacio de la Llave,146,146 Sochiapa,Total,14,13,1,39
30 Veracruz de Ignacio de la Llave,146,146 Sochiapa,Total,8,8,0,15
30 Veracruz de Ignacio de la Llave,146,146 Sochiapa,Total,2,2,0,28
30 Veracruz de Ignacio de la Llave,146,146 Sochiapa,Hombres,994,945,49,252
30 Veracruz de Ignacio de la Llave,146,146 Sochiapa,Hombres,18,16,2,106
30 Veracruz de Ignacio de la Llave,146,146 Sochiapa,Hombres,130,117,13,74
30 Veracruz de Ignacio de la Llave,146,146 Sochiapa,Hombres,164,158,6,21
30 Veracruz de Ignacio de la Llave,146,146 Sochiapa,Hombres,136,132,4,6
30 Veracruz de Ignacio de la Llave,146,146 Sochiapa,Hombres,118,113,5,2
30 Veracruz de Ignacio de la Llave,146,146 Sochiapa,Hombres,95,91,4,2
30 Veracruz de Ignacio de la Llave,146,146 Sochiapa,Hombres,86,84,2,3
30 Veracruz de Ignacio de la Llave,146,146 Sochiapa,Hombres,69,62,7,3
30 Veracruz de Ignacio de la Llave,146,146 Sochiapa,Hombres,48,48,0,2
30 Veracruz de Ignacio de la Llave,146,146 Sochiapa,Hombres,42,39,3,4
30 Veracruz de Ignacio de la Llave,146,146 Sochiapa,Hombres,37,36,1,1
30 Veracruz de Ignacio de la Llave,146,146 Sochiapa,Hombres,16,15,1,3
30 Veracruz de Ignacio de la Llave,146,146 Sochiapa,Hombres,12,12,0,4
30 Veracruz de Ignacio de la Llave,146,146 Sochiapa,Hombres,13,12,1,9
30 Veracruz de Ignacio de la Llave,146,146 Sochiapa,Hombres,8,8,0,6
30 Veracruz de Ignacio de la Llave,146,146 Sochiapa,Hombres,2,2,0,6
30 Veracruz de Ignacio de la Llave,146,146 Sochiapa,Mujeres,153,150,3,1122
30 Veracruz de Ignacio de la Llave,146,146 Sochiapa,Mujeres,1,1,0,128
30 Veracruz de Ignacio de la Llave,146,146 Sochiapa,Mujeres,18,17,1,153
30 Veracruz de Ignacio de la Llave,146,146 Sochiapa,Mujeres,36,34,2,135
30 Veracruz de Ignacio de la Llave,146,146 Sochiapa,Mujeres,23,23,0,123
30 Veracruz de Ignacio de la Llave,146,146 Sochiapa,Mujeres,13,13,0,117
30 Veracruz de Ignacio de la Llave,146,146 Sochiapa,Mujeres,17,17,0,86
30 Veracruz de Ignacio de la Llave,146,146 Sochiapa,Mujeres,11,11,0,74
30 Veracruz de Ignacio de la Llave,146,146 Sochiapa,Mujeres,10,10,0,61
30 Veracruz de Ignacio de la Llave,146,146 Sochiapa,Mujeres,9,9,0,50
30 Veracruz de Ignacio de la Llave,146,146 Sochiapa,Mujeres,5,5,0,44
30 Veracruz de Ignacio de la Llave,146,146 Sochiapa,Mujeres,4,4,0,37
30 Veracruz de Ignacio de la Llave,146,146 Sochiapa,Mujeres,2,2,0,23
30 Veracruz de Ignacio de la Llave,146,146 Sochiapa,Mujeres,3,3,0,30
30 Veracruz de Ignacio de la Llave,146,146 Sochiapa,Mujeres,1,1,0,30
30 Veracruz de Ignacio de la Llave,146,146 Sochiapa,Mujeres,0,0,0,9
30 Veracruz de Ignacio de la Llave,146,146 Sochiapa,Mujeres,0,0,0,22
30 Veracruz de Ignacio de la Llave,145,145 Soconusco,Total,5806,5607,199,5311
30 Veracruz de Ignacio de la Llave,145,145 Soconusco,Total,61,56,5,865
30 Veracruz de Ignacio de la Llave,145,145 Soconusco,Total,403,370,33,1125
30 Veracruz de Ignacio de la Llave,145,145 Soconusco,Total,734,696,38,552
30 Veracruz de Ignacio de la Llave,145,145 Soconusco,Total,729,709,20,435
30 Veracruz de Ignacio de la Llave,145,145 Soconusco,Total,771,756,15,377
30 Veracruz de Ignacio de la Llave,145,145 Soconusco,Total,720,705,15,336
30 Veracruz de Ignacio de la Llave,145,145 Soconusco,Total,642,633,9,312
30 Veracruz de Ignacio de la Llave,145,145 Soconusco,Total,593,569,24,256
30 Veracruz de Ignacio de la Llave,145,145 Soconusco,Total,424,412,12,233
30 Veracruz de Ignacio de la Llave,145,145 Soconusco,Total,290,276,14,193
30 Veracruz de Ignacio de la Llave,145,145 Soconusco,Total,171,166,5,163
30 Veracruz de Ignacio de la Llave,145,145 Soconusco,Total,117,114,3,118
30 Veracruz de Ignacio de la Llave,145,145 Soconusco,Total,90,85,5,137
30 Veracruz de Ignacio de la Llave,145,145 Soconusco,Total,42,41,1,90
30 Veracruz de Ignacio de la Llave,145,145 Soconusco,Total,15,15,0,57
30 Veracruz de Ignacio de la Llave,145,145 Soconusco,Total,4,4,0,62
30 Veracruz de Ignacio de la Llave,145,145 Soconusco,Hombres,4041,3887,154,1303
30 Veracruz de Ignacio de la Llave,145,145 Soconusco,Hombres,39,35,4,440
30 Veracruz de Ignacio de la Llave,145,145 Soconusco,Hombres,290,269,21,477
30 Veracruz de Ignacio de la Llave,145,145 Soconusco,Hombres,500,474,26,122
30 Veracruz de Ignacio de la Llave,145,145 Soconusco,Hombres,490,476,14,24
30 Veracruz de Ignacio de la Llave,145,145 Soconusco,Hombres,512,500,12,10
30 Veracruz de Ignacio de la Llave,145,145 Soconusco,Hombres,463,450,13,8
30 Veracruz de Ignacio de la Llave,145,145 Soconusco,Hombres,440,431,9,8
30 Veracruz de Ignacio de la Llave,145,145 Soconusco,Hombres,408,388,20,8
30 Veracruz de Ignacio de la Llave,145,145 Soconusco,Hombres,307,297,10,17
30 Veracruz de Ignacio de la Llave,145,145 Soconusco,Hombres,223,211,12,24
30 Veracruz de Ignacio de la Llave,145,145 Soconusco,Hombres,137,132,5,25
30 Veracruz de Ignacio de la Llave,145,145 Soconusco,Hombres,102,100,2,27
30 Veracruz de Ignacio de la Llave,145,145 Soconusco,Hombres,77,72,5,39
30 Veracruz de Ignacio de la Llave,145,145 Soconusco,Hombres,34,33,1,37
30 Veracruz de Ignacio de la Llave,145,145 Soconusco,Hombres,15,15,0,18
30 Veracruz de Ignacio de la Llave,145,145 Soconusco,Hombres,4,4,0,19
30 Veracruz de Ignacio de la Llave,145,145 Soconusco,Mujeres,1765,1720,45,4008
30 Veracruz de Ignacio de la Llave,145,145 Soconusco,Mujeres,22,21,1,425
30 Veracruz de Ignacio de la Llave,145,145 Soconusco,Mujeres,113,101,12,648
30 Veracruz de Ignacio de la Llave,145,145 Soconusco,Mujeres,234,222,12,430
30 Veracruz de Ignacio de la Llave,145,145 Soconusco,Mujeres,239,233,6,411
30 Veracruz de Ignacio de la Llave,145,145 Soconusco,Mujeres,259,256,3,367
30 Veracruz de Ignacio de la Llave,145,145 Soconusco,Mujeres,257,255,2,328
30 Veracruz de Ignacio de la Llave,145,145 Soconusco,Mujeres,202,202,0,304
30 Veracruz de Ignacio de la Llave,145,145 Soconusco,Mujeres,185,181,4,248
30 Veracruz de Ignacio de la Llave,145,145 Soconusco,Mujeres,117,115,2,216
30 Veracruz de Ignacio de la Llave,145,145 Soconusco,Mujeres,67,65,2,169
30 Veracruz de Ignacio de la Llave,145,145 Soconusco,Mujeres,34,34,0,138
30 Veracruz de Ignacio de la Llave,145,145 Soconusco,Mujeres,15,14,1,91
30 Veracruz de Ignacio de la Llave,145,145 Soconusco,Mujeres,13,13,0,98
30 Veracruz de Ignacio de la Llave,145,145 Soconusco,Mujeres,8,8,0,53
30 Veracruz de Ignacio de la Llave,145,145 Soconusco,Mujeres,0,0,0,39
30 Veracruz de Ignacio de la Llave,145,145 Soconusco,Mujeres,0,0,0,43
30 Veracruz de Ignacio de la Llave,147,147 Soledad Atzompa,Total,4823,4528,295,9706
30 Veracruz de Ignacio de la Llave,147,147 Soledad Atzompa,Total,88,66,22,1415
30 Veracruz de Ignacio de la Llave,147,147 Soledad Atzompa,Total,718,649,69,1640
30 Veracruz de Ignacio de la Llave,147,147 Soledad Atzompa,Total,855,818,37,1248
30 Veracruz de Ignacio de la Llave,147,147 Soledad Atzompa,Total,682,636,46,1027
30 Veracruz de Ignacio de la Llave,147,147 Soledad Atzompa,Total,566,532,34,934
30 Veracruz de Ignacio de la Llave,147,147 Soledad Atzompa,Total,468,450,18,746
30 Veracruz de Ignacio de la Llave,147,147 Soledad Atzompa,Total,378,358,20,597
30 Veracruz de Ignacio de la Llave,147,147 Soledad Atzompa,Total,323,304,19,480
30 Veracruz de Ignacio de la Llave,147,147 Soledad Atzompa,Total,236,225,11,377
30 Veracruz de Ignacio de la Llave,147,147 Soledad Atzompa,Total,167,163,4,306
30 Veracruz de Ignacio de la Llave,147,147 Soledad Atzompa,Total,132,128,4,274
30 Veracruz de Ignacio de la Llave,147,147 Soledad Atzompa,Total,105,101,4,223
30 Veracruz de Ignacio de la Llave,147,147 Soledad Atzompa,Total,64,61,3,200
30 Veracruz de Ignacio de la Llave,147,147 Soledad Atzompa,Total,22,20,2,97
30 Veracruz de Ignacio de la Llave,147,147 Soledad Atzompa,Total,11,10,1,61
30 Veracruz de Ignacio de la Llave,147,147 Soledad Atzompa,Total,8,7,1,81
30 Veracruz de Ignacio de la Llave,147,147 Soledad Atzompa,Hombres,4436,4149,287,2615
30 Veracruz de Ignacio de la Llave,147,147 Soledad Atzompa,Hombres,84,62,22,653
30 Veracruz de Ignacio de la Llave,147,147 Soledad Atzompa,Hombres,684,616,68,504
30 Veracruz de Ignacio de la Llave,147,147 Soledad Atzompa,Hombres,800,763,37,231
30 Veracruz de Ignacio de la Llave,147,147 Soledad Atzompa,Hombres,626,581,45,196
30 Veracruz de Ignacio de la Llave,147,147 Soledad Atzompa,Hombres,519,486,33,199
30 Veracruz de Ignacio de la Llave,147,147 Soledad Atzompa,Hombres,423,406,17,175
30 Veracruz de Ignacio de la Llave,147,147 Soledad Atzompa,Hombres,330,312,18,117
30 Veracruz de Ignacio de la Llave,147,147 Soledad Atzompa,Hombres,295,278,17,95
30 Veracruz de Ignacio de la Llave,147,147 Soledad Atzompa,Hombres,215,204,11,91
30 Veracruz de Ignacio de la Llave,147,147 Soledad Atzompa,Hombres,144,140,4,69
30 Veracruz de Ignacio de la Llave,147,147 Soledad Atzompa,Hombres,118,114,4,62
30 Veracruz de Ignacio de la Llave,147,147 Soledad Atzompa,Hombres,98,94,4,62
30 Veracruz de Ignacio de la Llave,147,147 Soledad Atzompa,Hombres,61,58,3,67
30 Veracruz de Ignacio de la Llave,147,147 Soledad Atzompa,Hombres,21,19,2,36
30 Veracruz de Ignacio de la Llave,147,147 Soledad Atzompa,Hombres,10,9,1,27
30 Veracruz de Ignacio de la Llave,147,147 Soledad Atzompa,Hombres,8,7,1,31
30 Veracruz de Ignacio de la Llave,147,147 Soledad Atzompa,Mujeres,387,379,8,7091
30 Veracruz de Ignacio de la Llave,147,147 Soledad Atzompa,Mujeres,4,4,0,762
30 Veracruz de Ignacio de la Llave,147,147 Soledad Atzompa,Mujeres,34,33,1,1136
30 Veracruz de Ignacio de la Llave,147,147 Soledad Atzompa,Mujeres,55,55,0,1017
30 Veracruz de Ignacio de la Llave,147,147 Soledad Atzompa,Mujeres,56,55,1,831
30 Veracruz de Ignacio de la Llave,147,147 Soledad Atzompa,Mujeres,47,46,1,735
30 Veracruz de Ignacio de la Llave,147,147 Soledad Atzompa,Mujeres,45,44,1,571
30 Veracruz de Ignacio de la Llave,147,147 Soledad Atzompa,Mujeres,48,46,2,480
30 Veracruz de Ignacio de la Llave,147,147 Soledad Atzompa,Mujeres,28,26,2,385
30 Veracruz de Ignacio de la Llave,147,147 Soledad Atzompa,Mujeres,21,21,0,286
30 Veracruz de Ignacio de la Llave,147,147 Soledad Atzompa,Mujeres,23,23,0,237
30 Veracruz de Ignacio de la Llave,147,147 Soledad Atzompa,Mujeres,14,14,0,212
30 Veracruz de Ignacio de la Llave,147,147 Soledad Atzompa,Mujeres,7,7,0,161
30 Veracruz de Ignacio de la Llave,147,147 Soledad Atzompa,Mujeres,3,3,0,133
30 Veracruz de Ignacio de la Llave,147,147 Soledad Atzompa,Mujeres,1,1,0,61
30 Veracruz de Ignacio de la Llave,147,147 Soledad Atzompa,Mujeres,1,1,0,34
30 Veracruz de Ignacio de la Llave,147,147 Soledad Atzompa,Mujeres,0,0,0,50
30 Veracruz de Ignacio de la Llave,148,148 Soledad de Doblado,Total,10321,10023,298,10834
30 Veracruz de Ignacio de la Llave,148,148 Soledad de Doblado,Total,135,128,7,1402
30 Veracruz de Ignacio de la Llave,148,148 Soledad de Doblado,Total,922,875,47,1760
30 Veracruz de Ignacio de la Llave,148,148 Soledad de Doblado,Total,1292,1226,66,998
30 Veracruz de Ignacio de la Llave,148,148 Soledad de Doblado,Total,1114,1087,27,742
30 Veracruz de Ignacio de la Llave,148,148 Soledad de Doblado,Total,1129,1099,30,776
30 Veracruz de Ignacio de la Llave,148,148 Soledad de Doblado,Total,1216,1194,22,729
30 Veracruz de Ignacio de la Llave,148,148 Soledad de Doblado,Total,1065,1044,21,724
30 Veracruz de Ignacio de la Llave,148,148 Soledad de Doblado,Total,899,887,12,616
30 Veracruz de Ignacio de la Llave,148,148 Soledad de Doblado,Total,754,736,18,563
30 Veracruz de Ignacio de la Llave,148,148 Soledad de Doblado,Total,553,544,9,478
30 Veracruz de Ignacio de la Llave,148,148 Soledad de Doblado,Total,422,412,10,440
30 Veracruz de Ignacio de la Llave,148,148 Soledad de Doblado,Total,321,311,10,438
30 Veracruz de Ignacio de la Llave,148,148 Soledad de Doblado,Total,257,243,14,442
30 Veracruz de Ignacio de la Llave,148,148 Soledad de Doblado,Total,145,142,3,299
30 Veracruz de Ignacio de la Llave,148,148 Soledad de Doblado,Total,59,59,0,222
30 Veracruz de Ignacio de la Llave,148,148 Soledad de Doblado,Total,38,36,2,205
30 Veracruz de Ignacio de la Llave,148,148 Soledad de Doblado,Hombres,8139,7882,257,2172
30 Veracruz de Ignacio de la Llave,148,148 Soledad de Doblado,Hombres,110,104,6,697
30 Veracruz de Ignacio de la Llave,148,148 Soledad de Doblado,Hombres,709,673,36,633
30 Veracruz de Ignacio de la Llave,148,148 Soledad de Doblado,Hombres,996,940,56,124
30 Veracruz de Ignacio de la Llave,148,148 Soledad de Doblado,Hombres,846,824,22,37
30 Veracruz de Ignacio de la Llave,148,148 Soledad de Doblado,Hombres,869,845,24,33
30 Veracruz de Ignacio de la Llave,148,148 Soledad de Doblado,Hombres,939,919,20,30
30 Veracruz de Ignacio de la Llave,148,148 Soledad de Doblado,Hombres,824,805,19,43
30 Veracruz de Ignacio de la Llave,148,148 Soledad de Doblado,Hombres,718,707,11,34
30 Veracruz de Ignacio de la Llave,148,148 Soledad de Doblado,Hombres,589,571,18,39
30 Veracruz de Ignacio de la Llave,148,148 Soledad de Doblado,Hombres,460,454,6,51
30 Veracruz de Ignacio de la Llave,148,148 Soledad de Doblado,Hombres,353,343,10,57
30 Veracruz de Ignacio de la Llave,148,148 Soledad de Doblado,Hombres,277,267,10,75
30 Veracruz de Ignacio de la Llave,148,148 Soledad de Doblado,Hombres,226,212,14,97
30 Veracruz de Ignacio de la Llave,148,148 Soledad de Doblado,Hombres,132,129,3,90
30 Veracruz de Ignacio de la Llave,148,148 Soledad de Doblado,Hombres,56,56,0,66
30 Veracruz de Ignacio de la Llave,148,148 Soledad de Doblado,Hombres,35,33,2,66
30 Veracruz de Ignacio de la Llave,148,148 Soledad de Doblado,Mujeres,2182,2141,41,8662
30 Veracruz de Ignacio de la Llave,148,148 Soledad de Doblado,Mujeres,25,24,1,705
30 Veracruz de Ignacio de la Llave,148,148 Soledad de Doblado,Mujeres,213,202,11,1127
30 Veracruz de Ignacio de la Llave,148,148 Soledad de Doblado,Mujeres,296,286,10,874
30 Veracruz de Ignacio de la Llave,148,148 Soledad de Doblado,Mujeres,268,263,5,705
30 Veracruz de Ignacio de la Llave,148,148 Soledad de Doblado,Mujeres,260,254,6,743
30 Veracruz de Ignacio de la Llave,148,148 Soledad de Doblado,Mujeres,277,275,2,699
30 Veracruz de Ignacio de la Llave,148,148 Soledad de Doblado,Mujeres,241,239,2,681
30 Veracruz de Ignacio de la Llave,148,148 Soledad de Doblado,Mujeres,181,180,1,582
30 Veracruz de Ignacio de la Llave,148,148 Soledad de Doblado,Mujeres,165,165,0,524
30 Veracruz de Ignacio de la Llave,148,148 Soledad de Doblado,Mujeres,93,90,3,427
30 Veracruz de Ignacio de la Llave,148,148 Soledad de Doblado,Mujeres,69,69,0,383
30 Veracruz de Ignacio de la Llave,148,148 Soledad de Doblado,Mujeres,44,44,0,363
30 Veracruz de Ignacio de la Llave,148,148 Soledad de Doblado,Mujeres,31,31,0,345
30 Veracruz de Ignacio de la Llave,148,148 Soledad de Doblado,Mujeres,13,13,0,209
30 Veracruz de Ignacio de la Llave,148,148 Soledad de Doblado,Mujeres,3,3,0,156
30 Veracruz de Ignacio de la Llave,148,148 Soledad de Doblado,Mujeres,3,3,0,139
30 Veracruz de Ignacio de la Llave,149,149 Soteapan,Total,9212,9060,152,13351
30 Veracruz de Ignacio de la Llave,149,149 Soteapan,Total,174,170,4,2402
30 Veracruz de Ignacio de la Llave,149,149 Soteapan,Total,1101,1071,30,2945
30 Veracruz de Ignacio de la Llave,149,149 Soteapan,Total,1483,1456,27,1581
30 Veracruz de Ignacio de la Llave,149,149 Soteapan,Total,1146,1113,33,1168
30 Veracruz de Ignacio de la Llave,149,149 Soteapan,Total,1098,1086,12,1056
30 Veracruz de Ignacio de la Llave,149,149 Soteapan,Total,1049,1036,13,936
30 Veracruz de Ignacio de la Llave,149,149 Soteapan,Total,768,760,8,666
30 Veracruz de Ignacio de la Llave,149,149 Soteapan,Total,665,659,6,637
30 Veracruz de Ignacio de la Llave,149,149 Soteapan,Total,516,511,5,488
30 Veracruz de Ignacio de la Llave,149,149 Soteapan,Total,464,456,8,431
30 Veracruz de Ignacio de la Llave,149,149 Soteapan,Total,305,302,3,277
30 Veracruz de Ignacio de la Llave,149,149 Soteapan,Total,179,179,0,223
30 Veracruz de Ignacio de la Llave,149,149 Soteapan,Total,150,148,2,219
30 Veracruz de Ignacio de la Llave,149,149 Soteapan,Total,80,79,1,155
30 Veracruz de Ignacio de la Llave,149,149 Soteapan,Total,24,24,0,82
30 Veracruz de Ignacio de la Llave,149,149 Soteapan,Total,10,10,0,85
30 Veracruz de Ignacio de la Llave,149,149 Soteapan,Hombres,7886,7743,143,2951
30 Veracruz de Ignacio de la Llave,149,149 Soteapan,Hombres,140,136,4,1153
30 Veracruz de Ignacio de la Llave,149,149 Soteapan,Hombres,949,925,24,1013
30 Veracruz de Ignacio de la Llave,149,149 Soteapan,Hombres,1268,1242,26,161
30 Veracruz de Ignacio de la Llave,149,149 Soteapan,Hombres,964,933,31,79
30 Veracruz de Ignacio de la Llave,149,149 Soteapan,Hombres,931,919,12,81
30 Veracruz de Ignacio de la Llave,149,149 Soteapan,Hombres,914,901,13,63
30 Veracruz de Ignacio de la Llave,149,149 Soteapan,Hombres,644,636,8,42
30 Veracruz de Ignacio de la Llave,149,149 Soteapan,Hombres,561,555,6,46
30 Veracruz de Ignacio de la Llave,149,149 Soteapan,Hombres,441,436,5,48
30 Veracruz de Ignacio de la Llave,149,149 Soteapan,Hombres,399,391,8,37
30 Veracruz de Ignacio de la Llave,149,149 Soteapan,Hombres,272,269,3,34
30 Veracruz de Ignacio de la Llave,149,149 Soteapan,Hombres,163,163,0,26
30 Veracruz de Ignacio de la Llave,149,149 Soteapan,Hombres,135,133,2,47
30 Veracruz de Ignacio de la Llave,149,149 Soteapan,Hombres,73,72,1,49
30 Veracruz de Ignacio de la Llave,149,149 Soteapan,Hombres,23,23,0,38
30 Veracruz de Ignacio de la Llave,149,149 Soteapan,Hombres,9,9,0,34
30 Veracruz de Ignacio de la Llave,149,149 Soteapan,Mujeres,1326,1317,9,10400
30 Veracruz de Ignacio de la Llave,149,149 Soteapan,Mujeres,34,34,0,1249
30 Veracruz de Ignacio de la Llave,149,149 Soteapan,Mujeres,152,146,6,1932
30 Veracruz de Ignacio de la Llave,149,149 Soteapan,Mujeres,215,214,1,1420
30 Veracruz de Ignacio de la Llave,149,149 Soteapan,Mujeres,182,180,2,1089
30 Veracruz de Ignacio de la Llave,149,149 Soteapan,Mujeres,167,167,0,975
30 Veracruz de Ignacio de la Llave,149,149 Soteapan,Mujeres,135,135,0,873
30 Veracruz de Ignacio de la Llave,149,149 Soteapan,Mujeres,124,124,0,624
30 Veracruz de Ignacio de la Llave,149,149 Soteapan,Mujeres,104,104,0,591
30 Veracruz de Ignacio de la Llave,149,149 Soteapan,Mujeres,75,75,0,440
30 Veracruz de Ignacio de la Llave,149,149 Soteapan,Mujeres,65,65,0,394
30 Veracruz de Ignacio de la Llave,149,149 Soteapan,Mujeres,33,33,0,243
30 Veracruz de Ignacio de la Llave,149,149 Soteapan,Mujeres,16,16,0,197
30 Veracruz de Ignacio de la Llave,149,149 Soteapan,Mujeres,15,15,0,172
30 Veracruz de Ignacio de la Llave,149,149 Soteapan,Mujeres,7,7,0,106
30 Veracruz de Ignacio de la Llave,149,149 Soteapan,Mujeres,1,1,0,44
30 Veracruz de Ignacio de la Llave,149,149 Soteapan,Mujeres,1,1,0,51
30 Veracruz de Ignacio de la Llave,150,150 Tamalín,Total,4115,4034,81,4641
30 Veracruz de Ignacio de la Llave,150,150 Tamalín,Total,42,40,2,726
30 Veracruz de Ignacio de la Llave,150,150 Tamalín,Total,310,281,29,885
30 Veracruz de Ignacio de la Llave,150,150 Tamalín,Total,482,469,13,373
30 Veracruz de Ignacio de la Llave,150,150 Tamalín,Total,405,399,6,267
30 Veracruz de Ignacio de la Llave,150,150 Tamalín,Total,437,429,8,312
30 Veracruz de Ignacio de la Llave,150,150 Tamalín,Total,420,416,4,316
30 Veracruz de Ignacio de la Llave,150,150 Tamalín,Total,442,439,3,290
30 Veracruz de Ignacio de la Llave,150,150 Tamalín,Total,417,412,5,272
30 Veracruz de Ignacio de la Llave,150,150 Tamalín,Total,302,301,1,235
30 Veracruz de Ignacio de la Llave,150,150 Tamalín,Total,264,263,1,191
30 Veracruz de Ignacio de la Llave,150,150 Tamalín,Total,211,208,3,171
30 Veracruz de Ignacio de la Llave,150,150 Tamalín,Total,152,149,3,165
30 Veracruz de Ignacio de la Llave,150,150 Tamalín,Total,124,123,1,145
30 Veracruz de Ignacio de la Llave,150,150 Tamalín,Total,73,72,1,117
30 Veracruz de Ignacio de la Llave,150,150 Tamalín,Total,22,21,1,91
30 Veracruz de Ignacio de la Llave,150,150 Tamalín,Total,12,12,0,85
30 Veracruz de Ignacio de la Llave,150,150 Tamalín,Hombres,3302,3232,70,1044
30 Veracruz de Ignacio de la Llave,150,150 Tamalín,Hombres,35,33,2,350
30 Veracruz de Ignacio de la Llave,150,150 Tamalín,Hombres,236,211,25,352
30 Veracruz de Ignacio de la Llave,150,150 Tamalín,Hombres,365,355,10,65
30 Veracruz de Ignacio de la Llave,150,150 Tamalín,Hombres,319,314,5,12
30 Veracruz de Ignacio de la Llave,150,150 Tamalín,Hombres,321,316,5,22
30 Veracruz de Ignacio de la Llave,150,150 Tamalín,Hombres,346,342,4,18
30 Veracruz de Ignacio de la Llave,150,150 Tamalín,Hombres,353,350,3,8
30 Veracruz de Ignacio de la Llave,150,150 Tamalín,Hombres,330,325,5,16
30 Veracruz de Ignacio de la Llave,150,150 Tamalín,Hombres,242,241,1,15
30 Veracruz de Ignacio de la Llave,150,150 Tamalín,Hombres,226,225,1,9
30 Veracruz de Ignacio de la Llave,150,150 Tamalín,Hombres,180,177,3,24
30 Veracruz de Ignacio de la Llave,150,150 Tamalín,Hombres,138,135,3,20
30 Veracruz de Ignacio de la Llave,150,150 Tamalín,Hombres,111,110,1,28
30 Veracruz de Ignacio de la Llave,150,150 Tamalín,Hombres,68,67,1,34
30 Veracruz de Ignacio de la Llave,150,150 Tamalín,Hombres,22,21,1,29
30 Veracruz de Ignacio de la Llave,150,150 Tamalín,Hombres,10,10,0,42
30 Veracruz de Ignacio de la Llave,150,150 Tamalín,Mujeres,813,802,11,3597
30 Veracruz de Ignacio de la Llave,150,150 Tamalín,Mujeres,7,7,0,376
30 Veracruz de Ignacio de la Llave,150,150 Tamalín,Mujeres,74,70,4,533
30 Veracruz de Ignacio de la Llave,150,150 Tamalín,Mujeres,117,114,3,308
30 Veracruz de Ignacio de la Llave,150,150 Tamalín,Mujeres,86,85,1,255
30 Veracruz de Ignacio de la Llave,150,150 Tamalín,Mujeres,116,113,3,290
30 Veracruz de Ignacio de la Llave,150,150 Tamalín,Mujeres,74,74,0,298
30 Veracruz de Ignacio de la Llave,150,150 Tamalín,Mujeres,89,89,0,282
30 Veracruz de Ignacio de la Llave,150,150 Tamalín,Mujeres,87,87,0,256
30 Veracruz de Ignacio de la Llave,150,150 Tamalín,Mujeres,60,60,0,220
30 Veracruz de Ignacio de la Llave,150,150 Tamalín,Mujeres,38,38,0,182
30 Veracruz de Ignacio de la Llave,150,150 Tamalín,Mujeres,31,31,0,147
30 Veracruz de Ignacio de la Llave,150,150 Tamalín,Mujeres,14,14,0,145
30 Veracruz de Ignacio de la Llave,150,150 Tamalín,Mujeres,13,13,0,117
30 Veracruz de Ignacio de la Llave,150,150 Tamalín,Mujeres,5,5,0,83
30 Veracruz de Ignacio de la Llave,150,150 Tamalín,Mujeres,0,0,0,62
30 Veracruz de Ignacio de la Llave,150,150 Tamalín,Mujeres,2,2,0,43
30 Veracruz de Ignacio de la Llave,151,151 Tamiahua,Total,8189,8078,111,10598
30 Veracruz de Ignacio de la Llave,151,151 Tamiahua,Total,30,29,1,1536
30 Veracruz de Ignacio de la Llave,151,151 Tamiahua,Total,378,365,13,2030
30 Veracruz de Ignacio de la Llave,151,151 Tamiahua,Total,673,647,26,675
30 Veracruz de Ignacio de la Llave,151,151 Tamiahua,Total,605,582,23,510
30 Veracruz de Ignacio de la Llave,151,151 Tamiahua,Total,764,752,12,544
30 Veracruz de Ignacio de la Llave,151,151 Tamiahua,Total,877,873,4,705
30 Veracruz de Ignacio de la Llave,151,151 Tamiahua,Total,958,948,10,723
30 Veracruz de Ignacio de la Llave,151,151 Tamiahua,Total,889,884,5,656
30 Veracruz de Ignacio de la Llave,151,151 Tamiahua,Total,781,774,7,636
30 Veracruz de Ignacio de la Llave,151,151 Tamiahua,Total,605,603,2,510
30 Veracruz de Ignacio de la Llave,151,151 Tamiahua,Total,592,588,4,523
30 Veracruz de Ignacio de la Llave,151,151 Tamiahua,Total,440,438,2,468
30 Veracruz de Ignacio de la Llave,151,151 Tamiahua,Total,328,327,1,395
30 Veracruz de Ignacio de la Llave,151,151 Tamiahua,Total,168,168,0,271
30 Veracruz de Ignacio de la Llave,151,151 Tamiahua,Total,59,58,1,205
30 Veracruz de Ignacio de la Llave,151,151 Tamiahua,Total,42,42,0,211
30 Veracruz de Ignacio de la Llave,151,151 Tamiahua,Hombres,6809,6718,91,2581
30 Veracruz de Ignacio de la Llave,151,151 Tamiahua,Hombres,23,22,1,780
30 Veracruz de Ignacio de la Llave,151,151 Tamiahua,Hombres,317,307,10,931
30 Veracruz de Ignacio de la Llave,151,151 Tamiahua,Hombres,530,511,19,164
30 Veracruz de Ignacio de la Llave,151,151 Tamiahua,Hombres,464,447,17,44
30 Veracruz de Ignacio de la Llave,151,151 Tamiahua,Hombres,612,601,11,32
30 Veracruz de Ignacio de la Llave,151,151 Tamiahua,Hombres,701,698,3,42
30 Veracruz de Ignacio de la Llave,151,151 Tamiahua,Hombres,784,775,9,45
30 Veracruz de Ignacio de la Llave,151,151 Tamiahua,Hombres,742,738,4,31
30 Veracruz de Ignacio de la Llave,151,151 Tamiahua,Hombres,651,644,7,52
30 Veracruz de Ignacio de la Llave,151,151 Tamiahua,Hombres,522,520,2,53
30 Veracruz de Ignacio de la Llave,151,151 Tamiahua,Hombres,522,518,4,44
30 Veracruz de Ignacio de la Llave,151,151 Tamiahua,Hombres,392,390,2,82
30 Veracruz de Ignacio de la Llave,151,151 Tamiahua,Hombres,299,298,1,78
30 Veracruz de Ignacio de la Llave,151,151 Tamiahua,Hombres,154,154,0,68
30 Veracruz de Ignacio de la Llave,151,151 Tamiahua,Hombres,57,56,1,67
30 Veracruz de Ignacio de la Llave,151,151 Tamiahua,Hombres,39,39,0,68
30 Veracruz de Ignacio de la Llave,151,151 Tamiahua,Mujeres,1380,1360,20,8017
30 Veracruz de Ignacio de la Llave,151,151 Tamiahua,Mujeres,7,7,0,756
30 Veracruz de Ignacio de la Llave,151,151 Tamiahua,Mujeres,61,58,3,1099
30 Veracruz de Ignacio de la Llave,151,151 Tamiahua,Mujeres,143,136,7,511
30 Veracruz de Ignacio de la Llave,151,151 Tamiahua,Mujeres,141,135,6,466
30 Veracruz de Ignacio de la Llave,151,151 Tamiahua,Mujeres,152,151,1,512
30 Veracruz de Ignacio de la Llave,151,151 Tamiahua,Mujeres,176,175,1,663
30 Veracruz de Ignacio de la Llave,151,151 Tamiahua,Mujeres,174,173,1,678
30 Veracruz de Ignacio de la Llave,151,151 Tamiahua,Mujeres,147,146,1,625
30 Veracruz de Ignacio de la Llave,151,151 Tamiahua,Mujeres,130,130,0,584
30 Veracruz de Ignacio de la Llave,151,151 Tamiahua,Mujeres,83,83,0,457
30 Veracruz de Ignacio de la Llave,151,151 Tamiahua,Mujeres,70,70,0,479
30 Veracruz de Ignacio de la Llave,151,151 Tamiahua,Mujeres,48,48,0,386
30 Veracruz de Ignacio de la Llave,151,151 Tamiahua,Mujeres,29,29,0,317
30 Veracruz de Ignacio de la Llave,151,151 Tamiahua,Mujeres,14,14,0,203
30 Veracruz de Ignacio de la Llave,151,151 Tamiahua,Mujeres,2,2,0,138
30 Veracruz de Ignacio de la Llave,151,151 Tamiahua,Mujeres,3,3,0,143
30 Veracruz de Ignacio de la Llave,152,152 Tampico Alto,Total,4654,4533,121,4966
30 Veracruz de Ignacio de la Llave,152,152 Tampico Alto,Total,29,29,0,690
30 Veracruz de Ignacio de la Llave,152,152 Tampico Alto,Total,266,248,18,734
30 Veracruz de Ignacio de la Llave,152,152 Tampico Alto,Total,484,467,17,364
30 Veracruz de Ignacio de la Llave,152,152 Tampico Alto,Total,483,463,20,306
30 Veracruz de Ignacio de la Llave,152,152 Tampico Alto,Total,463,454,9,309
30 Veracruz de Ignacio de la Llave,152,152 Tampico Alto,Total,529,518,11,308
30 Veracruz de Ignacio de la Llave,152,152 Tampico Alto,Total,491,481,10,326
30 Veracruz de Ignacio de la Llave,152,152 Tampico Alto,Total,460,451,9,317
30 Veracruz de Ignacio de la Llave,152,152 Tampico Alto,Total,403,395,8,292
30 Veracruz de Ignacio de la Llave,152,152 Tampico Alto,Total,331,325,6,228
30 Veracruz de Ignacio de la Llave,152,152 Tampico Alto,Total,246,239,7,260
30 Veracruz de Ignacio de la Llave,152,152 Tampico Alto,Total,188,187,1,225
30 Veracruz de Ignacio de la Llave,152,152 Tampico Alto,Total,137,135,2,211
30 Veracruz de Ignacio de la Llave,152,152 Tampico Alto,Total,84,82,2,157
30 Veracruz de Ignacio de la Llave,152,152 Tampico Alto,Total,38,38,0,127
30 Veracruz de Ignacio de la Llave,152,152 Tampico Alto,Total,22,21,1,112
30 Veracruz de Ignacio de la Llave,152,152 Tampico Alto,Hombres,3788,3677,111,1205
30 Veracruz de Ignacio de la Llave,152,152 Tampico Alto,Hombres,21,21,0,351
30 Veracruz de Ignacio de la Llave,152,152 Tampico Alto,Hombres,211,196,15,330
30 Veracruz de Ignacio de la Llave,152,152 Tampico Alto,Hombres,367,353,14,77
30 Veracruz de Ignacio de la Llave,152,152 Tampico Alto,Hombres,372,354,18,33
30 Veracruz de Ignacio de la Llave,152,152 Tampico Alto,Hombres,379,371,8,12
30 Veracruz de Ignacio de la Llave,152,152 Tampico Alto,Hombres,409,398,11,14
30 Veracruz de Ignacio de la Llave,152,152 Tampico Alto,Hombres,383,373,10,10
30 Veracruz de Ignacio de la Llave,152,152 Tampico Alto,Hombres,372,363,9,18
30 Veracruz de Ignacio de la Llave,152,152 Tampico Alto,Hombres,346,338,8,17
30 Veracruz de Ignacio de la Llave,152,152 Tampico Alto,Hombres,278,272,6,19
30 Veracruz de Ignacio de la Llave,152,152 Tampico Alto,Hombres,217,211,6,49
30 Veracruz de Ignacio de la Llave,152,152 Tampico Alto,Hombres,168,167,1,48
30 Veracruz de Ignacio de la Llave,152,152 Tampico Alto,Hombres,129,127,2,63
30 Veracruz de Ignacio de la Llave,152,152 Tampico Alto,Hombres,78,76,2,51
30 Veracruz de Ignacio de la Llave,152,152 Tampico Alto,Hombres,37,37,0,61
30 Veracruz de Ignacio de la Llave,152,152 Tampico Alto,Hombres,21,20,1,52
30 Veracruz de Ignacio de la Llave,152,152 Tampico Alto,Mujeres,866,856,10,3761
30 Veracruz de Ignacio de la Llave,152,152 Tampico Alto,Mujeres,8,8,0,339
30 Veracruz de Ignacio de la Llave,152,152 Tampico Alto,Mujeres,55,52,3,404
30 Veracruz de Ignacio de la Llave,152,152 Tampico Alto,Mujeres,117,114,3,287
30 Veracruz de Ignacio de la Llave,152,152 Tampico Alto,Mujeres,111,109,2,273
30 Veracruz de Ignacio de la Llave,152,152 Tampico Alto,Mujeres,84,83,1,297
30 Veracruz de Ignacio de la Llave,152,152 Tampico Alto,Mujeres,120,120,0,294
30 Veracruz de Ignacio de la Llave,152,152 Tampico Alto,Mujeres,108,108,0,316
30 Veracruz de Ignacio de la Llave,152,152 Tampico Alto,Mujeres,88,88,0,299
30 Veracruz de Ignacio de la Llave,152,152 Tampico Alto,Mujeres,57,57,0,275
30 Veracruz de Ignacio de la Llave,152,152 Tampico Alto,Mujeres,53,53,0,209
30 Veracruz de Ignacio de la Llave,152,152 Tampico Alto,Mujeres,29,28,1,211
30 Veracruz de Ignacio de la Llave,152,152 Tampico Alto,Mujeres,20,20,0,177
30 Veracruz de Ignacio de la Llave,152,152 Tampico Alto,Mujeres,8,8,0,148
30 Veracruz de Ignacio de la Llave,152,152 Tampico Alto,Mujeres,6,6,0,106
30 Veracruz de Ignacio de la Llave,152,152 Tampico Alto,Mujeres,1,1,0,66
30 Veracruz de Ignacio de la Llave,152,152 Tampico Alto,Mujeres,1,1,0,60
30 Veracruz de Ignacio de la Llave,153,153 Tancoco,Total,2150,2105,45,2520
30 Veracruz de Ignacio de la Llave,153,153 Tancoco,Total,15,15,0,352
30 Veracruz de Ignacio de la Llave,153,153 Tancoco,Total,129,124,5,507
30 Veracruz de Ignacio de la Llave,153,153 Tancoco,Total,218,213,5,192
30 Veracruz de Ignacio de la Llave,153,153 Tancoco,Total,217,208,9,119
30 Veracruz de Ignacio de la Llave,153,153 Tancoco,Total,182,178,4,137
30 Veracruz de Ignacio de la Llave,153,153 Tancoco,Total,230,227,3,133
30 Veracruz de Ignacio de la Llave,153,153 Tancoco,Total,226,219,7,178
30 Veracruz de Ignacio de la Llave,153,153 Tancoco,Total,223,220,3,119
30 Veracruz de Ignacio de la Llave,153,153 Tancoco,Total,168,166,2,119
30 Veracruz de Ignacio de la Llave,153,153 Tancoco,Total,139,136,3,123
30 Veracruz de Ignacio de la Llave,153,153 Tancoco,Total,133,133,0,103
30 Veracruz de Ignacio de la Llave,153,153 Tancoco,Total,113,111,2,116
30 Veracruz de Ignacio de la Llave,153,153 Tancoco,Total,87,85,2,113
30 Veracruz de Ignacio de la Llave,153,153 Tancoco,Total,37,37,0,86
30 Veracruz de Ignacio de la Llave,153,153 Tancoco,Total,23,23,0,67
30 Veracruz de Ignacio de la Llave,153,153 Tancoco,Total,10,10,0,56
30 Veracruz de Ignacio de la Llave,153,153 Tancoco,Hombres,1571,1530,41,684
30 Veracruz de Ignacio de la Llave,153,153 Tancoco,Hombres,12,12,0,191
30 Veracruz de Ignacio de la Llave,153,153 Tancoco,Hombres,89,86,3,221
30 Veracruz de Ignacio de la Llave,153,153 Tancoco,Hombres,141,137,4,57
30 Veracruz de Ignacio de la Llave,153,153 Tancoco,Hombres,155,147,8,13
30 Veracruz de Ignacio de la Llave,153,153 Tancoco,Hombres,138,134,4,3
30 Veracruz de Ignacio de la Llave,153,153 Tancoco,Hombres,161,158,3,8
30 Veracruz de Ignacio de la Llave,153,153 Tancoco,Hombres,176,169,7,10
30 Veracruz de Ignacio de la Llave,153,153 Tancoco,Hombres,160,157,3,7
30 Veracruz de Ignacio de la Llave,153,153 Tancoco,Hombres,129,127,2,7
30 Veracruz de Ignacio de la Llave,153,153 Tancoco,Hombres,103,100,3,13
30 Veracruz de Ignacio de la Llave,153,153 Tancoco,Hombres,90,90,0,18
30 Veracruz de Ignacio de la Llave,153,153 Tancoco,Hombres,87,85,2,23
30 Veracruz de Ignacio de la Llave,153,153 Tancoco,Hombres,70,68,2,30
30 Veracruz de Ignacio de la Llave,153,153 Tancoco,Hombres,29,29,0,26
30 Veracruz de Ignacio de la Llave,153,153 Tancoco,Hombres,22,22,0,29
30 Veracruz de Ignacio de la Llave,153,153 Tancoco,Hombres,9,9,0,28
30 Veracruz de Ignacio de la Llave,153,153 Tancoco,Mujeres,579,575,4,1836
30 Veracruz de Ignacio de la Llave,153,153 Tancoco,Mujeres,3,3,0,161
30 Veracruz de Ignacio de la Llave,153,153 Tancoco,Mujeres,40,38,2,286
30 Veracruz de Ignacio de la Llave,153,153 Tancoco,Mujeres,77,76,1,135
30 Veracruz de Ignacio de la Llave,153,153 Tancoco,Mujeres,62,61,1,106
30 Veracruz de Ignacio de la Llave,153,153 Tancoco,Mujeres,44,44,0,134
30 Veracruz de Ignacio de la Llave,153,153 Tancoco,Mujeres,69,69,0,125
30 Veracruz de Ignacio de la Llave,153,153 Tancoco,Mujeres,50,50,0,168
30 Veracruz de Ignacio de la Llave,153,153 Tancoco,Mujeres,63,63,0,112
30 Veracruz de Ignacio de la Llave,153,153 Tancoco,Mujeres,39,39,0,112
30 Veracruz de Ignacio de la Llave,153,153 Tancoco,Mujeres,36,36,0,110
30 Veracruz de Ignacio de la Llave,153,153 Tancoco,Mujeres,43,43,0,85
30 Veracruz de Ignacio de la Llave,153,153 Tancoco,Mujeres,26,26,0,93
30 Veracruz de Ignacio de la Llave,153,153 Tancoco,Mujeres,17,17,0,83
30 Veracruz de Ignacio de la Llave,153,153 Tancoco,Mujeres,8,8,0,60
30 Veracruz de Ignacio de la Llave,153,153 Tancoco,Mujeres,1,1,0,38
30 Veracruz de Ignacio de la Llave,153,153 Tancoco,Mujeres,1,1,0,28
30 Veracruz de Ignacio de la Llave,154,154 Tantima,Total,4312,4178,134,5721
30 Veracruz de Ignacio de la Llave,154,154 Tantima,Total,17,15,2,831
30 Veracruz de Ignacio de la Llave,154,154 Tantima,Total,305,287,18,1093
30 Veracruz de Ignacio de la Llave,154,154 Tantima,Total,422,408,14,338
30 Veracruz de Ignacio de la Llave,154,154 Tantima,Total,352,339,13,263
30 Veracruz de Ignacio de la Llave,154,154 Tantima,Total,392,385,7,357
30 Veracruz de Ignacio de la Llave,154,154 Tantima,Total,461,450,11,373
30 Veracruz de Ignacio de la Llave,154,154 Tantima,Total,439,432,7,368
30 Veracruz de Ignacio de la Llave,154,154 Tantima,Total,422,410,12,349
30 Veracruz de Ignacio de la Llave,154,154 Tantima,Total,331,324,7,289
30 Veracruz de Ignacio de la Llave,154,154 Tantima,Total,286,274,12,296
30 Veracruz de Ignacio de la Llave,154,154 Tantima,Total,291,282,9,296
30 Veracruz de Ignacio de la Llave,154,154 Tantima,Total,231,220,11,250
30 Veracruz de Ignacio de la Llave,154,154 Tantima,Total,186,181,5,243
30 Veracruz de Ignacio de la Llave,154,154 Tantima,Total,106,102,4,147
30 Veracruz de Ignacio de la Llave,154,154 Tantima,Total,54,52,2,127
30 Veracruz de Ignacio de la Llave,154,154 Tantima,Total,17,17,0,101
30 Veracruz de Ignacio de la Llave,154,154 Tantima,Hombres,3795,3677,118,1229
30 Veracruz de Ignacio de la Llave,154,154 Tantima,Hombres,16,14,2,414
30 Veracruz de Ignacio de la Llave,154,154 Tantima,Hombres,250,235,15,471
30 Veracruz de Ignacio de la Llave,154,154 Tantima,Hombres,320,311,9,46
30 Veracruz de Ignacio de la Llave,154,154 Tantima,Hombres,283,270,13,22
30 Veracruz de Ignacio de la Llave,154,154 Tantima,Hombres,327,325,2,12
30 Veracruz de Ignacio de la Llave,154,154 Tantima,Hombres,396,385,11,4
30 Veracruz de Ignacio de la Llave,154,154 Tantima,Hombres,385,378,7,19
30 Veracruz de Ignacio de la Llave,154,154 Tantima,Hombres,385,374,11,12
30 Veracruz de Ignacio de la Llave,154,154 Tantima,Hombres,304,297,7,8
30 Veracruz de Ignacio de la Llave,154,154 Tantima,Hombres,273,261,12,18
30 Veracruz de Ignacio de la Llave,154,154 Tantima,Hombres,276,268,8,26
30 Veracruz de Ignacio de la Llave,154,154 Tantima,Hombres,225,214,11,35
30 Veracruz de Ignacio de la Llave,154,154 Tantima,Hombres,183,178,5,35
30 Veracruz de Ignacio de la Llave,154,154 Tantima,Hombres,102,99,3,27
30 Veracruz de Ignacio de la Llave,154,154 Tantima,Hombres,53,51,2,40
30 Veracruz de Ignacio de la Llave,154,154 Tantima,Hombres,17,17,0,40
30 Veracruz de Ignacio de la Llave,154,154 Tantima,Mujeres,517,501,16,4492
30 Veracruz de Ignacio de la Llave,154,154 Tantima,Mujeres,1,1,0,417
30 Veracruz de Ignacio de la Llave,154,154 Tantima,Mujeres,55,52,3,622
30 Veracruz de Ignacio de la Llave,154,154 Tantima,Mujeres,102,97,5,292
30 Veracruz de Ignacio de la Llave,154,154 Tantima,Mujeres,69,69,0,241
30 Veracruz de Ignacio de la Llave,154,154 Tantima,Mujeres,65,60,5,345
30 Veracruz de Ignacio de la Llave,154,154 Tantima,Mujeres,65,65,0,369
30 Veracruz de Ignacio de la Llave,154,154 Tantima,Mujeres,54,54,0,349
30 Veracruz de Ignacio de la Llave,154,154 Tantima,Mujeres,37,36,1,337
30 Veracruz de Ignacio de la Llave,154,154 Tantima,Mujeres,27,27,0,281
30 Veracruz de Ignacio de la Llave,154,154 Tantima,Mujeres,13,13,0,278
30 Veracruz de Ignacio de la Llave,154,154 Tantima,Mujeres,15,14,1,270
30 Veracruz de Ignacio de la Llave,154,154 Tantima,Mujeres,6,6,0,215
30 Veracruz de Ignacio de la Llave,154,154 Tantima,Mujeres,3,3,0,208
30 Veracruz de Ignacio de la Llave,154,154 Tantima,Mujeres,4,3,1,120
30 Veracruz de Ignacio de la Llave,154,154 Tantima,Mujeres,1,1,0,87
30 Veracruz de Ignacio de la Llave,154,154 Tantima,Mujeres,0,0,0,61
30 Veracruz de Ignacio de la Llave,155,155 Tantoyuca,Total,34072,33526,546,39448
30 Veracruz de Ignacio de la Llave,155,155 Tantoyuca,Total,256,246,10,6959
30 Veracruz de Ignacio de la Llave,155,155 Tantoyuca,Total,2922,2847,75,8566
30 Veracruz de Ignacio de la Llave,155,155 Tantoyuca,Total,3866,3751,115,3323
30 Veracruz de Ignacio de la Llave,155,155 Tantoyuca,Total,3594,3500,94,2371
30 Veracruz de Ignacio de la Llave,155,155 Tantoyuca,Total,3535,3485,50,2386
30 Veracruz de Ignacio de la Llave,155,155 Tantoyuca,Total,3683,3647,36,2265
30 Veracruz de Ignacio de la Llave,155,155 Tantoyuca,Total,3626,3575,51,2119
30 Veracruz de Ignacio de la Llave,155,155 Tantoyuca,Total,3188,3156,32,2055
30 Veracruz de Ignacio de la Llave,155,155 Tantoyuca,Total,2587,2564,23,2016
30 Veracruz de Ignacio de la Llave,155,155 Tantoyuca,Total,1927,1900,27,1579
30 Veracruz de Ignacio de la Llave,155,155 Tantoyuca,Total,1640,1625,15,1524
30 Veracruz de Ignacio de la Llave,155,155 Tantoyuca,Total,1322,1310,12,1286
30 Veracruz de Ignacio de la Llave,155,155 Tantoyuca,Total,1033,1031,2,1217
30 Veracruz de Ignacio de la Llave,155,155 Tantoyuca,Total,528,526,2,819
30 Veracruz de Ignacio de la Llave,155,155 Tantoyuca,Total,223,223,0,518
30 Veracruz de Ignacio de la Llave,155,155 Tantoyuca,Total,142,140,2,445
30 Veracruz de Ignacio de la Llave,155,155 Tantoyuca,Hombres,26493,26054,439,9456
30 Veracruz de Ignacio de la Llave,155,155 Tantoyuca,Hombres,196,187,9,3470
30 Veracruz de Ignacio de la Llave,155,155 Tantoyuca,Hombres,2144,2087,57,3800
30 Veracruz de Ignacio de la Llave,155,155 Tantoyuca,Hombres,2819,2750,69,700
30 Veracruz de Ignacio de la Llave,155,155 Tantoyuca,Hombres,2701,2626,75,114
30 Veracruz de Ignacio de la Llave,155,155 Tantoyuca,Hombres,2648,2606,42,68
30 Veracruz de Ignacio de la Llave,155,155 Tantoyuca,Hombres,2741,2709,32,60
30 Veracruz de Ignacio de la Llave,155,155 Tantoyuca,Hombres,2769,2723,46,59
30 Veracruz de Ignacio de la Llave,155,155 Tantoyuca,Hombres,2464,2434,30,71
30 Veracruz de Ignacio de la Llave,155,155 Tantoyuca,Hombres,2096,2074,22,90
30 Veracruz de Ignacio de la Llave,155,155 Tantoyuca,Hombres,1595,1570,25,122
30 Veracruz de Ignacio de la Llave,155,155 Tantoyuca,Hombres,1398,1384,14,144
30 Veracruz de Ignacio de la Llave,155,155 Tantoyuca,Hombres,1158,1146,12,128
30 Veracruz de Ignacio de la Llave,155,155 Tantoyuca,Hombres,943,941,2,177
30 Veracruz de Ignacio de la Llave,155,155 Tantoyuca,Hombres,486,484,2,166
30 Veracruz de Ignacio de la Llave,155,155 Tantoyuca,Hombres,208,208,0,130
30 Veracruz de Ignacio de la Llave,155,155 Tantoyuca,Hombres,127,125,2,157
30 Veracruz de Ignacio de la Llave,155,155 Tantoyuca,Mujeres,7579,7472,107,29992
30 Veracruz de Ignacio de la Llave,155,155 Tantoyuca,Mujeres,60,59,1,3489
30 Veracruz de Ignacio de la Llave,155,155 Tantoyuca,Mujeres,778,760,18,4766
30 Veracruz de Ignacio de la Llave,155,155 Tantoyuca,Mujeres,1047,1001,46,2623
30 Veracruz de Ignacio de la Llave,155,155 Tantoyuca,Mujeres,893,874,19,2257
30 Veracruz de Ignacio de la Llave,155,155 Tantoyuca,Mujeres,887,879,8,2318
30 Veracruz de Ignacio de la Llave,155,155 Tantoyuca,Mujeres,942,938,4,2205
30 Veracruz de Ignacio de la Llave,155,155 Tantoyuca,Mujeres,857,852,5,2060
30 Veracruz de Ignacio de la Llave,155,155 Tantoyuca,Mujeres,724,722,2,1984
30 Veracruz de Ignacio de la Llave,155,155 Tantoyuca,Mujeres,491,490,1,1926
30 Veracruz de Ignacio de la Llave,155,155 Tantoyuca,Mujeres,332,330,2,1457
30 Veracruz de Ignacio de la Llave,155,155 Tantoyuca,Mujeres,242,241,1,1380
30 Veracruz de Ignacio de la Llave,155,155 Tantoyuca,Mujeres,164,164,0,1158
30 Veracruz de Ignacio de la Llave,155,155 Tantoyuca,Mujeres,90,90,0,1040
30 Veracruz de Ignacio de la Llave,155,155 Tantoyuca,Mujeres,42,42,0,653
30 Veracruz de Ignacio de la Llave,155,155 Tantoyuca,Mujeres,15,15,0,388
30 Veracruz de Ignacio de la Llave,155,155 Tantoyuca,Mujeres,15,15,0,288
30 Veracruz de Ignacio de la Llave,209,209 Tatahuicapan de Juárez,Total,4186,3865,321,6436
30 Veracruz de Ignacio de la Llave,209,209 Tatahuicapan de Juárez,Total,57,50,7,1057
30 Veracruz de Ignacio de la Llave,209,209 Tatahuicapan de Juárez,Total,458,394,64,1356
30 Veracruz de Ignacio de la Llave,209,209 Tatahuicapan de Juárez,Total,647,588,59,768
30 Veracruz de Ignacio de la Llave,209,209 Tatahuicapan de Juárez,Total,514,477,37,561
30 Veracruz de Ignacio de la Llave,209,209 Tatahuicapan de Juárez,Total,515,468,47,484
30 Veracruz de Ignacio de la Llave,209,209 Tatahuicapan de Juárez,Total,498,472,26,482
30 Veracruz de Ignacio de la Llave,209,209 Tatahuicapan de Juárez,Total,363,342,21,332
30 Veracruz de Ignacio de la Llave,209,209 Tatahuicapan de Juárez,Total,280,264,16,356
30 Veracruz de Ignacio de la Llave,209,209 Tatahuicapan de Juárez,Total,256,245,11,238
30 Veracruz de Ignacio de la Llave,209,209 Tatahuicapan de Juárez,Total,225,209,16,228
30 Veracruz de Ignacio de la Llave,209,209 Tatahuicapan de Juárez,Total,117,110,7,142
30 Veracruz de Ignacio de la Llave,209,209 Tatahuicapan de Juárez,Total,125,119,6,150
30 Veracruz de Ignacio de la Llave,209,209 Tatahuicapan de Juárez,Total,71,70,1,117
30 Veracruz de Ignacio de la Llave,209,209 Tatahuicapan de Juárez,Total,39,36,3,81
30 Veracruz de Ignacio de la Llave,209,209 Tatahuicapan de Juárez,Total,12,12,0,40
30 Veracruz de Ignacio de la Llave,209,209 Tatahuicapan de Juárez,Total,9,9,0,44
30 Veracruz de Ignacio de la Llave,209,209 Tatahuicapan de Juárez,Hombres,3686,3372,314,1507
30 Veracruz de Ignacio de la Llave,209,209 Tatahuicapan de Juárez,Hombres,53,46,7,511
30 Veracruz de Ignacio de la Llave,209,209 Tatahuicapan de Juárez,Hombres,410,349,61,535
30 Veracruz de Ignacio de la Llave,209,209 Tatahuicapan de Juárez,Hombres,548,491,57,90
30 Veracruz de Ignacio de la Llave,209,209 Tatahuicapan de Juárez,Hombres,437,401,36,44
30 Veracruz de Ignacio de la Llave,209,209 Tatahuicapan de Juárez,Hombres,450,404,46,46
30 Veracruz de Ignacio de la Llave,209,209 Tatahuicapan de Juárez,Hombres,426,400,26,33
30 Veracruz de Ignacio de la Llave,209,209 Tatahuicapan de Juárez,Hombres,310,289,21,38
30 Veracruz de Ignacio de la Llave,209,209 Tatahuicapan de Juárez,Hombres,244,228,16,23
30 Veracruz de Ignacio de la Llave,209,209 Tatahuicapan de Juárez,Hombres,237,226,11,22
30 Veracruz de Ignacio de la Llave,209,209 Tatahuicapan de Juárez,Hombres,214,198,16,30
30 Veracruz de Ignacio de la Llave,209,209 Tatahuicapan de Juárez,Hombres,114,107,7,20
30 Veracruz de Ignacio de la Llave,209,209 Tatahuicapan de Juárez,Hombres,122,116,6,27
30 Veracruz de Ignacio de la Llave,209,209 Tatahuicapan de Juárez,Hombres,65,64,1,27
30 Veracruz de Ignacio de la Llave,209,209 Tatahuicapan de Juárez,Hombres,37,34,3,24
30 Veracruz de Ignacio de la Llave,209,209 Tatahuicapan de Juárez,Hombres,12,12,0,16
30 Veracruz de Ignacio de la Llave,209,209 Tatahuicapan de Juárez,Hombres,7,7,0,21
30 Veracruz de Ignacio de la Llave,209,209 Tatahuicapan de Juárez,Mujeres,500,493,7,4929
30 Veracruz de Ignacio de la Llave,209,209 Tatahuicapan de Juárez,Mujeres,4,4,0,546
30 Veracruz de Ignacio de la Llave,209,209 Tatahuicapan de Juárez,Mujeres,48,45,3,821
30 Veracruz de Ignacio de la Llave,209,209 Tatahuicapan de Juárez,Mujeres,99,97,2,678
30 Veracruz de Ignacio de la Llave,209,209 Tatahuicapan de Juárez,Mujeres,77,76,1,517
30 Veracruz de Ignacio de la Llave,209,209 Tatahuicapan de Juárez,Mujeres,65,64,1,438
30 Veracruz de Ignacio de la Llave,209,209 Tatahuicapan de Juárez,Mujeres,72,72,0,449
30 Veracruz de Ignacio de la Llave,209,209 Tatahuicapan de Juárez,Mujeres,53,53,0,294
30 Veracruz de Ignacio de la Llave,209,209 Tatahuicapan de Juárez,Mujeres,36,36,0,333
30 Veracruz de Ignacio de la Llave,209,209 Tatahuicapan de Juárez,Mujeres,19,19,0,216
30 Veracruz de Ignacio de la Llave,209,209 Tatahuicapan de Juárez,Mujeres,11,11,0,198
30 Veracruz de Ignacio de la Llave,209,209 Tatahuicapan de Juárez,Mujeres,3,3,0,122
30 Veracruz de Ignacio de la Llave,209,209 Tatahuicapan de Juárez,Mujeres,3,3,0,123
30 Veracruz de Ignacio de la Llave,209,209 Tatahuicapan de Juárez,Mujeres,6,6,0,90
30 Veracruz de Ignacio de la Llave,209,209 Tatahuicapan de Juárez,Mujeres,2,2,0,57
30 Veracruz de Ignacio de la Llave,209,209 Tatahuicapan de Juárez,Mujeres,0,0,0,24
30 Veracruz de Ignacio de la Llave,209,209 Tatahuicapan de Juárez,Mujeres,2,2,0,23
30 Veracruz de Ignacio de la Llave,156,156 Tatatila,Total,1693,1660,33,2143
30 Veracruz de Ignacio de la Llave,156,156 Tatatila,Total,31,30,1,374
30 Veracruz de Ignacio de la Llave,156,156 Tatatila,Total,244,236,8,385
30 Veracruz de Ignacio de la Llave,156,156 Tatatila,Total,272,263,9,214
30 Veracruz de Ignacio de la Llave,156,156 Tatatila,Total,208,199,9,186
30 Veracruz de Ignacio de la Llave,156,156 Tatatila,Total,187,186,1,174
30 Veracruz de Ignacio de la Llave,156,156 Tatatila,Total,162,161,1,138
30 Veracruz de Ignacio de la Llave,156,156 Tatatila,Total,145,145,0,128
30 Veracruz de Ignacio de la Llave,156,156 Tatatila,Total,110,109,1,98
30 Veracruz de Ignacio de la Llave,156,156 Tatatila,Total,86,86,0,89
30 Veracruz de Ignacio de la Llave,156,156 Tatatila,Total,69,68,1,58
30 Veracruz de Ignacio de la Llave,156,156 Tatatila,Total,55,54,1,71
30 Veracruz de Ignacio de la Llave,156,156 Tatatila,Total,54,54,0,66
30 Veracruz de Ignacio de la Llave,156,156 Tatatila,Total,29,28,1,47
30 Veracruz de Ignacio de la Llave,156,156 Tatatila,Total,23,23,0,41
30 Veracruz de Ignacio de la Llave,156,156 Tatatila,Total,12,12,0,34
30 Veracruz de Ignacio de la Llave,156,156 Tatatila,Total,6,6,0,40
30 Veracruz de Ignacio de la Llave,156,156 Tatatila,Hombres,1487,1457,30,526
30 Veracruz de Ignacio de la Llave,156,156 Tatatila,Hombres,30,29,1,187
30 Veracruz de Ignacio de la Llave,156,156 Tatatila,Hombres,210,204,6,140
30 Veracruz de Ignacio de la Llave,156,156 Tatatila,Hombres,225,216,9,41
30 Veracruz de Ignacio de la Llave,156,156 Tatatila,Hombres,189,181,8,23
30 Veracruz de Ignacio de la Llave,156,156 Tatatila,Hombres,160,159,1,15
30 Veracruz de Ignacio de la Llave,156,156 Tatatila,Hombres,145,144,1,12
30 Veracruz de Ignacio de la Llave,156,156 Tatatila,Hombres,126,126,0,9
30 Veracruz de Ignacio de la Llave,156,156 Tatatila,Hombres,101,100,1,14
30 Veracruz de Ignacio de la Llave,156,156 Tatatila,Hombres,73,73,0,11
30 Veracruz de Ignacio de la Llave,156,156 Tatatila,Hombres,63,62,1,4
30 Veracruz de Ignacio de la Llave,156,156 Tatatila,Hombres,48,47,1,7
30 Veracruz de Ignacio de la Llave,156,156 Tatatila,Hombres,53,53,0,14
30 Veracruz de Ignacio de la Llave,156,156 Tatatila,Hombres,28,27,1,7
30 Veracruz de Ignacio de la Llave,156,156 Tatatila,Hombres,21,21,0,12
30 Veracruz de Ignacio de la Llave,156,156 Tatatila,Hombres,12,12,0,11
30 Veracruz de Ignacio de la Llave,156,156 Tatatila,Hombres,3,3,0,19
30 Veracruz de Ignacio de la Llave,156,156 Tatatila,Mujeres,206,203,3,1617
30 Veracruz de Ignacio de la Llave,156,156 Tatatila,Mujeres,1,1,0,187
30 Veracruz de Ignacio de la Llave,156,156 Tatatila,Mujeres,34,32,2,245
30 Veracruz de Ignacio de la Llave,156,156 Tatatila,Mujeres,47,47,0,173
30 Veracruz de Ignacio de la Llave,156,156 Tatatila,Mujeres,19,18,1,163
30 Veracruz de Ignacio de la Llave,156,156 Tatatila,Mujeres,27,27,0,159
30 Veracruz de Ignacio de la Llave,156,156 Tatatila,Mujeres,17,17,0,126
30 Veracruz de Ignacio de la Llave,156,156 Tatatila,Mujeres,19,19,0,119
30 Veracruz de Ignacio de la Llave,156,156 Tatatila,Mujeres,9,9,0,84
30 Veracruz de Ignacio de la Llave,156,156 Tatatila,Mujeres,13,13,0,78
30 Veracruz de Ignacio de la Llave,156,156 Tatatila,Mujeres,6,6,0,54
30 Veracruz de Ignacio de la Llave,156,156 Tatatila,Mujeres,7,7,0,64
30 Veracruz de Ignacio de la Llave,156,156 Tatatila,Mujeres,1,1,0,52
30 Veracruz de Ignacio de la Llave,156,156 Tatatila,Mujeres,1,1,0,40
30 Veracruz de Ignacio de la Llave,156,156 Tatatila,Mujeres,2,2,0,29
30 Veracruz de Ignacio de la Llave,156,156 Tatatila,Mujeres,0,0,0,23
30 Veracruz de Ignacio de la Llave,156,156 Tatatila,Mujeres,3,3,0,21
30 Veracruz de Ignacio de la Llave,158,158 Tecolutla,Total,9738,9415,323,9932
30 Veracruz de Ignacio de la Llave,158,158 Tecolutla,Total,79,74,5,1487
30 Veracruz de Ignacio de la Llave,158,158 Tecolutla,Total,728,688,40,1887
30 Veracruz de Ignacio de la Llave,158,158 Tecolutla,Total,1022,969,53,807
30 Veracruz de Ignacio de la Llave,158,158 Tecolutla,Total,942,912,30,601
30 Veracruz de Ignacio de la Llave,158,158 Tecolutla,Total,1018,991,27,646
30 Veracruz de Ignacio de la Llave,158,158 Tecolutla,Total,1107,1077,30,720
30 Veracruz de Ignacio de la Llave,158,158 Tecolutla,Total,1097,1068,29,604
30 Veracruz de Ignacio de la Llave,158,158 Tecolutla,Total,929,897,32,553
30 Veracruz de Ignacio de la Llave,158,158 Tecolutla,Total,755,732,23,522
30 Veracruz de Ignacio de la Llave,158,158 Tecolutla,Total,644,627,17,441
30 Veracruz de Ignacio de la Llave,158,158 Tecolutla,Total,506,494,12,400
30 Veracruz de Ignacio de la Llave,158,158 Tecolutla,Total,371,364,7,367
30 Veracruz de Ignacio de la Llave,158,158 Tecolutla,Total,283,276,7,351
30 Veracruz de Ignacio de la Llave,158,158 Tecolutla,Total,145,137,8,233
30 Veracruz de Ignacio de la Llave,158,158 Tecolutla,Total,72,71,1,142
30 Veracruz de Ignacio de la Llave,158,158 Tecolutla,Total,40,38,2,171
30 Veracruz de Ignacio de la Llave,158,158 Tecolutla,Hombres,7478,7176,302,2164
30 Veracruz de Ignacio de la Llave,158,158 Tecolutla,Hombres,63,58,5,736
30 Veracruz de Ignacio de la Llave,158,158 Tecolutla,Hombres,582,543,39,760
30 Veracruz de Ignacio de la Llave,158,158 Tecolutla,Hombres,764,717,47,121
30 Veracruz de Ignacio de la Llave,158,158 Tecolutla,Hombres,673,649,24,34
30 Veracruz de Ignacio de la Llave,158,158 Tecolutla,Hombres,743,717,26,20
30 Veracruz de Ignacio de la Llave,158,158 Tecolutla,Hombres,816,789,27,22
30 Veracruz de Ignacio de la Llave,158,158 Tecolutla,Hombres,814,786,28,28
30 Veracruz de Ignacio de la Llave,158,158 Tecolutla,Hombres,703,673,30,18
30 Veracruz de Ignacio de la Llave,158,158 Tecolutla,Hombres,582,560,22,25
30 Veracruz de Ignacio de la Llave,158,158 Tecolutla,Hombres,519,502,17,43
30 Veracruz de Ignacio de la Llave,158,158 Tecolutla,Hombres,413,401,12,51
30 Veracruz de Ignacio de la Llave,158,158 Tecolutla,Hombres,322,315,7,59
30 Veracruz de Ignacio de la Llave,158,158 Tecolutla,Hombres,248,241,7,75
30 Veracruz de Ignacio de la Llave,158,158 Tecolutla,Hombres,131,123,8,57
30 Veracruz de Ignacio de la Llave,158,158 Tecolutla,Hombres,66,65,1,46
30 Veracruz de Ignacio de la Llave,158,158 Tecolutla,Hombres,39,37,2,69
30 Veracruz de Ignacio de la Llave,158,158 Tecolutla,Mujeres,2260,2239,21,7768
30 Veracruz de Ignacio de la Llave,158,158 Tecolutla,Mujeres,16,16,0,751
30 Veracruz de Ignacio de la Llave,158,158 Tecolutla,Mujeres,146,145,1,1127
30 Veracruz de Ignacio de la Llave,158,158 Tecolutla,Mujeres,258,252,6,686
30 Veracruz de Ignacio de la Llave,158,158 Tecolutla,Mujeres,269,263,6,567
30 Veracruz de Ignacio de la Llave,158,158 Tecolutla,Mujeres,275,274,1,626
30 Veracruz de Ignacio de la Llave,158,158 Tecolutla,Mujeres,291,288,3,698
30 Veracruz de Ignacio de la Llave,158,158 Tecolutla,Mujeres,283,282,1,576
30 Veracruz de Ignacio de la Llave,158,158 Tecolutla,Mujeres,226,224,2,535
30 Veracruz de Ignacio de la Llave,158,158 Tecolutla,Mujeres,173,172,1,497
30 Veracruz de Ignacio de la Llave,158,158 Tecolutla,Mujeres,125,125,0,398
30 Veracruz de Ignacio de la Llave,158,158 Tecolutla,Mujeres,93,93,0,349
30 Veracruz de Ignacio de la Llave,158,158 Tecolutla,Mujeres,49,49,0,308
30 Veracruz de Ignacio de la Llave,158,158 Tecolutla,Mujeres,35,35,0,276
30 Veracruz de Ignacio de la Llave,158,158 Tecolutla,Mujeres,14,14,0,176
30 Veracruz de Ignacio de la Llave,158,158 Tecolutla,Mujeres,6,6,0,96
30 Veracruz de Ignacio de la Llave,158,158 Tecolutla,Mujeres,1,1,0,102
30 Veracruz de Ignacio de la Llave,159,159 Tehuipango,Total,5195,4124,1071,10013
30 Veracruz de Ignacio de la Llave,159,159 Tehuipango,Total,81,46,35,1684
30 Veracruz de Ignacio de la Llave,159,159 Tehuipango,Total,681,470,211,1995
30 Veracruz de Ignacio de la Llave,159,159 Tehuipango,Total,875,678,197,1145
30 Veracruz de Ignacio de la Llave,159,159 Tehuipango,Total,698,562,136,993
30 Veracruz de Ignacio de la Llave,159,159 Tehuipango,Total,660,539,121,867
30 Veracruz de Ignacio de la Llave,159,159 Tehuipango,Total,546,453,93,741
30 Veracruz de Ignacio de la Llave,159,159 Tehuipango,Total,427,363,64,543
30 Veracruz de Ignacio de la Llave,159,159 Tehuipango,Total,376,309,67,505
30 Veracruz de Ignacio de la Llave,159,159 Tehuipango,Total,249,209,40,361
30 Veracruz de Ignacio de la Llave,159,159 Tehuipango,Total,235,200,35,323
30 Veracruz de Ignacio de la Llave,159,159 Tehuipango,Total,166,137,29,274
30 Veracruz de Ignacio de la Llave,159,159 Tehuipango,Total,82,66,16,205
30 Veracruz de Ignacio de la Llave,159,159 Tehuipango,Total,63,49,14,162
30 Veracruz de Ignacio de la Llave,159,159 Tehuipango,Total,35,28,7,95
30 Veracruz de Ignacio de la Llave,159,159 Tehuipango,Total,10,5,5,53
30 Veracruz de Ignacio de la Llave,159,159 Tehuipango,Total,11,10,1,67
30 Veracruz de Ignacio de la Llave,159,159 Tehuipango,Hombres,4840,3790,1050,2363
30 Veracruz de Ignacio de la Llave,159,159 Tehuipango,Hombres,75,42,33,792
30 Veracruz de Ignacio de la Llave,159,159 Tehuipango,Hombres,635,429,206,701
30 Veracruz de Ignacio de la Llave,159,159 Tehuipango,Hombres,806,615,191,175
30 Veracruz de Ignacio de la Llave,159,159 Tehuipango,Hombres,650,516,134,118
30 Veracruz de Ignacio de la Llave,159,159 Tehuipango,Hombres,616,497,119,93
30 Veracruz de Ignacio de la Llave,159,159 Tehuipango,Hombres,510,419,91,84
30 Veracruz de Ignacio de la Llave,159,159 Tehuipango,Hombres,396,333,63,68
30 Veracruz de Ignacio de la Llave,159,159 Tehuipango,Hombres,350,284,66,62
30 Veracruz de Ignacio de la Llave,159,159 Tehuipango,Hombres,232,192,40,43
30 Veracruz de Ignacio de la Llave,159,159 Tehuipango,Hombres,217,182,35,42
30 Veracruz de Ignacio de la Llave,159,159 Tehuipango,Hombres,158,129,29,46
30 Veracruz de Ignacio de la Llave,159,159 Tehuipango,Hombres,79,63,16,33
30 Veracruz de Ignacio de la Llave,159,159 Tehuipango,Hombres,61,47,14,36
30 Veracruz de Ignacio de la Llave,159,159 Tehuipango,Hombres,35,28,7,28
30 Veracruz de Ignacio de la Llave,159,159 Tehuipango,Hombres,10,5,5,17
30 Veracruz de Ignacio de la Llave,159,159 Tehuipango,Hombres,10,9,1,25
30 Veracruz de Ignacio de la Llave,159,159 Tehuipango,Mujeres,355,334,21,7650
30 Veracruz de Ignacio de la Llave,159,159 Tehuipango,Mujeres,6,4,2,892
30 Veracruz de Ignacio de la Llave,159,159 Tehuipango,Mujeres,46,41,5,1294
30 Veracruz de Ignacio de la Llave,159,159 Tehuipango,Mujeres,69,63,6,970
30 Veracruz de Ignacio de la Llave,159,159 Tehuipango,Mujeres,48,46,2,875
30 Veracruz de Ignacio de la Llave,159,159 Tehuipango,Mujeres,44,42,2,774
30 Veracruz de Ignacio de la Llave,159,159 Tehuipango,Mujeres,36,34,2,657
30 Veracruz de Ignacio de la Llave,159,159 Tehuipango,Mujeres,31,30,1,475
30 Veracruz de Ignacio de la Llave,159,159 Tehuipango,Mujeres,26,25,1,443
30 Veracruz de Ignacio de la Llave,159,159 Tehuipango,Mujeres,17,17,0,318
30 Veracruz de Ignacio de la Llave,159,159 Tehuipango,Mujeres,18,18,0,281
30 Veracruz de Ignacio de la Llave,159,159 Tehuipango,Mujeres,8,8,0,228
30 Veracruz de Ignacio de la Llave,159,159 Tehuipango,Mujeres,3,3,0,172
30 Veracruz de Ignacio de la Llave,159,159 Tehuipango,Mujeres,2,2,0,126
30 Veracruz de Ignacio de la Llave,159,159 Tehuipango,Mujeres,0,0,0,67
30 Veracruz de Ignacio de la Llave,159,159 Tehuipango,Mujeres,0,0,0,36
30 Veracruz de Ignacio de la Llave,159,159 Tehuipango,Mujeres,1,1,0,42
30 Veracruz de Ignacio de la Llave,161,161 Tempoal,Total,11961,11700,261,14743
30 Veracruz de Ignacio de la Llave,161,161 Tempoal,Total,74,70,4,2312
30 Veracruz de Ignacio de la Llave,161,161 Tempoal,Total,920,879,41,2951
30 Veracruz de Ignacio de la Llave,161,161 Tempoal,Total,1229,1184,45,1115
30 Veracruz de Ignacio de la Llave,161,161 Tempoal,Total,1094,1064,30,866
30 Veracruz de Ignacio de la Llave,161,161 Tempoal,Total,1169,1146,23,888
30 Veracruz de Ignacio de la Llave,161,161 Tempoal,Total,1312,1296,16,921
30 Veracruz de Ignacio de la Llave,161,161 Tempoal,Total,1307,1287,20,874
30 Veracruz de Ignacio de la Llave,161,161 Tempoal,Total,1100,1086,14,802
30 Veracruz de Ignacio de la Llave,161,161 Tempoal,Total,964,945,19,759
30 Veracruz de Ignacio de la Llave,161,161 Tempoal,Total,829,818,11,657
30 Veracruz de Ignacio de la Llave,161,161 Tempoal,Total,670,656,14,635
30 Veracruz de Ignacio de la Llave,161,161 Tempoal,Total,527,520,7,523
30 Veracruz de Ignacio de la Llave,161,161 Tempoal,Total,405,397,8,534
30 Veracruz de Ignacio de la Llave,161,161 Tempoal,Total,218,212,6,399
30 Veracruz de Ignacio de la Llave,161,161 Tempoal,Total,85,85,0,264
30 Veracruz de Ignacio de la Llave,161,161 Tempoal,Total,58,55,3,243
30 Veracruz de Ignacio de la Llave,161,161 Tempoal,Hombres,9625,9397,228,3532
30 Veracruz de Ignacio de la Llave,161,161 Tempoal,Hombres,56,52,4,1179
30 Veracruz de Ignacio de la Llave,161,161 Tempoal,Hombres,703,671,32,1322
30 Veracruz de Ignacio de la Llave,161,161 Tempoal,Hombres,915,884,31,230
30 Veracruz de Ignacio de la Llave,161,161 Tempoal,Hombres,816,789,27,48
30 Veracruz de Ignacio de la Llave,161,161 Tempoal,Hombres,897,876,21,34
30 Veracruz de Ignacio de la Llave,161,161 Tempoal,Hombres,1023,1009,14,33
30 Veracruz de Ignacio de la Llave,161,161 Tempoal,Hombres,1026,1006,20,33
30 Veracruz de Ignacio de la Llave,161,161 Tempoal,Hombres,892,878,14,31
30 Veracruz de Ignacio de la Llave,161,161 Tempoal,Hombres,810,793,17,46
30 Veracruz de Ignacio de la Llave,161,161 Tempoal,Hombres,708,698,10,52
30 Veracruz de Ignacio de la Llave,161,161 Tempoal,Hombres,576,562,14,77
30 Veracruz de Ignacio de la Llave,161,161 Tempoal,Hombres,487,480,7,65
30 Veracruz de Ignacio de la Llave,161,161 Tempoal,Hombres,370,362,8,103
30 Veracruz de Ignacio de la Llave,161,161 Tempoal,Hombres,210,204,6,122
30 Veracruz de Ignacio de la Llave,161,161 Tempoal,Hombres,81,81,0,68
30 Veracruz de Ignacio de la Llave,161,161 Tempoal,Hombres,55,52,3,89
30 Veracruz de Ignacio de la Llave,161,161 Tempoal,Mujeres,2336,2303,33,11211
30 Veracruz de Ignacio de la Llave,161,161 Tempoal,Mujeres,18,18,0,1133
30 Veracruz de Ignacio de la Llave,161,161 Tempoal,Mujeres,217,208,9,1629
30 Veracruz de Ignacio de la Llave,161,161 Tempoal,Mujeres,314,300,14,885
30 Veracruz de Ignacio de la Llave,161,161 Tempoal,Mujeres,278,275,3,818
30 Veracruz de Ignacio de la Llave,161,161 Tempoal,Mujeres,272,270,2,854
30 Veracruz de Ignacio de la Llave,161,161 Tempoal,Mujeres,289,287,2,888
30 Veracruz de Ignacio de la Llave,161,161 Tempoal,Mujeres,281,281,0,841
30 Veracruz de Ignacio de la Llave,161,161 Tempoal,Mujeres,208,208,0,771
30 Veracruz de Ignacio de la Llave,161,161 Tempoal,Mujeres,154,152,2,713
30 Veracruz de Ignacio de la Llave,161,161 Tempoal,Mujeres,121,120,1,605
30 Veracruz de Ignacio de la Llave,161,161 Tempoal,Mujeres,94,94,0,558
30 Veracruz de Ignacio de la Llave,161,161 Tempoal,Mujeres,40,40,0,458
30 Veracruz de Ignacio de la Llave,161,161 Tempoal,Mujeres,35,35,0,431
30 Veracruz de Ignacio de la Llave,161,161 Tempoal,Mujeres,8,8,0,277
30 Veracruz de Ignacio de la Llave,161,161 Tempoal,Mujeres,4,4,0,196
30 Veracruz de Ignacio de la Llave,161,161 Tempoal,Mujeres,3,3,0,154
30 Veracruz de Ignacio de la Llave,162,162 Tenampa,Total,2209,2160,49,2508
30 Veracruz de Ignacio de la Llave,162,162 Tenampa,Total,33,32,1,380
30 Veracruz de Ignacio de la Llave,162,162 Tenampa,Total,225,217,8,432
30 Veracruz de Ignacio de la Llave,162,162 Tenampa,Total,337,325,12,283
30 Veracruz de Ignacio de la Llave,162,162 Tenampa,Total,257,250,7,248
30 Veracruz de Ignacio de la Llave,162,162 Tenampa,Total,238,235,3,215
30 Veracruz de Ignacio de la Llave,162,162 Tenampa,Total,232,227,5,175
30 Veracruz de Ignacio de la Llave,162,162 Tenampa,Total,167,165,2,142
30 Veracruz de Ignacio de la Llave,162,162 Tenampa,Total,183,177,6,130
30 Veracruz de Ignacio de la Llave,162,162 Tenampa,Total,147,144,3,116
30 Veracruz de Ignacio de la Llave,162,162 Tenampa,Total,122,122,0,99
30 Veracruz de Ignacio de la Llave,162,162 Tenampa,Total,95,93,2,72
30 Veracruz de Ignacio de la Llave,162,162 Tenampa,Total,73,73,0,66
30 Veracruz de Ignacio de la Llave,162,162 Tenampa,Total,62,62,0,56
30 Veracruz de Ignacio de la Llave,162,162 Tenampa,Total,27,27,0,45
30 Veracruz de Ignacio de la Llave,162,162 Tenampa,Total,10,10,0,21
30 Veracruz de Ignacio de la Llave,162,162 Tenampa,Total,1,1,0,28
30 Veracruz de Ignacio de la Llave,162,162 Tenampa,Hombres,1826,1779,47,444
30 Veracruz de Ignacio de la Llave,162,162 Tenampa,Hombres,27,26,1,171
30 Veracruz de Ignacio de la Llave,162,162 Tenampa,Hombres,188,180,8,125
30 Veracruz de Ignacio de la Llave,162,162 Tenampa,Hombres,252,242,10,26
30 Veracruz de Ignacio de la Llave,162,162 Tenampa,Hombres,215,208,7,12
30 Veracruz de Ignacio de la Llave,162,162 Tenampa,Hombres,192,189,3,18
30 Veracruz de Ignacio de la Llave,162,162 Tenampa,Hombres,184,179,5,6
30 Veracruz de Ignacio de la Llave,162,162 Tenampa,Hombres,143,141,2,6
30 Veracruz de Ignacio de la Llave,162,162 Tenampa,Hombres,158,152,6,4
30 Veracruz de Ignacio de la Llave,162,162 Tenampa,Hombres,125,122,3,7
30 Veracruz de Ignacio de la Llave,162,162 Tenampa,Hombres,103,103,0,9
30 Veracruz de Ignacio de la Llave,162,162 Tenampa,Hombres,89,87,2,5
30 Veracruz de Ignacio de la Llave,162,162 Tenampa,Hombres,65,65,0,9
30 Veracruz de Ignacio de la Llave,162,162 Tenampa,Hombres,50,50,0,12
30 Veracruz de Ignacio de la Llave,162,162 Tenampa,Hombres,27,27,0,12
30 Veracruz de Ignacio de la Llave,162,162 Tenampa,Hombres,7,7,0,10
30 Veracruz de Ignacio de la Llave,162,162 Tenampa,Hombres,1,1,0,12
30 Veracruz de Ignacio de la Llave,162,162 Tenampa,Mujeres,383,381,2,2064
30 Veracruz de Ignacio de la Llave,162,162 Tenampa,Mujeres,6,6,0,209
30 Veracruz de Ignacio de la Llave,162,162 Tenampa,Mujeres,37,37,0,307
30 Veracruz de Ignacio de la Llave,162,162 Tenampa,Mujeres,85,83,2,257
30 Veracruz de Ignacio de la Llave,162,162 Tenampa,Mujeres,42,42,0,236
30 Veracruz de Ignacio de la Llave,162,162 Tenampa,Mujeres,46,46,0,197
30 Veracruz de Ignacio de la Llave,162,162 Tenampa,Mujeres,48,48,0,169
30 Veracruz de Ignacio de la Llave,162,162 Tenampa,Mujeres,24,24,0,136
30 Veracruz de Ignacio de la Llave,162,162 Tenampa,Mujeres,25,25,0,126
30 Veracruz de Ignacio de la Llave,162,162 Tenampa,Mujeres,22,22,0,109
30 Veracruz de Ignacio de la Llave,162,162 Tenampa,Mujeres,19,19,0,90
30 Veracruz de Ignacio de la Llave,162,162 Tenampa,Mujeres,6,6,0,67
30 Veracruz de Ignacio de la Llave,162,162 Tenampa,Mujeres,8,8,0,57
30 Veracruz de Ignacio de la Llave,162,162 Tenampa,Mujeres,12,12,0,44
30 Veracruz de Ignacio de la Llave,162,162 Tenampa,Mujeres,0,0,0,33
30 Veracruz de Ignacio de la Llave,162,162 Tenampa,Mujeres,3,3,0,11
30 Veracruz de Ignacio de la Llave,162,162 Tenampa,Mujeres,0,0,0,16
30 Veracruz de Ignacio de la Llave,163,163 Tenochtitlán,Total,1323,1218,105,2389
30 Veracruz de Ignacio de la Llave,163,163 Tenochtitlán,Total,22,21,1,371
30 Veracruz de Ignacio de la Llave,163,163 Tenochtitlán,Total,113,104,9,417
30 Veracruz de Ignacio de la Llave,163,163 Tenochtitlán,Total,141,124,17,200
30 Veracruz de Ignacio de la Llave,163,163 Tenochtitlán,Total,131,118,13,171
30 Veracruz de Ignacio de la Llave,163,163 Tenochtitlán,Total,171,160,11,188
30 Veracruz de Ignacio de la Llave,163,163 Tenochtitlán,Total,156,142,14,169
30 Veracruz de Ignacio de la Llave,163,163 Tenochtitlán,Total,143,131,12,150
30 Veracruz de Ignacio de la Llave,163,163 Tenochtitlán,Total,123,116,7,133
30 Veracruz de Ignacio de la Llave,163,163 Tenochtitlán,Total,83,75,8,122
30 Veracruz de Ignacio de la Llave,163,163 Tenochtitlán,Total,71,64,7,109
30 Veracruz de Ignacio de la Llave,163,163 Tenochtitlán,Total,70,68,2,93
30 Veracruz de Ignacio de la Llave,163,163 Tenochtitlán,Total,53,51,2,74
30 Veracruz de Ignacio de la Llave,163,163 Tenochtitlán,Total,26,25,1,70
30 Veracruz de Ignacio de la Llave,163,163 Tenochtitlán,Total,12,11,1,64
30 Veracruz de Ignacio de la Llave,163,163 Tenochtitlán,Total,3,3,0,25
30 Veracruz de Ignacio de la Llave,163,163 Tenochtitlán,Total,5,5,0,33
30 Veracruz de Ignacio de la Llave,163,163 Tenochtitlán,Hombres,1113,1011,102,618
30 Veracruz de Ignacio de la Llave,163,163 Tenochtitlán,Hombres,17,16,1,177
30 Veracruz de Ignacio de la Llave,163,163 Tenochtitlán,Hombres,101,92,9,155
30 Veracruz de Ignacio de la Llave,163,163 Tenochtitlán,Hombres,105,90,15,35
30 Veracruz de Ignacio de la Llave,163,163 Tenochtitlán,Hombres,104,92,12,33
30 Veracruz de Ignacio de la Llave,163,163 Tenochtitlán,Hombres,138,127,11,29
30 Veracruz de Ignacio de la Llave,163,163 Tenochtitlán,Hombres,130,116,14,19
30 Veracruz de Ignacio de la Llave,163,163 Tenochtitlán,Hombres,125,113,12,22
30 Veracruz de Ignacio de la Llave,163,163 Tenochtitlán,Hombres,109,102,7,18
30 Veracruz de Ignacio de la Llave,163,163 Tenochtitlán,Hombres,66,58,8,22
30 Veracruz de Ignacio de la Llave,163,163 Tenochtitlán,Hombres,65,58,7,16
30 Veracruz de Ignacio de la Llave,163,163 Tenochtitlán,Hombres,61,59,2,20
30 Veracruz de Ignacio de la Llave,163,163 Tenochtitlán,Hombres,48,46,2,16
30 Veracruz de Ignacio de la Llave,163,163 Tenochtitlán,Hombres,24,23,1,10
30 Veracruz de Ignacio de la Llave,163,163 Tenochtitlán,Hombres,12,11,1,20
30 Veracruz de Ignacio de la Llave,163,163 Tenochtitlán,Hombres,3,3,0,14
30 Veracruz de Ignacio de la Llave,163,163 Tenochtitlán,Hombres,5,5,0,12
30 Veracruz de Ignacio de la Llave,163,163 Tenochtitlán,Mujeres,210,207,3,1771
30 Veracruz de Ignacio de la Llave,163,163 Tenochtitlán,Mujeres,5,5,0,194
30 Veracruz de Ignacio de la Llave,163,163 Tenochtitlán,Mujeres,12,12,0,262
30 Veracruz de Ignacio de la Llave,163,163 Tenochtitlán,Mujeres,36,34,2,165
30 Veracruz de Ignacio de la Llave,163,163 Tenochtitlán,Mujeres,27,26,1,138
30 Veracruz de Ignacio de la Llave,163,163 Tenochtitlán,Mujeres,33,33,0,159
30 Veracruz de Ignacio de la Llave,163,163 Tenochtitlán,Mujeres,26,26,0,150
30 Veracruz de Ignacio de la Llave,163,163 Tenochtitlán,Mujeres,18,18,0,128
30 Veracruz de Ignacio de la Llave,163,163 Tenochtitlán,Mujeres,14,14,0,115
30 Veracruz de Ignacio de la Llave,163,163 Tenochtitlán,Mujeres,17,17,0,100
30 Veracruz de Ignacio de la Llave,163,163 Tenochtitlán,Mujeres,6,6,0,93
30 Veracruz de Ignacio de la Llave,163,163 Tenochtitlán,Mujeres,9,9,0,73
30 Veracruz de Ignacio de la Llave,163,163 Tenochtitlán,Mujeres,5,5,0,58
30 Veracruz de Ignacio de la Llave,163,163 Tenochtitlán,Mujeres,2,2,0,60
30 Veracruz de Ignacio de la Llave,163,163 Tenochtitlán,Mujeres,0,0,0,44
30 Veracruz de Ignacio de la Llave,163,163 Tenochtitlán,Mujeres,0,0,0,11
30 Veracruz de Ignacio de la Llave,163,163 Tenochtitlán,Mujeres,0,0,0,21
30 Veracruz de Ignacio de la Llave,164,164 Teocelo,Total,6952,6770,182,5632
30 Veracruz de Ignacio de la Llave,164,164 Teocelo,Total,74,73,1,875
30 Veracruz de Ignacio de la Llave,164,164 Teocelo,Total,475,445,30,1026
30 Veracruz de Ignacio de la Llave,164,164 Teocelo,Total,825,790,35,622
30 Veracruz de Ignacio de la Llave,164,164 Teocelo,Total,837,816,21,395
30 Veracruz de Ignacio de la Llave,164,164 Teocelo,Total,881,858,23,390
30 Veracruz de Ignacio de la Llave,164,164 Teocelo,Total,800,789,11,347
30 Veracruz de Ignacio de la Llave,164,164 Teocelo,Total,717,705,12,273
30 Veracruz de Ignacio de la Llave,164,164 Teocelo,Total,577,565,12,257
30 Veracruz de Ignacio de la Llave,164,164 Teocelo,Total,514,506,8,224
30 Veracruz de Ignacio de la Llave,164,164 Teocelo,Total,408,396,12,225
30 Veracruz de Ignacio de la Llave,164,164 Teocelo,Total,283,278,5,225
30 Veracruz de Ignacio de la Llave,164,164 Teocelo,Total,190,185,5,210
30 Veracruz de Ignacio de la Llave,164,164 Teocelo,Total,165,161,4,179
30 Veracruz de Ignacio de la Llave,164,164 Teocelo,Total,117,115,2,158
30 Veracruz de Ignacio de la Llave,164,164 Teocelo,Total,61,60,1,113
30 Veracruz de Ignacio de la Llave,164,164 Teocelo,Total,28,28,0,113
30 Veracruz de Ignacio de la Llave,164,164 Teocelo,Hombres,4754,4602,152,1305
30 Veracruz de Ignacio de la Llave,164,164 Teocelo,Hombres,63,62,1,421
30 Veracruz de Ignacio de la Llave,164,164 Teocelo,Hombres,348,319,29,397
30 Veracruz de Ignacio de la Llave,164,164 Teocelo,Hombres,578,552,26,139
30 Veracruz de Ignacio de la Llave,164,164 Teocelo,Hombres,557,540,17,18
30 Veracruz de Ignacio de la Llave,164,164 Teocelo,Hombres,593,577,16,22
30 Veracruz de Ignacio de la Llave,164,164 Teocelo,Hombres,525,514,11,13
30 Veracruz de Ignacio de la Llave,164,164 Teocelo,Hombres,452,441,11,17
30 Veracruz de Ignacio de la Llave,164,164 Teocelo,Hombres,361,353,8,14
30 Veracruz de Ignacio de la Llave,164,164 Teocelo,Hombres,360,352,8,24
30 Veracruz de Ignacio de la Llave,164,164 Teocelo,Hombres,287,277,10,20
30 Veracruz de Ignacio de la Llave,164,164 Teocelo,Hombres,209,204,5,30
30 Veracruz de Ignacio de la Llave,164,164 Teocelo,Hombres,132,128,4,36
30 Veracruz de Ignacio de la Llave,164,164 Teocelo,Hombres,124,121,3,48
30 Veracruz de Ignacio de la Llave,164,164 Teocelo,Hombres,93,91,2,34
30 Veracruz de Ignacio de la Llave,164,164 Teocelo,Hombres,52,51,1,34
30 Veracruz de Ignacio de la Llave,164,164 Teocelo,Hombres,20,20,0,38
30 Veracruz de Ignacio de la Llave,164,164 Teocelo,Mujeres,2198,2168,30,4327
30 Veracruz de Ignacio de la Llave,164,164 Teocelo,Mujeres,11,11,0,454
30 Veracruz de Ignacio de la Llave,164,164 Teocelo,Mujeres,127,126,1,629
30 Veracruz de Ignacio de la Llave,164,164 Teocelo,Mujeres,247,238,9,483
30 Veracruz de Ignacio de la Llave,164,164 Teocelo,Mujeres,280,276,4,377
30 Veracruz de Ignacio de la Llave,164,164 Teocelo,Mujeres,288,281,7,368
30 Veracruz de Ignacio de la Llave,164,164 Teocelo,Mujeres,275,275,0,334
30 Veracruz de Ignacio de la Llave,164,164 Teocelo,Mujeres,265,264,1,256
30 Veracruz de Ignacio de la Llave,164,164 Teocelo,Mujeres,216,212,4,243
30 Veracruz de Ignacio de la Llave,164,164 Teocelo,Mujeres,154,154,0,200
30 Veracruz de Ignacio de la Llave,164,164 Teocelo,Mujeres,121,119,2,205
30 Veracruz de Ignacio de la Llave,164,164 Teocelo,Mujeres,74,74,0,195
30 Veracruz de Ignacio de la Llave,164,164 Teocelo,Mujeres,58,57,1,174
30 Veracruz de Ignacio de la Llave,164,164 Teocelo,Mujeres,41,40,1,131
30 Veracruz de Ignacio de la Llave,164,164 Teocelo,Mujeres,24,24,0,124
30 Veracruz de Ignacio de la Llave,164,164 Teocelo,Mujeres,9,9,0,79
30 Veracruz de Ignacio de la Llave,164,164 Teocelo,Mujeres,8,8,0,75
30 Veracruz de Ignacio de la Llave,165,165 Tepatlaxco,Total,2884,2862,22,3233
30 Veracruz de Ignacio de la Llave,165,165 Tepatlaxco,Total,55,52,3,486
30 Veracruz de Ignacio de la Llave,165,165 Tepatlaxco,Total,279,276,3,555
30 Veracruz de Ignacio de la Llave,165,165 Tepatlaxco,Total,445,441,4,354
30 Veracruz de Ignacio de la Llave,165,165 Tepatlaxco,Total,341,338,3,276
30 Veracruz de Ignacio de la Llave,165,165 Tepatlaxco,Total,314,311,3,264
30 Veracruz de Ignacio de la Llave,165,165 Tepatlaxco,Total,327,325,2,218
30 Veracruz de Ignacio de la Llave,165,165 Tepatlaxco,Total,247,246,1,209
30 Veracruz de Ignacio de la Llave,165,165 Tepatlaxco,Total,218,218,0,167
30 Veracruz de Ignacio de la Llave,165,165 Tepatlaxco,Total,146,144,2,140
30 Veracruz de Ignacio de la Llave,165,165 Tepatlaxco,Total,167,167,0,131
30 Veracruz de Ignacio de la Llave,165,165 Tepatlaxco,Total,109,109,0,90
30 Veracruz de Ignacio de la Llave,165,165 Tepatlaxco,Total,89,89,0,89
30 Veracruz de Ignacio de la Llave,165,165 Tepatlaxco,Total,71,70,1,85
30 Veracruz de Ignacio de la Llave,165,165 Tepatlaxco,Total,50,50,0,62
30 Veracruz de Ignacio de la Llave,165,165 Tepatlaxco,Total,18,18,0,61
30 Veracruz de Ignacio de la Llave,165,165 Tepatlaxco,Total,8,8,0,46
30 Veracruz de Ignacio de la Llave,165,165 Tepatlaxco,Hombres,2522,2501,21,598
30 Veracruz de Ignacio de la Llave,165,165 Tepatlaxco,Hombres,52,49,3,231
30 Veracruz de Ignacio de la Llave,165,165 Tepatlaxco,Hombres,240,237,3,177
30 Veracruz de Ignacio de la Llave,165,165 Tepatlaxco,Hombres,378,374,4,34
30 Veracruz de Ignacio de la Llave,165,165 Tepatlaxco,Hombres,288,286,2,13
30 Veracruz de Ignacio de la Llave,165,165 Tepatlaxco,Hombres,269,266,3,7
30 Veracruz de Ignacio de la Llave,165,165 Tepatlaxco,Hombres,284,282,2,9
30 Veracruz de Ignacio de la Llave,165,165 Tepatlaxco,Hombres,220,219,1,9
30 Veracruz de Ignacio de la Llave,165,165 Tepatlaxco,Hombres,187,187,0,11
30 Veracruz de Ignacio de la Llave,165,165 Tepatlaxco,Hombres,127,125,2,9
30 Veracruz de Ignacio de la Llave,165,165 Tepatlaxco,Hombres,155,155,0,10
30 Veracruz de Ignacio de la Llave,165,165 Tepatlaxco,Hombres,97,97,0,11
30 Veracruz de Ignacio de la Llave,165,165 Tepatlaxco,Hombres,83,83,0,10
30 Veracruz de Ignacio de la Llave,165,165 Tepatlaxco,Hombres,68,67,1,14
30 Veracruz de Ignacio de la Llave,165,165 Tepatlaxco,Hombres,49,49,0,16
30 Veracruz de Ignacio de la Llave,165,165 Tepatlaxco,Hombres,17,17,0,22
30 Veracruz de Ignacio de la Llave,165,165 Tepatlaxco,Hombres,8,8,0,15
30 Veracruz de Ignacio de la Llave,165,165 Tepatlaxco,Mujeres,362,361,1,2635
30 Veracruz de Ignacio de la Llave,165,165 Tepatlaxco,Mujeres,3,3,0,255
30 Veracruz de Ignacio de la Llave,165,165 Tepatlaxco,Mujeres,39,39,0,378
30 Veracruz de Ignacio de la Llave,165,165 Tepatlaxco,Mujeres,67,67,0,320
30 Veracruz de Ignacio de la Llave,165,165 Tepatlaxco,Mujeres,53,52,1,263
30 Veracruz de Ignacio de la Llave,165,165 Tepatlaxco,Mujeres,45,45,0,257
30 Veracruz de Ignacio de la Llave,165,165 Tepatlaxco,Mujeres,43,43,0,209
30 Veracruz de Ignacio de la Llave,165,165 Tepatlaxco,Mujeres,27,27,0,200
30 Veracruz de Ignacio de la Llave,165,165 Tepatlaxco,Mujeres,31,31,0,156
30 Veracruz de Ignacio de la Llave,165,165 Tepatlaxco,Mujeres,19,19,0,131
30 Veracruz de Ignacio de la Llave,165,165 Tepatlaxco,Mujeres,12,12,0,121
30 Veracruz de Ignacio de la Llave,165,165 Tepatlaxco,Mujeres,12,12,0,79
30 Veracruz de Ignacio de la Llave,165,165 Tepatlaxco,Mujeres,6,6,0,79
30 Veracruz de Ignacio de la Llave,165,165 Tepatlaxco,Mujeres,3,3,0,71
30 Veracruz de Ignacio de la Llave,165,165 Tepatlaxco,Mujeres,1,1,0,46
30 Veracruz de Ignacio de la Llave,165,165 Tepatlaxco,Mujeres,1,1,0,39
30 Veracruz de Ignacio de la Llave,165,165 Tepatlaxco,Mujeres,0,0,0,31
30 Veracruz de Ignacio de la Llave,166,166 Tepetlán,Total,3115,2967,148,3894
30 Veracruz de Ignacio de la Llave,166,166 Tepetlán,Total,45,39,6,505
30 Veracruz de Ignacio de la Llave,166,166 Tepetlán,Total,326,305,21,559
30 Veracruz de Ignacio de la Llave,166,166 Tepetlán,Total,399,372,27,347
30 Veracruz de Ignacio de la Llave,166,166 Tepetlán,Total,322,316,6,323
30 Veracruz de Ignacio de la Llave,166,166 Tepetlán,Total,376,359,17,348
30 Veracruz de Ignacio de la Llave,166,166 Tepetlán,Total,377,360,17,312
30 Veracruz de Ignacio de la Llave,166,166 Tepetlán,Total,277,271,6,251
30 Veracruz de Ignacio de la Llave,166,166 Tepetlán,Total,256,240,16,234
30 Veracruz de Ignacio de la Llave,166,166 Tepetlán,Total,202,197,5,197
30 Veracruz de Ignacio de la Llave,166,166 Tepetlán,Total,157,151,6,150
30 Veracruz de Ignacio de la Llave,166,166 Tepetlán,Total,132,124,8,167
30 Veracruz de Ignacio de la Llave,166,166 Tepetlán,Total,92,86,6,138
30 Veracruz de Ignacio de la Llave,166,166 Tepetlán,Total,66,61,5,138
30 Veracruz de Ignacio de la Llave,166,166 Tepetlán,Total,54,52,2,87
30 Veracruz de Ignacio de la Llave,166,166 Tepetlán,Total,18,18,0,65
30 Veracruz de Ignacio de la Llave,166,166 Tepetlán,Total,16,16,0,73
30 Veracruz de Ignacio de la Llave,166,166 Tepetlán,Hombres,2871,2724,147,648
30 Veracruz de Ignacio de la Llave,166,166 Tepetlán,Hombres,42,36,6,253
30 Veracruz de Ignacio de la Llave,166,166 Tepetlán,Hombres,294,273,21,163
30 Veracruz de Ignacio de la Llave,166,166 Tepetlán,Hombres,337,311,26,26
30 Veracruz de Ignacio de la Llave,166,166 Tepetlán,Hombres,292,286,6,11
30 Veracruz de Ignacio de la Llave,166,166 Tepetlán,Hombres,341,324,17,8
30 Veracruz de Ignacio de la Llave,166,166 Tepetlán,Hombres,347,330,17,9
30 Veracruz de Ignacio de la Llave,166,166 Tepetlán,Hombres,261,255,6,7
30 Veracruz de Ignacio de la Llave,166,166 Tepetlán,Hombres,240,224,16,12
30 Veracruz de Ignacio de la Llave,166,166 Tepetlán,Hombres,194,189,5,7
30 Veracruz de Ignacio de la Llave,166,166 Tepetlán,Hombres,154,148,6,10
30 Veracruz de Ignacio de la Llave,166,166 Tepetlán,Hombres,128,120,8,22
30 Veracruz de Ignacio de la Llave,166,166 Tepetlán,Hombres,91,85,6,21
30 Veracruz de Ignacio de la Llave,166,166 Tepetlán,Hombres,65,60,5,23
30 Veracruz de Ignacio de la Llave,166,166 Tepetlán,Hombres,52,50,2,21
30 Veracruz de Ignacio de la Llave,166,166 Tepetlán,Hombres,18,18,0,20
30 Veracruz de Ignacio de la Llave,166,166 Tepetlán,Hombres,15,15,0,35
30 Veracruz de Ignacio de la Llave,166,166 Tepetlán,Mujeres,244,243,1,3246
30 Veracruz de Ignacio de la Llave,166,166 Tepetlán,Mujeres,3,3,0,252
30 Veracruz de Ignacio de la Llave,166,166 Tepetlán,Mujeres,32,32,0,396
30 Veracruz de Ignacio de la Llave,166,166 Tepetlán,Mujeres,62,61,1,321
30 Veracruz de Ignacio de la Llave,166,166 Tepetlán,Mujeres,30,30,0,312
30 Veracruz de Ignacio de la Llave,166,166 Tepetlán,Mujeres,35,35,0,340
30 Veracruz de Ignacio de la Llave,166,166 Tepetlán,Mujeres,30,30,0,303
30 Veracruz de Ignacio de la Llave,166,166 Tepetlán,Mujeres,16,16,0,244
30 Veracruz de Ignacio de la Llave,166,166 Tepetlán,Mujeres,16,16,0,222
30 Veracruz de Ignacio de la Llave,166,166 Tepetlán,Mujeres,8,8,0,190
30 Veracruz de Ignacio de la Llave,166,166 Tepetlán,Mujeres,3,3,0,140
30 Veracruz de Ignacio de la Llave,166,166 Tepetlán,Mujeres,4,4,0,145
30 Veracruz de Ignacio de la Llave,166,166 Tepetlán,Mujeres,1,1,0,117
30 Veracruz de Ignacio de la Llave,166,166 Tepetlán,Mujeres,1,1,0,115
30 Veracruz de Ignacio de la Llave,166,166 Tepetlán,Mujeres,2,2,0,66
30 Veracruz de Ignacio de la Llave,166,166 Tepetlán,Mujeres,0,0,0,45
30 Veracruz de Ignacio de la Llave,166,166 Tepetlán,Mujeres,1,1,0,38
30 Veracruz de Ignacio de la Llave,167,167 Tepetzintla,Total,4942,4871,71,5848
30 Veracruz de Ignacio de la Llave,167,167 Tepetzintla,Total,62,62,0,949
30 Veracruz de Ignacio de la Llave,167,167 Tepetzintla,Total,434,422,12,1216
30 Veracruz de Ignacio de la Llave,167,167 Tepetzintla,Total,474,456,18,457
30 Veracruz de Ignacio de la Llave,167,167 Tepetzintla,Total,488,481,7,331
30 Veracruz de Ignacio de la Llave,167,167 Tepetzintla,Total,470,462,8,310
30 Veracruz de Ignacio de la Llave,167,167 Tepetzintla,Total,537,533,4,371
30 Veracruz de Ignacio de la Llave,167,167 Tepetzintla,Total,547,541,6,370
30 Veracruz de Ignacio de la Llave,167,167 Tepetzintla,Total,461,455,6,285
30 Veracruz de Ignacio de la Llave,167,167 Tepetzintla,Total,383,377,6,313
30 Veracruz de Ignacio de la Llave,167,167 Tepetzintla,Total,309,307,2,231
30 Veracruz de Ignacio de la Llave,167,167 Tepetzintla,Total,263,261,2,205
30 Veracruz de Ignacio de la Llave,167,167 Tepetzintla,Total,202,202,0,259
30 Veracruz de Ignacio de la Llave,167,167 Tepetzintla,Total,167,167,0,220
30 Veracruz de Ignacio de la Llave,167,167 Tepetzintla,Total,79,79,0,137
30 Veracruz de Ignacio de la Llave,167,167 Tepetzintla,Total,42,42,0,94
30 Veracruz de Ignacio de la Llave,167,167 Tepetzintla,Total,24,24,0,100
30 Veracruz de Ignacio de la Llave,167,167 Tepetzintla,Hombres,3854,3795,59,1440
30 Veracruz de Ignacio de la Llave,167,167 Tepetzintla,Hombres,48,48,0,507
30 Veracruz de Ignacio de la Llave,167,167 Tepetzintla,Hombres,328,318,10,523
30 Veracruz de Ignacio de la Llave,167,167 Tepetzintla,Hombres,360,347,13,89
30 Veracruz de Ignacio de la Llave,167,167 Tepetzintla,Hombres,361,355,6,20
30 Veracruz de Ignacio de la Llave,167,167 Tepetzintla,Hombres,358,350,8,19
30 Veracruz de Ignacio de la Llave,167,167 Tepetzintla,Hombres,399,396,3,21
30 Veracruz de Ignacio de la Llave,167,167 Tepetzintla,Hombres,423,418,5,9
30 Veracruz de Ignacio de la Llave,167,167 Tepetzintla,Hombres,358,353,5,16
30 Veracruz de Ignacio de la Llave,167,167 Tepetzintla,Hombres,298,293,5,15
30 Veracruz de Ignacio de la Llave,167,167 Tepetzintla,Hombres,234,232,2,23
30 Veracruz de Ignacio de la Llave,167,167 Tepetzintla,Hombres,228,226,2,20
30 Veracruz de Ignacio de la Llave,167,167 Tepetzintla,Hombres,172,172,0,33
30 Veracruz de Ignacio de la Llave,167,167 Tepetzintla,Hombres,150,150,0,34
30 Veracruz de Ignacio de la Llave,167,167 Tepetzintla,Hombres,72,72,0,41
30 Veracruz de Ignacio de la Llave,167,167 Tepetzintla,Hombres,42,42,0,34
30 Veracruz de Ignacio de la Llave,167,167 Tepetzintla,Hombres,23,23,0,36
30 Veracruz de Ignacio de la Llave,167,167 Tepetzintla,Mujeres,1088,1076,12,4408
30 Veracruz de Ignacio de la Llave,167,167 Tepetzintla,Mujeres,14,14,0,442
30 Veracruz de Ignacio de la Llave,167,167 Tepetzintla,Mujeres,106,104,2,693
30 Veracruz de Ignacio de la Llave,167,167 Tepetzintla,Mujeres,114,109,5,368
30 Veracruz de Ignacio de la Llave,167,167 Tepetzintla,Mujeres,127,126,1,311
30 Veracruz de Ignacio de la Llave,167,167 Tepetzintla,Mujeres,112,112,0,291
30 Veracruz de Ignacio de la Llave,167,167 Tepetzintla,Mujeres,138,137,1,350
30 Veracruz de Ignacio de la Llave,167,167 Tepetzintla,Mujeres,124,123,1,361
30 Veracruz de Ignacio de la Llave,167,167 Tepetzintla,Mujeres,103,102,1,269
30 Veracruz de Ignacio de la Llave,167,167 Tepetzintla,Mujeres,85,84,1,298
30 Veracruz de Ignacio de la Llave,167,167 Tepetzintla,Mujeres,75,75,0,208
30 Veracruz de Ignacio de la Llave,167,167 Tepetzintla,Mujeres,35,35,0,185
30 Veracruz de Ignacio de la Llave,167,167 Tepetzintla,Mujeres,30,30,0,226
30 Veracruz de Ignacio de la Llave,167,167 Tepetzintla,Mujeres,17,17,0,186
30 Veracruz de Ignacio de la Llave,167,167 Tepetzintla,Mujeres,7,7,0,96
30 Veracruz de Ignacio de la Llave,167,167 Tepetzintla,Mujeres,0,0,0,60
30 Veracruz de Ignacio de la Llave,167,167 Tepetzintla,Mujeres,1,1,0,64
30 Veracruz de Ignacio de la Llave,168,168 Tequila,Total,4149,4037,112,5723
30 Veracruz de Ignacio de la Llave,168,168 Tequila,Total,58,53,5,996
30 Veracruz de Ignacio de la Llave,168,168 Tequila,Total,414,397,17,1131
30 Veracruz de Ignacio de la Llave,168,168 Tequila,Total,663,644,19,656
30 Veracruz de Ignacio de la Llave,168,168 Tequila,Total,578,561,17,507
30 Veracruz de Ignacio de la Llave,168,168 Tequila,Total,521,507,14,431
30 Veracruz de Ignacio de la Llave,168,168 Tequila,Total,454,446,8,391
30 Veracruz de Ignacio de la Llave,168,168 Tequila,Total,347,340,7,246
30 Veracruz de Ignacio de la Llave,168,168 Tequila,Total,312,302,10,242
30 Veracruz de Ignacio de la Llave,168,168 Tequila,Total,244,239,5,219
30 Veracruz de Ignacio de la Llave,168,168 Tequila,Total,214,210,4,232
30 Veracruz de Ignacio de la Llave,168,168 Tequila,Total,131,128,3,150
30 Veracruz de Ignacio de la Llave,168,168 Tequila,Total,105,102,3,136
30 Veracruz de Ignacio de la Llave,168,168 Tequila,Total,61,61,0,155
30 Veracruz de Ignacio de la Llave,168,168 Tequila,Total,21,21,0,121
30 Veracruz de Ignacio de la Llave,168,168 Tequila,Total,19,19,0,58
30 Veracruz de Ignacio de la Llave,168,168 Tequila,Total,7,7,0,52
30 Veracruz de Ignacio de la Llave,168,168 Tequila,Hombres,3333,3230,103,1488
30 Veracruz de Ignacio de la Llave,168,168 Tequila,Hombres,53,48,5,494
30 Veracruz de Ignacio de la Llave,168,168 Tequila,Hombres,341,326,15,432
30 Veracruz de Ignacio de la Llave,168,168 Tequila,Hombres,523,507,16,115
30 Veracruz de Ignacio de la Llave,168,168 Tequila,Hombres,463,448,15,46
30 Veracruz de Ignacio de la Llave,168,168 Tequila,Hombres,422,408,14,36
30 Veracruz de Ignacio de la Llave,168,168 Tequila,Hombres,368,361,7,43
30 Veracruz de Ignacio de la Llave,168,168 Tequila,Hombres,271,264,7,27
30 Veracruz de Ignacio de la Llave,168,168 Tequila,Hombres,241,231,10,31
30 Veracruz de Ignacio de la Llave,168,168 Tequila,Hombres,198,193,5,28
30 Veracruz de Ignacio de la Llave,168,168 Tequila,Hombres,182,178,4,37
30 Veracruz de Ignacio de la Llave,168,168 Tequila,Hombres,99,97,2,30
30 Veracruz de Ignacio de la Llave,168,168 Tequila,Hombres,83,80,3,25
30 Veracruz de Ignacio de la Llave,168,168 Tequila,Hombres,49,49,0,51
30 Veracruz de Ignacio de la Llave,168,168 Tequila,Hombres,19,19,0,45
30 Veracruz de Ignacio de la Llave,168,168 Tequila,Hombres,15,15,0,25
30 Veracruz de Ignacio de la Llave,168,168 Tequila,Hombres,6,6,0,23
30 Veracruz de Ignacio de la Llave,168,168 Tequila,Mujeres,816,807,9,4235
30 Veracruz de Ignacio de la Llave,168,168 Tequila,Mujeres,5,5,0,502
30 Veracruz de Ignacio de la Llave,168,168 Tequila,Mujeres,73,71,2,699
30 Veracruz de Ignacio de la Llave,168,168 Tequila,Mujeres,140,137,3,541
30 Veracruz de Ignacio de la Llave,168,168 Tequila,Mujeres,115,113,2,461
30 Veracruz de Ignacio de la Llave,168,168 Tequila,Mujeres,99,99,0,395
30 Veracruz de Ignacio de la Llave,168,168 Tequila,Mujeres,86,85,1,348
30 Veracruz de Ignacio de la Llave,168,168 Tequila,Mujeres,76,76,0,219
30 Veracruz de Ignacio de la Llave,168,168 Tequila,Mujeres,71,71,0,211
30 Veracruz de Ignacio de la Llave,168,168 Tequila,Mujeres,46,46,0,191
30 Veracruz de Ignacio de la Llave,168,168 Tequila,Mujeres,32,32,0,195
30 Veracruz de Ignacio de la Llave,168,168 Tequila,Mujeres,32,31,1,120
30 Veracruz de Ignacio de la Llave,168,168 Tequila,Mujeres,22,22,0,111
30 Veracruz de Ignacio de la Llave,168,168 Tequila,Mujeres,12,12,0,104
30 Veracruz de Ignacio de la Llave,168,168 Tequila,Mujeres,2,2,0,76
30 Veracruz de Ignacio de la Llave,168,168 Tequila,Mujeres,4,4,0,33
30 Veracruz de Ignacio de la Llave,168,168 Tequila,Mujeres,1,1,0,29
30 Veracruz de Ignacio de la Llave,170,170 Texcatepec,Total,2531,2455,76,4639
30 Veracruz de Ignacio de la Llave,170,170 Texcatepec,Total,43,41,2,820
30 Veracruz de Ignacio de la Llave,170,170 Texcatepec,Total,320,295,25,856
30 Veracruz de Ignacio de la Llave,170,170 Texcatepec,Total,308,300,8,474
30 Veracruz de Ignacio de la Llave,170,170 Texcatepec,Total,291,284,7,459
30 Veracruz de Ignacio de la Llave,170,170 Texcatepec,Total,265,254,11,359
30 Veracruz de Ignacio de la Llave,170,170 Texcatepec,Total,250,244,6,294
30 Veracruz de Ignacio de la Llave,170,170 Texcatepec,Total,228,224,4,253
30 Veracruz de Ignacio de la Llave,170,170 Texcatepec,Total,215,212,3,229
30 Veracruz de Ignacio de la Llave,170,170 Texcatepec,Total,168,165,3,207
30 Veracruz de Ignacio de la Llave,170,170 Texcatepec,Total,172,169,3,156
30 Veracruz de Ignacio de la Llave,170,170 Texcatepec,Total,86,86,0,137
30 Veracruz de Ignacio de la Llave,170,170 Texcatepec,Total,62,61,1,101
30 Veracruz de Ignacio de la Llave,170,170 Texcatepec,Total,69,68,1,123
30 Veracruz de Ignacio de la Llave,170,170 Texcatepec,Total,28,28,0,61
30 Veracruz de Ignacio de la Llave,170,170 Texcatepec,Total,18,17,1,58
30 Veracruz de Ignacio de la Llave,170,170 Texcatepec,Total,8,7,1,52
30 Veracruz de Ignacio de la Llave,170,170 Texcatepec,Hombres,2315,2243,72,1120
30 Veracruz de Ignacio de la Llave,170,170 Texcatepec,Hombres,40,38,2,400
30 Veracruz de Ignacio de la Llave,170,170 Texcatepec,Hombres,290,268,22,302
30 Veracruz de Ignacio de la Llave,170,170 Texcatepec,Hombres,269,262,7,73
30 Veracruz de Ignacio de la Llave,170,170 Texcatepec,Hombres,254,247,7,50
30 Veracruz de Ignacio de la Llave,170,170 Texcatepec,Hombres,247,236,11,49
30 Veracruz de Ignacio de la Llave,170,170 Texcatepec,Hombres,232,226,6,27
30 Veracruz de Ignacio de la Llave,170,170 Texcatepec,Hombres,202,198,4,22
30 Veracruz de Ignacio de la Llave,170,170 Texcatepec,Hombres,204,201,3,28
30 Veracruz de Ignacio de la Llave,170,170 Texcatepec,Hombres,157,154,3,26
30 Veracruz de Ignacio de la Llave,170,170 Texcatepec,Hombres,165,162,3,24
30 Veracruz de Ignacio de la Llave,170,170 Texcatepec,Hombres,81,81,0,24
30 Veracruz de Ignacio de la Llave,170,170 Texcatepec,Hombres,58,57,1,22
30 Veracruz de Ignacio de la Llave,170,170 Texcatepec,Hombres,66,65,1,18
30 Veracruz de Ignacio de la Llave,170,170 Texcatepec,Hombres,25,25,0,16
30 Veracruz de Ignacio de la Llave,170,170 Texcatepec,Hombres,17,16,1,18
30 Veracruz de Ignacio de la Llave,170,170 Texcatepec,Hombres,8,7,1,21
30 Veracruz de Ignacio de la Llave,170,170 Texcatepec,Mujeres,216,212,4,3519
30 Veracruz de Ignacio de la Llave,170,170 Texcatepec,Mujeres,3,3,0,420
30 Veracruz de Ignacio de la Llave,170,170 Texcatepec,Mujeres,30,27,3,554
30 Veracruz de Ignacio de la Llave,170,170 Texcatepec,Mujeres,39,38,1,401
30 Veracruz de Ignacio de la Llave,170,170 Texcatepec,Mujeres,37,37,0,409
30 Veracruz de Ignacio de la Llave,170,170 Texcatepec,Mujeres,18,18,0,310
30 Veracruz de Ignacio de la Llave,170,170 Texcatepec,Mujeres,18,18,0,267
30 Veracruz de Ignacio de la Llave,170,170 Texcatepec,Mujeres,26,26,0,231
30 Veracruz de Ignacio de la Llave,170,170 Texcatepec,Mujeres,11,11,0,201
30 Veracruz de Ignacio de la Llave,170,170 Texcatepec,Mujeres,11,11,0,181
30 Veracruz de Ignacio de la Llave,170,170 Texcatepec,Mujeres,7,7,0,132
30 Veracruz de Ignacio de la Llave,170,170 Texcatepec,Mujeres,5,5,0,113
30 Veracruz de Ignacio de la Llave,170,170 Texcatepec,Mujeres,4,4,0,79
30 Veracruz de Ignacio de la Llave,170,170 Texcatepec,Mujeres,3,3,0,105
30 Veracruz de Ignacio de la Llave,170,170 Texcatepec,Mujeres,3,3,0,45
30 Veracruz de Ignacio de la Llave,170,170 Texcatepec,Mujeres,1,1,0,40
30 Veracruz de Ignacio de la Llave,170,170 Texcatepec,Mujeres,0,0,0,31
30 Veracruz de Ignacio de la Llave,171,171 Texhuacán,Total,1515,1467,48,2207
30 Veracruz de Ignacio de la Llave,171,171 Texhuacán,Total,33,29,4,357
30 Veracruz de Ignacio de la Llave,171,171 Texhuacán,Total,174,165,9,368
30 Veracruz de Ignacio de la Llave,171,171 Texhuacán,Total,218,206,12,276
30 Veracruz de Ignacio de la Llave,171,171 Texhuacán,Total,187,185,2,211
30 Veracruz de Ignacio de la Llave,171,171 Texhuacán,Total,184,174,10,183
30 Veracruz de Ignacio de la Llave,171,171 Texhuacán,Total,171,168,3,144
30 Veracruz de Ignacio de la Llave,171,171 Texhuacán,Total,124,121,3,97
30 Veracruz de Ignacio de la Llave,171,171 Texhuacán,Total,107,106,1,112
30 Veracruz de Ignacio de la Llave,171,171 Texhuacán,Total,86,84,2,79
30 Veracruz de Ignacio de la Llave,171,171 Texhuacán,Total,69,69,0,98
30 Veracruz de Ignacio de la Llave,171,171 Texhuacán,Total,69,68,1,60
30 Veracruz de Ignacio de la Llave,171,171 Texhuacán,Total,34,34,0,51
30 Veracruz de Ignacio de la Llave,171,171 Texhuacán,Total,26,26,0,62
30 Veracruz de Ignacio de la Llave,171,171 Texhuacán,Total,17,16,1,47
30 Veracruz de Ignacio de la Llave,171,171 Texhuacán,Total,14,14,0,25
30 Veracruz de Ignacio de la Llave,171,171 Texhuacán,Total,2,2,0,37
30 Veracruz de Ignacio de la Llave,171,171 Texhuacán,Hombres,1232,1186,46,491
30 Veracruz de Ignacio de la Llave,171,171 Texhuacán,Hombres,28,24,4,159
30 Veracruz de Ignacio de la Llave,171,171 Texhuacán,Hombres,154,145,9,114
30 Veracruz de Ignacio de la Llave,171,171 Texhuacán,Hombres,157,145,12,33
30 Veracruz de Ignacio de la Llave,171,171 Texhuacán,Hombres,137,135,2,17
30 Veracruz de Ignacio de la Llave,171,171 Texhuacán,Hombres,150,142,8,18
30 Veracruz de Ignacio de la Llave,171,171 Texhuacán,Hombres,140,137,3,19
30 Veracruz de Ignacio de la Llave,171,171 Texhuacán,Hombres,96,93,3,11
30 Veracruz de Ignacio de la Llave,171,171 Texhuacán,Hombres,88,87,1,14
30 Veracruz de Ignacio de la Llave,171,171 Texhuacán,Hombres,78,76,2,12
30 Veracruz de Ignacio de la Llave,171,171 Texhuacán,Hombres,62,62,0,22
30 Veracruz de Ignacio de la Llave,171,171 Texhuacán,Hombres,64,63,1,12
30 Veracruz de Ignacio de la Llave,171,171 Texhuacán,Hombres,29,29,0,4
30 Veracruz de Ignacio de la Llave,171,171 Texhuacán,Hombres,20,20,0,11
30 Veracruz de Ignacio de la Llave,171,171 Texhuacán,Hombres,15,14,1,20
30 Veracruz de Ignacio de la Llave,171,171 Texhuacán,Hombres,12,12,0,10
30 Veracruz de Ignacio de la Llave,171,171 Texhuacán,Hombres,2,2,0,15
30 Veracruz de Ignacio de la Llave,171,171 Texhuacán,Mujeres,283,281,2,1716
30 Veracruz de Ignacio de la Llave,171,171 Texhuacán,Mujeres,5,5,0,198
30 Veracruz de Ignacio de la Llave,171,171 Texhuacán,Mujeres,20,20,0,254
30 Veracruz de Ignacio de la Llave,171,171 Texhuacán,Mujeres,61,61,0,243
30 Veracruz de Ignacio de la Llave,171,171 Texhuacán,Mujeres,50,50,0,194
30 Veracruz de Ignacio de la Llave,171,171 Texhuacán,Mujeres,34,32,2,165
30 Veracruz de Ignacio de la Llave,171,171 Texhuacán,Mujeres,31,31,0,125
30 Veracruz de Ignacio de la Llave,171,171 Texhuacán,Mujeres,28,28,0,86
30 Veracruz de Ignacio de la Llave,171,171 Texhuacán,Mujeres,19,19,0,98
30 Veracruz de Ignacio de la Llave,171,171 Texhuacán,Mujeres,8,8,0,67
30 Veracruz de Ignacio de la Llave,171,171 Texhuacán,Mujeres,7,7,0,76
30 Veracruz de Ignacio de la Llave,171,171 Texhuacán,Mujeres,5,5,0,48
30 Veracruz de Ignacio de la Llave,171,171 Texhuacán,Mujeres,5,5,0,47
30 Veracruz de Ignacio de la Llave,171,171 Texhuacán,Mujeres,6,6,0,51
30 Veracruz de Ignacio de la Llave,171,171 Texhuacán,Mujeres,2,2,0,27
30 Veracruz de Ignacio de la Llave,171,171 Texhuacán,Mujeres,2,2,0,15
30 Veracruz de Ignacio de la Llave,171,171 Texhuacán,Mujeres,0,0,0,22
30 Veracruz de Ignacio de la Llave,172,172 Texistepec,Total,7116,6732,384,8401
30 Veracruz de Ignacio de la Llave,172,172 Texistepec,Total,64,61,3,1294
30 Veracruz de Ignacio de la Llave,172,172 Texistepec,Total,574,526,48,1660
30 Veracruz de Ignacio de la Llave,172,172 Texistepec,Total,897,832,65,710
30 Veracruz de Ignacio de la Llave,172,172 Texistepec,Total,789,739,50,617
30 Veracruz de Ignacio de la Llave,172,172 Texistepec,Total,839,796,43,603
30 Veracruz de Ignacio de la Llave,172,172 Texistepec,Total,843,812,31,563
30 Veracruz de Ignacio de la Llave,172,172 Texistepec,Total,727,692,35,499
30 Veracruz de Ignacio de la Llave,172,172 Texistepec,Total,621,592,29,478
30 Veracruz de Ignacio de la Llave,172,172 Texistepec,Total,509,488,21,383
30 Veracruz de Ignacio de la Llave,172,172 Texistepec,Total,376,354,22,375
30 Veracruz de Ignacio de la Llave,172,172 Texistepec,Total,296,283,13,252
30 Veracruz de Ignacio de la Llave,172,172 Texistepec,Total,233,223,10,228
30 Veracruz de Ignacio de la Llave,172,172 Texistepec,Total,168,158,10,283
30 Veracruz de Ignacio de la Llave,172,172 Texistepec,Total,105,102,3,195
30 Veracruz de Ignacio de la Llave,172,172 Texistepec,Total,50,50,0,137
30 Veracruz de Ignacio de la Llave,172,172 Texistepec,Total,25,24,1,124
30 Veracruz de Ignacio de la Llave,172,172 Texistepec,Hombres,5783,5430,353,1865
30 Veracruz de Ignacio de la Llave,172,172 Texistepec,Hombres,55,52,3,637
30 Veracruz de Ignacio de la Llave,172,172 Texistepec,Hombres,467,422,45,645
30 Veracruz de Ignacio de la Llave,172,172 Texistepec,Hombres,684,631,53,91
30 Veracruz de Ignacio de la Llave,172,172 Texistepec,Hombres,595,554,41,39
30 Veracruz de Ignacio de la Llave,172,172 Texistepec,Hombres,648,607,41,20
30 Veracruz de Ignacio de la Llave,172,172 Texistepec,Hombres,667,638,29,15
30 Veracruz de Ignacio de la Llave,172,172 Texistepec,Hombres,591,556,35,17
30 Veracruz de Ignacio de la Llave,172,172 Texistepec,Hombres,510,483,27,23
30 Veracruz de Ignacio de la Llave,172,172 Texistepec,Hombres,439,418,21,22
30 Veracruz de Ignacio de la Llave,172,172 Texistepec,Hombres,334,313,21,30
30 Veracruz de Ignacio de la Llave,172,172 Texistepec,Hombres,262,249,13,34
30 Veracruz de Ignacio de la Llave,172,172 Texistepec,Hombres,210,200,10,37
30 Veracruz de Ignacio de la Llave,172,172 Texistepec,Hombres,153,143,10,80
30 Veracruz de Ignacio de la Llave,172,172 Texistepec,Hombres,101,98,3,68
30 Veracruz de Ignacio de la Llave,172,172 Texistepec,Hombres,43,43,0,47
30 Veracruz de Ignacio de la Llave,172,172 Texistepec,Hombres,24,23,1,60
30 Veracruz de Ignacio de la Llave,172,172 Texistepec,Mujeres,1333,1302,31,6536
30 Veracruz de Ignacio de la Llave,172,172 Texistepec,Mujeres,9,9,0,657
30 Veracruz de Ignacio de la Llave,172,172 Texistepec,Mujeres,107,104,3,1015
30 Veracruz de Ignacio de la Llave,172,172 Texistepec,Mujeres,213,201,12,619
30 Veracruz de Ignacio de la Llave,172,172 Texistepec,Mujeres,194,185,9,578
30 Veracruz de Ignacio de la Llave,172,172 Texistepec,Mujeres,191,189,2,583
30 Veracruz de Ignacio de la Llave,172,172 Texistepec,Mujeres,176,174,2,548
30 Veracruz de Ignacio de la Llave,172,172 Texistepec,Mujeres,136,136,0,482
30 Veracruz de Ignacio de la Llave,172,172 Texistepec,Mujeres,111,109,2,455
30 Veracruz de Ignacio de la Llave,172,172 Texistepec,Mujeres,70,70,0,361
30 Veracruz de Ignacio de la Llave,172,172 Texistepec,Mujeres,42,41,1,345
30 Veracruz de Ignacio de la Llave,172,172 Texistepec,Mujeres,34,34,0,218
30 Veracruz de Ignacio de la Llave,172,172 Texistepec,Mujeres,23,23,0,191
30 Veracruz de Ignacio de la Llave,172,172 Texistepec,Mujeres,15,15,0,203
30 Veracruz de Ignacio de la Llave,172,172 Texistepec,Mujeres,4,4,0,127
30 Veracruz de Ignacio de la Llave,172,172 Texistepec,Mujeres,7,7,0,90
30 Veracruz de Ignacio de la Llave,172,172 Texistepec,Mujeres,1,1,0,64
30 Veracruz de Ignacio de la Llave,173,173 Tezonapa,Total,17316,16991,325,21602
30 Veracruz de Ignacio de la Llave,173,173 Tezonapa,Total,250,231,19,3297
30 Veracruz de Ignacio de la Llave,173,173 Tezonapa,Total,1675,1621,54,3799
30 Veracruz de Ignacio de la Llave,173,173 Tezonapa,Total,2302,2229,73,2184
30 Veracruz de Ignacio de la Llave,173,173 Tezonapa,Total,1899,1861,38,1557
30 Veracruz de Ignacio de la Llave,173,173 Tezonapa,Total,1915,1888,27,1547
30 Veracruz de Ignacio de la Llave,173,173 Tezonapa,Total,1929,1903,26,1514
30 Veracruz de Ignacio de la Llave,173,173 Tezonapa,Total,1619,1595,24,1247
30 Veracruz de Ignacio de la Llave,173,173 Tezonapa,Total,1478,1463,15,1172
30 Veracruz de Ignacio de la Llave,173,173 Tezonapa,Total,1185,1168,17,1006
30 Veracruz de Ignacio de la Llave,173,173 Tezonapa,Total,1029,1019,10,888
30 Veracruz de Ignacio de la Llave,173,173 Tezonapa,Total,708,700,8,812
30 Veracruz de Ignacio de la Llave,173,173 Tezonapa,Total,482,479,3,669
30 Veracruz de Ignacio de la Llave,173,173 Tezonapa,Total,437,431,6,752
30 Veracruz de Ignacio de la Llave,173,173 Tezonapa,Total,208,205,3,486
30 Veracruz de Ignacio de la Llave,173,173 Tezonapa,Total,112,112,0,321
30 Veracruz de Ignacio de la Llave,173,173 Tezonapa,Total,88,86,2,351
30 Veracruz de Ignacio de la Llave,173,173 Tezonapa,Hombres,14431,14174,257,4472
30 Veracruz de Ignacio de la Llave,173,173 Tezonapa,Hombres,215,201,14,1618
30 Veracruz de Ignacio de la Llave,173,173 Tezonapa,Hombres,1400,1359,41,1342
30 Veracruz de Ignacio de la Llave,173,173 Tezonapa,Hombres,1849,1798,51,264
30 Veracruz de Ignacio de la Llave,173,173 Tezonapa,Hombres,1546,1518,28,84
30 Veracruz de Ignacio de la Llave,173,173 Tezonapa,Hombres,1572,1551,21,45
30 Veracruz de Ignacio de la Llave,173,173 Tezonapa,Hombres,1575,1554,21,46
30 Veracruz de Ignacio de la Llave,173,173 Tezonapa,Hombres,1339,1316,23,47
30 Veracruz de Ignacio de la Llave,173,173 Tezonapa,Hombres,1216,1203,13,51
30 Veracruz de Ignacio de la Llave,173,173 Tezonapa,Hombres,998,983,15,55
30 Veracruz de Ignacio de la Llave,173,173 Tezonapa,Hombres,896,887,9,67
30 Veracruz de Ignacio de la Llave,173,173 Tezonapa,Hombres,626,618,8,138
30 Veracruz de Ignacio de la Llave,173,173 Tezonapa,Hombres,428,426,2,126
30 Veracruz de Ignacio de la Llave,173,173 Tezonapa,Hombres,398,392,6,197
30 Veracruz de Ignacio de la Llave,173,173 Tezonapa,Hombres,190,187,3,143
30 Veracruz de Ignacio de la Llave,173,173 Tezonapa,Hombres,101,101,0,118
30 Veracruz de Ignacio de la Llave,173,173 Tezonapa,Hombres,82,80,2,131
30 Veracruz de Ignacio de la Llave,173,173 Tezonapa,Mujeres,2885,2817,68,17130
30 Veracruz de Ignacio de la Llave,173,173 Tezonapa,Mujeres,35,30,5,1679
30 Veracruz de Ignacio de la Llave,173,173 Tezonapa,Mujeres,275,262,13,2457
30 Veracruz de Ignacio de la Llave,173,173 Tezonapa,Mujeres,453,431,22,1920
30 Veracruz de Ignacio de la Llave,173,173 Tezonapa,Mujeres,353,343,10,1473
30 Veracruz de Ignacio de la Llave,173,173 Tezonapa,Mujeres,343,337,6,1502
30 Veracruz de Ignacio de la Llave,173,173 Tezonapa,Mujeres,354,349,5,1468
30 Veracruz de Ignacio de la Llave,173,173 Tezonapa,Mujeres,280,279,1,1200
30 Veracruz de Ignacio de la Llave,173,173 Tezonapa,Mujeres,262,260,2,1121
30 Veracruz de Ignacio de la Llave,173,173 Tezonapa,Mujeres,187,185,2,951
30 Veracruz de Ignacio de la Llave,173,173 Tezonapa,Mujeres,133,132,1,821
30 Veracruz de Ignacio de la Llave,173,173 Tezonapa,Mujeres,82,82,0,674
30 Veracruz de Ignacio de la Llave,173,173 Tezonapa,Mujeres,54,53,1,543
30 Veracruz de Ignacio de la Llave,173,173 Tezonapa,Mujeres,39,39,0,555
30 Veracruz de Ignacio de la Llave,173,173 Tezonapa,Mujeres,18,18,0,343
30 Veracruz de Ignacio de la Llave,173,173 Tezonapa,Mujeres,11,11,0,203
30 Veracruz de Ignacio de la Llave,173,173 Tezonapa,Mujeres,6,6,0,220
30 Veracruz de Ignacio de la Llave,174,174 Tierra Blanca,Total,35987,34343,1644,38443
30 Veracruz de Ignacio de la Llave,174,174 Tierra Blanca,Total,300,266,34,5145
30 Veracruz de Ignacio de la Llave,174,174 Tierra Blanca,Total,2527,2280,247,7092
30 Veracruz de Ignacio de la Llave,174,174 Tierra Blanca,Total,4384,4046,338,3576
30 Veracruz de Ignacio de la Llave,174,174 Tierra Blanca,Total,4229,4010,219,2481
30 Veracruz de Ignacio de la Llave,174,174 Tierra Blanca,Total,4068,3919,149,2407
30 Veracruz de Ignacio de la Llave,174,174 Tierra Blanca,Total,4223,4109,114,2472
30 Veracruz de Ignacio de la Llave,174,174 Tierra Blanca,Total,4010,3899,111,2315
30 Veracruz de Ignacio de la Llave,174,174 Tierra Blanca,Total,3359,3249,110,2050
30 Veracruz de Ignacio de la Llave,174,174 Tierra Blanca,Total,2862,2753,109,2069
30 Veracruz de Ignacio de la Llave,174,174 Tierra Blanca,Total,2213,2152,61,1826
30 Veracruz de Ignacio de la Llave,174,174 Tierra Blanca,Total,1500,1442,58,1838
30 Veracruz de Ignacio de la Llave,174,174 Tierra Blanca,Total,962,929,33,1469
30 Veracruz de Ignacio de la Llave,174,174 Tierra Blanca,Total,730,695,35,1374
30 Veracruz de Ignacio de la Llave,174,174 Tierra Blanca,Total,357,342,15,1030
30 Veracruz de Ignacio de la Llave,174,174 Tierra Blanca,Total,165,159,6,660
30 Veracruz de Ignacio de la Llave,174,174 Tierra Blanca,Total,98,93,5,639
30 Veracruz de Ignacio de la Llave,174,174 Tierra Blanca,Hombres,26461,25139,1322,8726
30 Veracruz de Ignacio de la Llave,174,174 Tierra Blanca,Hombres,259,227,32,2485
30 Veracruz de Ignacio de la Llave,174,174 Tierra Blanca,Hombres,1992,1793,199,2841
30 Veracruz de Ignacio de la Llave,174,174 Tierra Blanca,Hombres,3115,2883,232,678
30 Veracruz de Ignacio de la Llave,174,174 Tierra Blanca,Hombres,2941,2792,149,100
30 Veracruz de Ignacio de la Llave,174,174 Tierra Blanca,Hombres,2846,2725,121,94
30 Veracruz de Ignacio de la Llave,174,174 Tierra Blanca,Hombres,2938,2840,98,84
30 Veracruz de Ignacio de la Llave,174,174 Tierra Blanca,Hombres,2873,2770,103,104
30 Veracruz de Ignacio de la Llave,174,174 Tierra Blanca,Hombres,2455,2360,95,113
30 Veracruz de Ignacio de la Llave,174,174 Tierra Blanca,Hombres,2075,1979,96,168
30 Veracruz de Ignacio de la Llave,174,174 Tierra Blanca,Hombres,1758,1703,55,260
30 Veracruz de Ignacio de la Llave,174,174 Tierra Blanca,Hombres,1232,1179,53,353
30 Veracruz de Ignacio de la Llave,174,174 Tierra Blanca,Hombres,802,772,30,339
30 Veracruz de Ignacio de la Llave,174,174 Tierra Blanca,Hombres,629,596,33,347
30 Veracruz de Ignacio de la Llave,174,174 Tierra Blanca,Hombres,311,296,15,313
30 Veracruz de Ignacio de la Llave,174,174 Tierra Blanca,Hombres,150,144,6,220
30 Veracruz de Ignacio de la Llave,174,174 Tierra Blanca,Hombres,85,80,5,227
30 Veracruz de Ignacio de la Llave,174,174 Tierra Blanca,Mujeres,9526,9204,322,29717
30 Veracruz de Ignacio de la Llave,174,174 Tierra Blanca,Mujeres,41,39,2,2660
30 Veracruz de Ignacio de la Llave,174,174 Tierra Blanca,Mujeres,535,487,48,4251
30 Veracruz de Ignacio de la Llave,174,174 Tierra Blanca,Mujeres,1269,1163,106,2898
30 Veracruz de Ignacio de la Llave,174,174 Tierra Blanca,Mujeres,1288,1218,70,2381
30 Veracruz de Ignacio de la Llave,174,174 Tierra Blanca,Mujeres,1222,1194,28,2313
30 Veracruz de Ignacio de la Llave,174,174 Tierra Blanca,Mujeres,1285,1269,16,2388
30 Veracruz de Ignacio de la Llave,174,174 Tierra Blanca,Mujeres,1137,1129,8,2211
30 Veracruz de Ignacio de la Llave,174,174 Tierra Blanca,Mujeres,904,889,15,1937
30 Veracruz de Ignacio de la Llave,174,174 Tierra Blanca,Mujeres,787,774,13,1901
30 Veracruz de Ignacio de la Llave,174,174 Tierra Blanca,Mujeres,455,449,6,1566
30 Veracruz de Ignacio de la Llave,174,174 Tierra Blanca,Mujeres,268,263,5,1485
30 Veracruz de Ignacio de la Llave,174,174 Tierra Blanca,Mujeres,160,157,3,1130
30 Veracruz de Ignacio de la Llave,174,174 Tierra Blanca,Mujeres,101,99,2,1027
30 Veracruz de Ignacio de la Llave,174,174 Tierra Blanca,Mujeres,46,46,0,717
30 Veracruz de Ignacio de la Llave,174,174 Tierra Blanca,Mujeres,15,15,0,440
30 Veracruz de Ignacio de la Llave,174,174 Tierra Blanca,Mujeres,13,13,0,412
30 Veracruz de Ignacio de la Llave,175,175 Tihuatlán,Total,33262,32397,865,34645
30 Veracruz de Ignacio de la Llave,175,175 Tihuatlán,Total,193,184,9,5151
30 Veracruz de Ignacio de la Llave,175,175 Tihuatlán,Total,2524,2416,108,6870
30 Veracruz de Ignacio de la Llave,175,175 Tihuatlán,Total,4412,4225,187,3208
30 Veracruz de Ignacio de la Llave,175,175 Tihuatlán,Total,3992,3865,127,2343
30 Veracruz de Ignacio de la Llave,175,175 Tihuatlán,Total,3857,3778,79,2333
30 Veracruz de Ignacio de la Llave,175,175 Tihuatlán,Total,3943,3878,65,2217
30 Veracruz de Ignacio de la Llave,175,175 Tihuatlán,Total,3636,3571,65,1986
30 Veracruz de Ignacio de la Llave,175,175 Tihuatlán,Total,2887,2830,57,1723
30 Veracruz de Ignacio de la Llave,175,175 Tihuatlán,Total,2279,2237,42,1681
30 Veracruz de Ignacio de la Llave,175,175 Tihuatlán,Total,1824,1772,52,1431
30 Veracruz de Ignacio de la Llave,175,175 Tihuatlán,Total,1356,1326,30,1408
30 Veracruz de Ignacio de la Llave,175,175 Tihuatlán,Total,951,939,12,1265
30 Veracruz de Ignacio de la Llave,175,175 Tihuatlán,Total,761,742,19,1166
30 Veracruz de Ignacio de la Llave,175,175 Tihuatlán,Total,374,367,7,777
30 Veracruz de Ignacio de la Llave,175,175 Tihuatlán,Total,157,155,2,496
30 Veracruz de Ignacio de la Llave,175,175 Tihuatlán,Total,116,112,4,590
30 Veracruz de Ignacio de la Llave,175,175 Tihuatlán,Hombres,24998,24264,734,7867
30 Veracruz de Ignacio de la Llave,175,175 Tihuatlán,Hombres,160,152,8,2535
30 Veracruz de Ignacio de la Llave,175,175 Tihuatlán,Hombres,1927,1847,80,2786
30 Veracruz de Ignacio de la Llave,175,175 Tihuatlán,Hombres,3216,3074,142,522
30 Veracruz de Ignacio de la Llave,175,175 Tihuatlán,Hombres,2875,2772,103,110
30 Veracruz de Ignacio de la Llave,175,175 Tihuatlán,Hombres,2813,2745,68,65
30 Veracruz de Ignacio de la Llave,175,175 Tihuatlán,Hombres,2805,2748,57,76
30 Veracruz de Ignacio de la Llave,175,175 Tihuatlán,Hombres,2622,2563,59,74
30 Veracruz de Ignacio de la Llave,175,175 Tihuatlán,Hombres,2131,2077,54,78
30 Veracruz de Ignacio de la Llave,175,175 Tihuatlán,Hombres,1749,1708,41,103
30 Veracruz de Ignacio de la Llave,175,175 Tihuatlán,Hombres,1471,1421,50,129
30 Veracruz de Ignacio de la Llave,175,175 Tihuatlán,Hombres,1121,1092,29,212
30 Veracruz de Ignacio de la Llave,175,175 Tihuatlán,Hombres,827,815,12,261
30 Veracruz de Ignacio de la Llave,175,175 Tihuatlán,Hombres,690,672,18,280
30 Veracruz de Ignacio de la Llave,175,175 Tihuatlán,Hombres,330,323,7,240
30 Veracruz de Ignacio de la Llave,175,175 Tihuatlán,Hombres,149,147,2,178
30 Veracruz de Ignacio de la Llave,175,175 Tihuatlán,Hombres,112,108,4,218
30 Veracruz de Ignacio de la Llave,175,175 Tihuatlán,Mujeres,8264,8133,131,26778
30 Veracruz de Ignacio de la Llave,175,175 Tihuatlán,Mujeres,33,32,1,2616
30 Veracruz de Ignacio de la Llave,175,175 Tihuatlán,Mujeres,597,569,28,4084
30 Veracruz de Ignacio de la Llave,175,175 Tihuatlán,Mujeres,1196,1151,45,2686
30 Veracruz de Ignacio de la Llave,175,175 Tihuatlán,Mujeres,1117,1093,24,2233
30 Veracruz de Ignacio de la Llave,175,175 Tihuatlán,Mujeres,1044,1033,11,2268
30 Veracruz de Ignacio de la Llave,175,175 Tihuatlán,Mujeres,1138,1130,8,2141
30 Veracruz de Ignacio de la Llave,175,175 Tihuatlán,Mujeres,1014,1008,6,1912
30 Veracruz de Ignacio de la Llave,175,175 Tihuatlán,Mujeres,756,753,3,1645
30 Veracruz de Ignacio de la Llave,175,175 Tihuatlán,Mujeres,530,529,1,1578
30 Veracruz de Ignacio de la Llave,175,175 Tihuatlán,Mujeres,353,351,2,1302
30 Veracruz de Ignacio de la Llave,175,175 Tihuatlán,Mujeres,235,234,1,1196
30 Veracruz de Ignacio de la Llave,175,175 Tihuatlán,Mujeres,124,124,0,1004
30 Veracruz de Ignacio de la Llave,175,175 Tihuatlán,Mujeres,71,70,1,886
30 Veracruz de Ignacio de la Llave,175,175 Tihuatlán,Mujeres,44,44,0,537
30 Veracruz de Ignacio de la Llave,175,175 Tihuatlán,Mujeres,8,8,0,318
30 Veracruz de Ignacio de la Llave,175,175 Tihuatlán,Mujeres,4,4,0,372
30 Veracruz de Ignacio de la Llave,180,180 Tlachichilco,Total,3434,3401,33,4775
30 Veracruz de Ignacio de la Llave,180,180 Tlachichilco,Total,50,46,4,813
30 Veracruz de Ignacio de la Llave,180,180 Tlachichilco,Total,391,382,9,906
30 Veracruz de Ignacio de la Llave,180,180 Tlachichilco,Total,397,394,3,417
30 Veracruz de Ignacio de la Llave,180,180 Tlachichilco,Total,345,341,4,364
30 Veracruz de Ignacio de la Llave,180,180 Tlachichilco,Total,307,304,3,337
30 Veracruz de Ignacio de la Llave,180,180 Tlachichilco,Total,357,354,3,292
30 Veracruz de Ignacio de la Llave,180,180 Tlachichilco,Total,349,347,2,322
30 Veracruz de Ignacio de la Llave,180,180 Tlachichilco,Total,260,256,4,263
30 Veracruz de Ignacio de la Llave,180,180 Tlachichilco,Total,209,208,1,206
30 Veracruz de Ignacio de la Llave,180,180 Tlachichilco,Total,192,192,0,227
30 Veracruz de Ignacio de la Llave,180,180 Tlachichilco,Total,191,191,0,171
30 Veracruz de Ignacio de la Llave,180,180 Tlachichilco,Total,143,143,0,149
30 Veracruz de Ignacio de la Llave,180,180 Tlachichilco,Total,134,134,0,157
30 Veracruz de Ignacio de la Llave,180,180 Tlachichilco,Total,63,63,0,69
30 Veracruz de Ignacio de la Llave,180,180 Tlachichilco,Total,29,29,0,40
30 Veracruz de Ignacio de la Llave,180,180 Tlachichilco,Total,17,17,0,42
30 Veracruz de Ignacio de la Llave,180,180 Tlachichilco,Hombres,3090,3058,32,913
30 Veracruz de Ignacio de la Llave,180,180 Tlachichilco,Hombres,44,41,3,399
30 Veracruz de Ignacio de la Llave,180,180 Tlachichilco,Hombres,342,333,9,324
30 Veracruz de Ignacio de la Llave,180,180 Tlachichilco,Hombres,344,341,3,40
30 Veracruz de Ignacio de la Llave,180,180 Tlachichilco,Hombres,308,304,4,16
30 Veracruz de Ignacio de la Llave,180,180 Tlachichilco,Hombres,278,275,3,8
30 Veracruz de Ignacio de la Llave,180,180 Tlachichilco,Hombres,311,308,3,6
30 Veracruz de Ignacio de la Llave,180,180 Tlachichilco,Hombres,297,295,2,9
30 Veracruz de Ignacio de la Llave,180,180 Tlachichilco,Hombres,241,237,4,13
30 Veracruz de Ignacio de la Llave,180,180 Tlachichilco,Hombres,192,191,1,8
30 Veracruz de Ignacio de la Llave,180,180 Tlachichilco,Hombres,184,184,0,10
30 Veracruz de Ignacio de la Llave,180,180 Tlachichilco,Hombres,182,182,0,8
30 Veracruz de Ignacio de la Llave,180,180 Tlachichilco,Hombres,139,139,0,11
30 Veracruz de Ignacio de la Llave,180,180 Tlachichilco,Hombres,125,125,0,18
30 Veracruz de Ignacio de la Llave,180,180 Tlachichilco,Hombres,60,60,0,14
30 Veracruz de Ignacio de la Llave,180,180 Tlachichilco,Hombres,29,29,0,11
30 Veracruz de Ignacio de la Llave,180,180 Tlachichilco,Hombres,14,14,0,18
30 Veracruz de Ignacio de la Llave,180,180 Tlachichilco,Mujeres,344,343,1,3862
30 Veracruz de Ignacio de la Llave,180,180 Tlachichilco,Mujeres,6,5,1,414
30 Veracruz de Ignacio de la Llave,180,180 Tlachichilco,Mujeres,49,49,0,582
30 Veracruz de Ignacio de la Llave,180,180 Tlachichilco,Mujeres,53,53,0,377
30 Veracruz de Ignacio de la Llave,180,180 Tlachichilco,Mujeres,37,37,0,348
30 Veracruz de Ignacio de la Llave,180,180 Tlachichilco,Mujeres,29,29,0,329
30 Veracruz de Ignacio de la Llave,180,180 Tlachichilco,Mujeres,46,46,0,286
30 Veracruz de Ignacio de la Llave,180,180 Tlachichilco,Mujeres,52,52,0,313
30 Veracruz de Ignacio de la Llave,180,180 Tlachichilco,Mujeres,19,19,0,250
30 Veracruz de Ignacio de la Llave,180,180 Tlachichilco,Mujeres,17,17,0,198
30 Veracruz de Ignacio de la Llave,180,180 Tlachichilco,Mujeres,8,8,0,217
30 Veracruz de Ignacio de la Llave,180,180 Tlachichilco,Mujeres,9,9,0,163
30 Veracruz de Ignacio de la Llave,180,180 Tlachichilco,Mujeres,4,4,0,138
30 Veracruz de Ignacio de la Llave,180,180 Tlachichilco,Mujeres,9,9,0,139
30 Veracruz de Ignacio de la Llave,180,180 Tlachichilco,Mujeres,3,3,0,55
30 Veracruz de Ignacio de la Llave,180,180 Tlachichilco,Mujeres,0,0,0,29
30 Veracruz de Ignacio de la Llave,180,180 Tlachichilco,Mujeres,3,3,0,24
30 Veracruz de Ignacio de la Llave,176,176 Tlacojalpan,Total,1604,1483,121,1991
30 Veracruz de Ignacio de la Llave,176,176 Tlacojalpan,Total,14,12,2,251
30 Veracruz de Ignacio de la Llave,176,176 Tlacojalpan,Total,122,107,15,317
30 Veracruz de Ignacio de la Llave,176,176 Tlacojalpan,Total,189,170,19,171
30 Veracruz de Ignacio de la Llave,176,176 Tlacojalpan,Total,158,153,5,121
30 Veracruz de Ignacio de la Llave,176,176 Tlacojalpan,Total,158,147,11,132
30 Veracruz de Ignacio de la Llave,176,176 Tlacojalpan,Total,212,194,18,141
30 Veracruz de Ignacio de la Llave,176,176 Tlacojalpan,Total,182,168,14,136
30 Veracruz de Ignacio de la Llave,176,176 Tlacojalpan,Total,176,164,12,107
30 Veracruz de Ignacio de la Llave,176,176 Tlacojalpan,Total,129,123,6,84
30 Veracruz de Ignacio de la Llave,176,176 Tlacojalpan,Total,88,84,4,84
30 Veracruz de Ignacio de la Llave,176,176 Tlacojalpan,Total,67,63,4,101
30 Veracruz de Ignacio de la Llave,176,176 Tlacojalpan,Total,49,43,6,81
30 Veracruz de Ignacio de la Llave,176,176 Tlacojalpan,Total,37,35,2,102
30 Veracruz de Ignacio de la Llave,176,176 Tlacojalpan,Total,14,12,2,81
30 Veracruz de Ignacio de la Llave,176,176 Tlacojalpan,Total,6,6,0,44
30 Veracruz de Ignacio de la Llave,176,176 Tlacojalpan,Total,3,2,1,38
30 Veracruz de Ignacio de la Llave,176,176 Tlacojalpan,Hombres,1236,1128,108,518
30 Veracruz de Ignacio de la Llave,176,176 Tlacojalpan,Hombres,11,9,2,124
30 Veracruz de Ignacio de la Llave,176,176 Tlacojalpan,Hombres,107,93,14,130
30 Veracruz de Ignacio de la Llave,176,176 Tlacojalpan,Hombres,144,129,15,30
30 Veracruz de Ignacio de la Llave,176,176 Tlacojalpan,Hombres,118,113,5,11
30 Veracruz de Ignacio de la Llave,176,176 Tlacojalpan,Hombres,112,104,8,9
30 Veracruz de Ignacio de la Llave,176,176 Tlacojalpan,Hombres,155,139,16,6
30 Veracruz de Ignacio de la Llave,176,176 Tlacojalpan,Hombres,139,126,13,11
30 Veracruz de Ignacio de la Llave,176,176 Tlacojalpan,Hombres,132,120,12,8
30 Veracruz de Ignacio de la Llave,176,176 Tlacojalpan,Hombres,105,99,6,11
30 Veracruz de Ignacio de la Llave,176,176 Tlacojalpan,Hombres,62,59,3,12
30 Veracruz de Ignacio de la Llave,176,176 Tlacojalpan,Hombres,56,52,4,23
30 Veracruz de Ignacio de la Llave,176,176 Tlacojalpan,Hombres,41,36,5,26
30 Veracruz de Ignacio de la Llave,176,176 Tlacojalpan,Hombres,32,30,2,35
30 Veracruz de Ignacio de la Llave,176,176 Tlacojalpan,Hombres,13,11,2,42
30 Veracruz de Ignacio de la Llave,176,176 Tlacojalpan,Hombres,6,6,0,19
30 Veracruz de Ignacio de la Llave,176,176 Tlacojalpan,Hombres,3,2,1,21
30 Veracruz de Ignacio de la Llave,176,176 Tlacojalpan,Mujeres,368,355,13,1473
30 Veracruz de Ignacio de la Llave,176,176 Tlacojalpan,Mujeres,3,3,0,127
30 Veracruz de Ignacio de la Llave,176,176 Tlacojalpan,Mujeres,15,14,1,187
30 Veracruz de Ignacio de la Llave,176,176 Tlacojalpan,Mujeres,45,41,4,141
30 Veracruz de Ignacio de la Llave,176,176 Tlacojalpan,Mujeres,40,40,0,110
30 Veracruz de Ignacio de la Llave,176,176 Tlacojalpan,Mujeres,46,43,3,123
30 Veracruz de Ignacio de la Llave,176,176 Tlacojalpan,Mujeres,57,55,2,135
30 Veracruz de Ignacio de la Llave,176,176 Tlacojalpan,Mujeres,43,42,1,125
30 Veracruz de Ignacio de la Llave,176,176 Tlacojalpan,Mujeres,44,44,0,99
30 Veracruz de Ignacio de la Llave,176,176 Tlacojalpan,Mujeres,24,24,0,73
30 Veracruz de Ignacio de la Llave,176,176 Tlacojalpan,Mujeres,26,25,1,72
30 Veracruz de Ignacio de la Llave,176,176 Tlacojalpan,Mujeres,11,11,0,78
30 Veracruz de Ignacio de la Llave,176,176 Tlacojalpan,Mujeres,8,7,1,55
30 Veracruz de Ignacio de la Llave,176,176 Tlacojalpan,Mujeres,5,5,0,67
30 Veracruz de Ignacio de la Llave,176,176 Tlacojalpan,Mujeres,1,1,0,39
30 Veracruz de Ignacio de la Llave,176,176 Tlacojalpan,Mujeres,0,0,0,25
30 Veracruz de Ignacio de la Llave,176,176 Tlacojalpan,Mujeres,0,0,0,17
30 Veracruz de Ignacio de la Llave,177,177 Tlacolulan,Total,3542,3499,43,3678
30 Veracruz de Ignacio de la Llave,177,177 Tlacolulan,Total,108,105,3,608
30 Veracruz de Ignacio de la Llave,177,177 Tlacolulan,Total,519,504,15,747
30 Veracruz de Ignacio de la Llave,177,177 Tlacolulan,Total,562,557,5,416
30 Veracruz de Ignacio de la Llave,177,177 Tlacolulan,Total,444,440,4,349
30 Veracruz de Ignacio de la Llave,177,177 Tlacolulan,Total,400,397,3,306
30 Veracruz de Ignacio de la Llave,177,177 Tlacolulan,Total,358,354,4,266
30 Veracruz de Ignacio de la Llave,177,177 Tlacolulan,Total,298,295,3,183
30 Veracruz de Ignacio de la Llave,177,177 Tlacolulan,Total,226,224,2,146
30 Veracruz de Ignacio de la Llave,177,177 Tlacolulan,Total,168,167,1,126
30 Veracruz de Ignacio de la Llave,177,177 Tlacolulan,Total,136,133,3,116
30 Veracruz de Ignacio de la Llave,177,177 Tlacolulan,Total,106,106,0,102
30 Veracruz de Ignacio de la Llave,177,177 Tlacolulan,Total,84,84,0,93
30 Veracruz de Ignacio de la Llave,177,177 Tlacolulan,Total,58,58,0,71
30 Veracruz de Ignacio de la Llave,177,177 Tlacolulan,Total,38,38,0,52
30 Veracruz de Ignacio de la Llave,177,177 Tlacolulan,Total,21,21,0,45
30 Veracruz de Ignacio de la Llave,177,177 Tlacolulan,Total,16,16,0,52
30 Veracruz de Ignacio de la Llave,177,177 Tlacolulan,Hombres,2880,2839,41,730
30 Veracruz de Ignacio de la Llave,177,177 Tlacolulan,Hombres,93,91,2,311
30 Veracruz de Ignacio de la Llave,177,177 Tlacolulan,Hombres,426,412,14,216
30 Veracruz de Ignacio de la Llave,177,177 Tlacolulan,Hombres,433,428,5,48
30 Veracruz de Ignacio de la Llave,177,177 Tlacolulan,Hombres,380,376,4,13
30 Veracruz de Ignacio de la Llave,177,177 Tlacolulan,Hombres,321,318,3,13
30 Veracruz de Ignacio de la Llave,177,177 Tlacolulan,Hombres,286,282,4,13
30 Veracruz de Ignacio de la Llave,177,177 Tlacolulan,Hombres,231,228,3,6
30 Veracruz de Ignacio de la Llave,177,177 Tlacolulan,Hombres,181,179,2,9
30 Veracruz de Ignacio de la Llave,177,177 Tlacolulan,Hombres,138,137,1,9
30 Veracruz de Ignacio de la Llave,177,177 Tlacolulan,Hombres,112,109,3,10
30 Veracruz de Ignacio de la Llave,177,177 Tlacolulan,Hombres,88,88,0,11
30 Veracruz de Ignacio de la Llave,177,177 Tlacolulan,Hombres,74,74,0,15
30 Veracruz de Ignacio de la Llave,177,177 Tlacolulan,Hombres,48,48,0,16
30 Veracruz de Ignacio de la Llave,177,177 Tlacolulan,Hombres,36,36,0,8
30 Veracruz de Ignacio de la Llave,177,177 Tlacolulan,Hombres,19,19,0,18
30 Veracruz de Ignacio de la Llave,177,177 Tlacolulan,Hombres,14,14,0,14
30 Veracruz de Ignacio de la Llave,177,177 Tlacolulan,Mujeres,662,660,2,2948
30 Veracruz de Ignacio de la Llave,177,177 Tlacolulan,Mujeres,15,14,1,297
30 Veracruz de Ignacio de la Llave,177,177 Tlacolulan,Mujeres,93,92,1,531
30 Veracruz de Ignacio de la Llave,177,177 Tlacolulan,Mujeres,129,129,0,368
30 Veracruz de Ignacio de la Llave,177,177 Tlacolulan,Mujeres,64,64,0,336
30 Veracruz de Ignacio de la Llave,177,177 Tlacolulan,Mujeres,79,79,0,293
30 Veracruz de Ignacio de la Llave,177,177 Tlacolulan,Mujeres,72,72,0,253
30 Veracruz de Ignacio de la Llave,177,177 Tlacolulan,Mujeres,67,67,0,177
30 Veracruz de Ignacio de la Llave,177,177 Tlacolulan,Mujeres,45,45,0,137
30 Veracruz de Ignacio de la Llave,177,177 Tlacolulan,Mujeres,30,30,0,117
30 Veracruz de Ignacio de la Llave,177,177 Tlacolulan,Mujeres,24,24,0,106
30 Veracruz de Ignacio de la Llave,177,177 Tlacolulan,Mujeres,18,18,0,91
30 Veracruz de Ignacio de la Llave,177,177 Tlacolulan,Mujeres,10,10,0,78
30 Veracruz de Ignacio de la Llave,177,177 Tlacolulan,Mujeres,10,10,0,55
30 Veracruz de Ignacio de la Llave,177,177 Tlacolulan,Mujeres,2,2,0,44
30 Veracruz de Ignacio de la Llave,177,177 Tlacolulan,Mujeres,2,2,0,27
30 Veracruz de Ignacio de la Llave,177,177 Tlacolulan,Mujeres,2,2,0,38
30 Veracruz de Ignacio de la Llave,178,178 Tlacotalpan,Total,5393,5250,143,5424
30 Veracruz de Ignacio de la Llave,178,178 Tlacotalpan,Total,39,35,4,705
30 Veracruz de Ignacio de la Llave,178,178 Tlacotalpan,Total,275,255,20,904
30 Veracruz de Ignacio de la Llave,178,178 Tlacotalpan,Total,525,508,17,461
30 Veracruz de Ignacio de la Llave,178,178 Tlacotalpan,Total,515,499,16,281
30 Veracruz de Ignacio de la Llave,178,178 Tlacotalpan,Total,547,537,10,262
30 Veracruz de Ignacio de la Llave,178,178 Tlacotalpan,Total,655,639,16,335
30 Veracruz de Ignacio de la Llave,178,178 Tlacotalpan,Total,641,621,20,319
30 Veracruz de Ignacio de la Llave,178,178 Tlacotalpan,Total,594,581,13,262
30 Veracruz de Ignacio de la Llave,178,178 Tlacotalpan,Total,473,466,7,276
30 Veracruz de Ignacio de la Llave,178,178 Tlacotalpan,Total,397,393,4,300
30 Veracruz de Ignacio de la Llave,178,178 Tlacotalpan,Total,251,247,4,286
30 Veracruz de Ignacio de la Llave,178,178 Tlacotalpan,Total,193,190,3,296
30 Veracruz de Ignacio de la Llave,178,178 Tlacotalpan,Total,168,162,6,280
30 Veracruz de Ignacio de la Llave,178,178 Tlacotalpan,Total,76,75,1,197
30 Veracruz de Ignacio de la Llave,178,178 Tlacotalpan,Total,25,24,1,126
30 Veracruz de Ignacio de la Llave,178,178 Tlacotalpan,Total,19,18,1,134
30 Veracruz de Ignacio de la Llave,178,178 Tlacotalpan,Hombres,3921,3808,113,1240
30 Veracruz de Ignacio de la Llave,178,178 Tlacotalpan,Hombres,36,32,4,363
30 Veracruz de Ignacio de la Llave,178,178 Tlacotalpan,Hombres,230,218,12,342
30 Veracruz de Ignacio de la Llave,178,178 Tlacotalpan,Hombres,393,384,9,90
30 Veracruz de Ignacio de la Llave,178,178 Tlacotalpan,Hombres,360,348,12,20
30 Veracruz de Ignacio de la Llave,178,178 Tlacotalpan,Hombres,367,358,9,6
30 Veracruz de Ignacio de la Llave,178,178 Tlacotalpan,Hombres,445,430,15,10
30 Veracruz de Ignacio de la Llave,178,178 Tlacotalpan,Hombres,456,437,19,14
30 Veracruz de Ignacio de la Llave,178,178 Tlacotalpan,Hombres,409,399,10,12
30 Veracruz de Ignacio de la Llave,178,178 Tlacotalpan,Hombres,346,341,5,14
30 Veracruz de Ignacio de la Llave,178,178 Tlacotalpan,Hombres,300,297,3,32
30 Veracruz de Ignacio de la Llave,178,178 Tlacotalpan,Hombres,189,185,4,62
30 Veracruz de Ignacio de la Llave,178,178 Tlacotalpan,Hombres,156,153,3,66
30 Veracruz de Ignacio de la Llave,178,178 Tlacotalpan,Hombres,135,130,5,67
30 Veracruz de Ignacio de la Llave,178,178 Tlacotalpan,Hombres,60,59,1,60
30 Veracruz de Ignacio de la Llave,178,178 Tlacotalpan,Hombres,23,22,1,39
30 Veracruz de Ignacio de la Llave,178,178 Tlacotalpan,Hombres,16,15,1,43
30 Veracruz de Ignacio de la Llave,178,178 Tlacotalpan,Mujeres,1472,1442,30,4184
30 Veracruz de Ignacio de la Llave,178,178 Tlacotalpan,Mujeres,3,3,0,342
30 Veracruz de Ignacio de la Llave,178,178 Tlacotalpan,Mujeres,45,37,8,562
30 Veracruz de Ignacio de la Llave,178,178 Tlacotalpan,Mujeres,132,124,8,371
30 Veracruz de Ignacio de la Llave,178,178 Tlacotalpan,Mujeres,155,151,4,261
30 Veracruz de Ignacio de la Llave,178,178 Tlacotalpan,Mujeres,180,179,1,256
30 Veracruz de Ignacio de la Llave,178,178 Tlacotalpan,Mujeres,210,209,1,325
30 Veracruz de Ignacio de la Llave,178,178 Tlacotalpan,Mujeres,185,184,1,305
30 Veracruz de Ignacio de la Llave,178,178 Tlacotalpan,Mujeres,185,182,3,250
30 Veracruz de Ignacio de la Llave,178,178 Tlacotalpan,Mujeres,127,125,2,262
30 Veracruz de Ignacio de la Llave,178,178 Tlacotalpan,Mujeres,97,96,1,268
30 Veracruz de Ignacio de la Llave,178,178 Tlacotalpan,Mujeres,62,62,0,224
30 Veracruz de Ignacio de la Llave,178,178 Tlacotalpan,Mujeres,37,37,0,230
30 Veracruz de Ignacio de la Llave,178,178 Tlacotalpan,Mujeres,33,32,1,213
30 Veracruz de Ignacio de la Llave,178,178 Tlacotalpan,Mujeres,16,16,0,137
30 Veracruz de Ignacio de la Llave,178,178 Tlacotalpan,Mujeres,2,2,0,87
30 Veracruz de Ignacio de la Llave,178,178 Tlacotalpan,Mujeres,3,3,0,91
30 Veracruz de Ignacio de la Llave,179,179 Tlacotepec de Mejía,Total,1380,1357,23,1628
30 Veracruz de Ignacio de la Llave,179,179 Tlacotepec de Mejía,Total,18,18,0,258
30 Veracruz de Ignacio de la Llave,179,179 Tlacotepec de Mejía,Total,143,141,2,253
30 Veracruz de Ignacio de la Llave,179,179 Tlacotepec de Mejía,Total,163,160,3,139
30 Veracruz de Ignacio de la Llave,179,179 Tlacotepec de Mejía,Total,155,152,3,134
30 Veracruz de Ignacio de la Llave,179,179 Tlacotepec de Mejía,Total,168,165,3,127
30 Veracruz de Ignacio de la Llave,179,179 Tlacotepec de Mejía,Total,146,143,3,117
30 Veracruz de Ignacio de la Llave,179,179 Tlacotepec de Mejía,Total,129,127,2,107
30 Veracruz de Ignacio de la Llave,179,179 Tlacotepec de Mejía,Total,122,120,2,92
30 Veracruz de Ignacio de la Llave,179,179 Tlacotepec de Mejía,Total,93,93,0,77
30 Veracruz de Ignacio de la Llave,179,179 Tlacotepec de Mejía,Total,72,70,2,55
30 Veracruz de Ignacio de la Llave,179,179 Tlacotepec de Mejía,Total,68,67,1,58
30 Veracruz de Ignacio de la Llave,179,179 Tlacotepec de Mejía,Total,42,41,1,58
30 Veracruz de Ignacio de la Llave,179,179 Tlacotepec de Mejía,Total,32,31,1,53
30 Veracruz de Ignacio de la Llave,179,179 Tlacotepec de Mejía,Total,20,20,0,36
30 Veracruz de Ignacio de la Llave,179,179 Tlacotepec de Mejía,Total,5,5,0,32
30 Veracruz de Ignacio de la Llave,179,179 Tlacotepec de Mejía,Total,4,4,0,32
30 Veracruz de Ignacio de la Llave,179,179 Tlacotepec de Mejía,Hombres,1107,1084,23,352
30 Veracruz de Ignacio de la Llave,179,179 Tlacotepec de Mejía,Hombres,17,17,0,132
30 Veracruz de Ignacio de la Llave,179,179 Tlacotepec de Mejía,Hombres,114,112,2,89
30 Veracruz de Ignacio de la Llave,179,179 Tlacotepec de Mejía,Hombres,116,113,3,13
30 Veracruz de Ignacio de la Llave,179,179 Tlacotepec de Mejía,Hombres,121,118,3,7
30 Veracruz de Ignacio de la Llave,179,179 Tlacotepec de Mejía,Hombres,130,127,3,4
30 Veracruz de Ignacio de la Llave,179,179 Tlacotepec de Mejía,Hombres,119,116,3,8
30 Veracruz de Ignacio de la Llave,179,179 Tlacotepec de Mejía,Hombres,104,102,2,8
30 Veracruz de Ignacio de la Llave,179,179 Tlacotepec de Mejía,Hombres,103,101,2,11
30 Veracruz de Ignacio de la Llave,179,179 Tlacotepec de Mejía,Hombres,75,75,0,7
30 Veracruz de Ignacio de la Llave,179,179 Tlacotepec de Mejía,Hombres,63,61,2,3
30 Veracruz de Ignacio de la Llave,179,179 Tlacotepec de Mejía,Hombres,57,56,1,6
30 Veracruz de Ignacio de la Llave,179,179 Tlacotepec de Mejía,Hombres,33,32,1,11
30 Veracruz de Ignacio de la Llave,179,179 Tlacotepec de Mejía,Hombres,28,27,1,14
30 Veracruz de Ignacio de la Llave,179,179 Tlacotepec de Mejía,Hombres,19,19,0,18
30 Veracruz de Ignacio de la Llave,179,179 Tlacotepec de Mejía,Hombres,4,4,0,8
30 Veracruz de Ignacio de la Llave,179,179 Tlacotepec de Mejía,Hombres,4,4,0,13
30 Veracruz de Ignacio de la Llave,179,179 Tlacotepec de Mejía,Mujeres,273,273,0,1276
30 Veracruz de Ignacio de la Llave,179,179 Tlacotepec de Mejía,Mujeres,1,1,0,126
30 Veracruz de Ignacio de la Llave,179,179 Tlacotepec de Mejía,Mujeres,29,29,0,164
30 Veracruz de Ignacio de la Llave,179,179 Tlacotepec de Mejía,Mujeres,47,47,0,126
30 Veracruz de Ignacio de la Llave,179,179 Tlacotepec de Mejía,Mujeres,34,34,0,127
30 Veracruz de Ignacio de la Llave,179,179 Tlacotepec de Mejía,Mujeres,38,38,0,123
30 Veracruz de Ignacio de la Llave,179,179 Tlacotepec de Mejía,Mujeres,27,27,0,109
30 Veracruz de Ignacio de la Llave,179,179 Tlacotepec de Mejía,Mujeres,25,25,0,99
30 Veracruz de Ignacio de la Llave,179,179 Tlacotepec de Mejía,Mujeres,19,19,0,81
30 Veracruz de Ignacio de la Llave,179,179 Tlacotepec de Mejía,Mujeres,18,18,0,70
30 Veracruz de Ignacio de la Llave,179,179 Tlacotepec de Mejía,Mujeres,9,9,0,52
30 Veracruz de Ignacio de la Llave,179,179 Tlacotepec de Mejía,Mujeres,11,11,0,52
30 Veracruz de Ignacio de la Llave,179,179 Tlacotepec de Mejía,Mujeres,9,9,0,47
30 Veracruz de Ignacio de la Llave,179,179 Tlacotepec de Mejía,Mujeres,4,4,0,39
30 Veracruz de Ignacio de la Llave,179,179 Tlacotepec de Mejía,Mujeres,1,1,0,18
30 Veracruz de Ignacio de la Llave,179,179 Tlacotepec de Mejía,Mujeres,1,1,0,24
30 Veracruz de Ignacio de la Llave,179,179 Tlacotepec de Mejía,Mujeres,0,0,0,19
30 Veracruz de Ignacio de la Llave,181,181 Tlalixcoyan,Total,14516,14016,500,15056
30 Veracruz de Ignacio de la Llave,181,181 Tlalixcoyan,Total,117,104,13,2005
30 Veracruz de Ignacio de la Llave,181,181 Tlalixcoyan,Total,1090,999,91,2672
30 Veracruz de Ignacio de la Llave,181,181 Tlalixcoyan,Total,1679,1606,73,1265
30 Veracruz de Ignacio de la Llave,181,181 Tlalixcoyan,Total,1358,1316,42,828
30 Veracruz de Ignacio de la Llave,181,181 Tlalixcoyan,Total,1422,1379,43,901
30 Veracruz de Ignacio de la Llave,181,181 Tlalixcoyan,Total,1565,1528,37,994
30 Veracruz de Ignacio de la Llave,181,181 Tlalixcoyan,Total,1562,1524,38,1010
30 Veracruz de Ignacio de la Llave,181,181 Tlalixcoyan,Total,1446,1408,38,924
30 Veracruz de Ignacio de la Llave,181,181 Tlalixcoyan,Total,1193,1174,19,866
30 Veracruz de Ignacio de la Llave,181,181 Tlalixcoyan,Total,918,892,26,693
30 Veracruz de Ignacio de la Llave,181,181 Tlalixcoyan,Total,761,735,26,687
30 Veracruz de Ignacio de la Llave,181,181 Tlalixcoyan,Total,551,535,16,594
30 Veracruz de Ignacio de la Llave,181,181 Tlalixcoyan,Total,443,426,17,545
30 Veracruz de Ignacio de la Llave,181,181 Tlalixcoyan,Total,227,215,12,445
30 Veracruz de Ignacio de la Llave,181,181 Tlalixcoyan,Total,123,116,7,285
30 Veracruz de Ignacio de la Llave,181,181 Tlalixcoyan,Total,61,59,2,342
30 Veracruz de Ignacio de la Llave,181,181 Tlalixcoyan,Hombres,11316,10903,413,2990
30 Veracruz de Ignacio de la Llave,181,181 Tlalixcoyan,Hombres,103,92,11,945
30 Veracruz de Ignacio de la Llave,181,181 Tlalixcoyan,Hombres,869,792,77,1075
30 Veracruz de Ignacio de la Llave,181,181 Tlalixcoyan,Hombres,1221,1169,52,189
30 Veracruz de Ignacio de la Llave,181,181 Tlalixcoyan,Hombres,991,966,25,43
30 Veracruz de Ignacio de la Llave,181,181 Tlalixcoyan,Hombres,1040,1006,34,23
30 Veracruz de Ignacio de la Llave,181,181 Tlalixcoyan,Hombres,1137,1106,31,30
30 Veracruz de Ignacio de la Llave,181,181 Tlalixcoyan,Hombres,1197,1166,31,29
30 Veracruz de Ignacio de la Llave,181,181 Tlalixcoyan,Hombres,1125,1092,33,50
30 Veracruz de Ignacio de la Llave,181,181 Tlalixcoyan,Hombres,951,932,19,52
30 Veracruz de Ignacio de la Llave,181,181 Tlalixcoyan,Hombres,754,730,24,47
30 Veracruz de Ignacio de la Llave,181,181 Tlalixcoyan,Hombres,653,630,23,63
30 Veracruz de Ignacio de la Llave,181,181 Tlalixcoyan,Hombres,494,478,16,71
30 Veracruz de Ignacio de la Llave,181,181 Tlalixcoyan,Hombres,397,381,16,83
30 Veracruz de Ignacio de la Llave,181,181 Tlalixcoyan,Hombres,213,201,12,97
30 Veracruz de Ignacio de la Llave,181,181 Tlalixcoyan,Hombres,117,110,7,84
30 Veracruz de Ignacio de la Llave,181,181 Tlalixcoyan,Hombres,54,52,2,109
30 Veracruz de Ignacio de la Llave,181,181 Tlalixcoyan,Mujeres,3200,3113,87,12066
30 Veracruz de Ignacio de la Llave,181,181 Tlalixcoyan,Mujeres,14,12,2,1060
30 Veracruz de Ignacio de la Llave,181,181 Tlalixcoyan,Mujeres,221,207,14,1597
30 Veracruz de Ignacio de la Llave,181,181 Tlalixcoyan,Mujeres,458,437,21,1076
30 Veracruz de Ignacio de la Llave,181,181 Tlalixcoyan,Mujeres,367,350,17,785
30 Veracruz de Ignacio de la Llave,181,181 Tlalixcoyan,Mujeres,382,373,9,878
30 Veracruz de Ignacio de la Llave,181,181 Tlalixcoyan,Mujeres,428,422,6,964
30 Veracruz de Ignacio de la Llave,181,181 Tlalixcoyan,Mujeres,365,358,7,981
30 Veracruz de Ignacio de la Llave,181,181 Tlalixcoyan,Mujeres,321,316,5,874
30 Veracruz de Ignacio de la Llave,181,181 Tlalixcoyan,Mujeres,242,242,0,814
30 Veracruz de Ignacio de la Llave,181,181 Tlalixcoyan,Mujeres,164,162,2,646
30 Veracruz de Ignacio de la Llave,181,181 Tlalixcoyan,Mujeres,108,105,3,624
30 Veracruz de Ignacio de la Llave,181,181 Tlalixcoyan,Mujeres,57,57,0,523
30 Veracruz de Ignacio de la Llave,181,181 Tlalixcoyan,Mujeres,46,45,1,462
30 Veracruz de Ignacio de la Llave,181,181 Tlalixcoyan,Mujeres,14,14,0,348
30 Veracruz de Ignacio de la Llave,181,181 Tlalixcoyan,Mujeres,6,6,0,201
30 Veracruz de Ignacio de la Llave,181,181 Tlalixcoyan,Mujeres,7,7,0,233
30 Veracruz de Ignacio de la Llave,182,182 Tlalnelhuayocan,Total,6951,6701,250,4947
30 Veracruz de Ignacio de la Llave,182,182 Tlalnelhuayocan,Total,82,81,1,928
30 Veracruz de Ignacio de la Llave,182,182 Tlalnelhuayocan,Total,684,638,46,1186
30 Veracruz de Ignacio de la Llave,182,182 Tlalnelhuayocan,Total,1072,1029,43,579
30 Veracruz de Ignacio de la Llave,182,182 Tlalnelhuayocan,Total,951,916,35,431
30 Veracruz de Ignacio de la Llave,182,182 Tlalnelhuayocan,Total,884,851,33,348
30 Veracruz de Ignacio de la Llave,182,182 Tlalnelhuayocan,Total,878,856,22,278
30 Veracruz de Ignacio de la Llave,182,182 Tlalnelhuayocan,Total,672,652,20,206
30 Veracruz de Ignacio de la Llave,182,182 Tlalnelhuayocan,Total,558,544,14,190
30 Veracruz de Ignacio de la Llave,182,182 Tlalnelhuayocan,Total,424,403,21,171
30 Veracruz de Ignacio de la Llave,182,182 Tlalnelhuayocan,Total,247,243,4,146
30 Veracruz de Ignacio de la Llave,182,182 Tlalnelhuayocan,Total,190,181,9,124
30 Veracruz de Ignacio de la Llave,182,182 Tlalnelhuayocan,Total,139,137,2,90
30 Veracruz de Ignacio de la Llave,182,182 Tlalnelhuayocan,Total,87,87,0,98
30 Veracruz de Ignacio de la Llave,182,182 Tlalnelhuayocan,Total,50,50,0,67
30 Veracruz de Ignacio de la Llave,182,182 Tlalnelhuayocan,Total,21,21,0,46
30 Veracruz de Ignacio de la Llave,182,182 Tlalnelhuayocan,Total,12,12,0,59
30 Veracruz de Ignacio de la Llave,182,182 Tlalnelhuayocan,Hombres,4478,4261,217,1248
30 Veracruz de Ignacio de la Llave,182,182 Tlalnelhuayocan,Hombres,51,50,1,466
30 Veracruz de Ignacio de la Llave,182,182 Tlalnelhuayocan,Hombres,449,415,34,469
30 Veracruz de Ignacio de la Llave,182,182 Tlalnelhuayocan,Hombres,711,675,36,93
30 Veracruz de Ignacio de la Llave,182,182 Tlalnelhuayocan,Hombres,643,613,30,25
30 Veracruz de Ignacio de la Llave,182,182 Tlalnelhuayocan,Hombres,552,519,33,13
30 Veracruz de Ignacio de la Llave,182,182 Tlalnelhuayocan,Hombres,537,519,18,13
30 Veracruz de Ignacio de la Llave,182,182 Tlalnelhuayocan,Hombres,433,416,17,11
30 Veracruz de Ignacio de la Llave,182,182 Tlalnelhuayocan,Hombres,350,337,13,16
30 Veracruz de Ignacio de la Llave,182,182 Tlalnelhuayocan,Hombres,262,241,21,10
30 Veracruz de Ignacio de la Llave,182,182 Tlalnelhuayocan,Hombres,153,150,3,16
30 Veracruz de Ignacio de la Llave,182,182 Tlalnelhuayocan,Hombres,121,112,9,19
30 Veracruz de Ignacio de la Llave,182,182 Tlalnelhuayocan,Hombres,98,96,2,16
30 Veracruz de Ignacio de la Llave,182,182 Tlalnelhuayocan,Hombres,57,57,0,27
30 Veracruz de Ignacio de la Llave,182,182 Tlalnelhuayocan,Hombres,36,36,0,14
30 Veracruz de Ignacio de la Llave,182,182 Tlalnelhuayocan,Hombres,16,16,0,15
30 Veracruz de Ignacio de la Llave,182,182 Tlalnelhuayocan,Hombres,9,9,0,25
30 Veracruz de Ignacio de la Llave,182,182 Tlalnelhuayocan,Mujeres,2473,2440,33,3699
30 Veracruz de Ignacio de la Llave,182,182 Tlalnelhuayocan,Mujeres,31,31,0,462
30 Veracruz de Ignacio de la Llave,182,182 Tlalnelhuayocan,Mujeres,235,223,12,717
30 Veracruz de Ignacio de la Llave,182,182 Tlalnelhuayocan,Mujeres,361,354,7,486
30 Veracruz de Ignacio de la Llave,182,182 Tlalnelhuayocan,Mujeres,308,303,5,406
30 Veracruz de Ignacio de la Llave,182,182 Tlalnelhuayocan,Mujeres,332,332,0,335
30 Veracruz de Ignacio de la Llave,182,182 Tlalnelhuayocan,Mujeres,341,337,4,265
30 Veracruz de Ignacio de la Llave,182,182 Tlalnelhuayocan,Mujeres,239,236,3,195
30 Veracruz de Ignacio de la Llave,182,182 Tlalnelhuayocan,Mujeres,208,207,1,174
30 Veracruz de Ignacio de la Llave,182,182 Tlalnelhuayocan,Mujeres,162,162,0,161
30 Veracruz de Ignacio de la Llave,182,182 Tlalnelhuayocan,Mujeres,94,93,1,130
30 Veracruz de Ignacio de la Llave,182,182 Tlalnelhuayocan,Mujeres,69,69,0,105
30 Veracruz de Ignacio de la Llave,182,182 Tlalnelhuayocan,Mujeres,41,41,0,74
30 Veracruz de Ignacio de la Llave,182,182 Tlalnelhuayocan,Mujeres,30,30,0,71
30 Veracruz de Ignacio de la Llave,182,182 Tlalnelhuayocan,Mujeres,14,14,0,53
30 Veracruz de Ignacio de la Llave,182,182 Tlalnelhuayocan,Mujeres,5,5,0,31
30 Veracruz de Ignacio de la Llave,182,182 Tlalnelhuayocan,Mujeres,3,3,0,34
30 Veracruz de Ignacio de la Llave,24,024 Tlaltetela,Total,5297,5178,119,5360
30 Veracruz de Ignacio de la Llave,24,024 Tlaltetela,Total,143,136,7,877
30 Veracruz de Ignacio de la Llave,24,024 Tlaltetela,Total,686,670,16,887
30 Veracruz de Ignacio de la Llave,24,024 Tlaltetela,Total,799,787,12,566
30 Veracruz de Ignacio de la Llave,24,024 Tlaltetela,Total,639,618,21,447
30 Veracruz de Ignacio de la Llave,24,024 Tlaltetela,Total,598,581,17,462
30 Veracruz de Ignacio de la Llave,24,024 Tlaltetela,Total,523,512,11,401
30 Veracruz de Ignacio de la Llave,24,024 Tlaltetela,Total,418,408,10,338
30 Veracruz de Ignacio de la Llave,24,024 Tlaltetela,Total,344,340,4,270
30 Veracruz de Ignacio de la Llave,24,024 Tlaltetela,Total,327,318,9,232
30 Veracruz de Ignacio de la Llave,24,024 Tlaltetela,Total,254,252,2,219
30 Veracruz de Ignacio de la Llave,24,024 Tlaltetela,Total,197,192,5,164
30 Veracruz de Ignacio de la Llave,24,024 Tlaltetela,Total,134,133,1,135
30 Veracruz de Ignacio de la Llave,24,024 Tlaltetela,Total,125,122,3,135
30 Veracruz de Ignacio de la Llave,24,024 Tlaltetela,Total,69,68,1,101
30 Veracruz de Ignacio de la Llave,24,024 Tlaltetela,Total,25,25,0,66
30 Veracruz de Ignacio de la Llave,24,024 Tlaltetela,Total,16,16,0,60
30 Veracruz de Ignacio de la Llave,24,024 Tlaltetela,Hombres,4386,4273,113,919
30 Veracruz de Ignacio de la Llave,24,024 Tlaltetela,Hombres,116,110,6,406
30 Veracruz de Ignacio de la Llave,24,024 Tlaltetela,Hombres,531,515,16,264
30 Veracruz de Ignacio de la Llave,24,024 Tlaltetela,Hombres,597,586,11,45
30 Veracruz de Ignacio de la Llave,24,024 Tlaltetela,Hombres,528,509,19,12
30 Veracruz de Ignacio de la Llave,24,024 Tlaltetela,Hombres,487,470,17,20
30 Veracruz de Ignacio de la Llave,24,024 Tlaltetela,Hombres,445,434,11,11
30 Veracruz de Ignacio de la Llave,24,024 Tlaltetela,Hombres,347,338,9,6
30 Veracruz de Ignacio de la Llave,24,024 Tlaltetela,Hombres,300,296,4,10
30 Veracruz de Ignacio de la Llave,24,024 Tlaltetela,Hombres,281,273,8,14
30 Veracruz de Ignacio de la Llave,24,024 Tlaltetela,Hombres,225,223,2,15
30 Veracruz de Ignacio de la Llave,24,024 Tlaltetela,Hombres,181,176,5,20
30 Veracruz de Ignacio de la Llave,24,024 Tlaltetela,Hombres,121,120,1,18
30 Veracruz de Ignacio de la Llave,24,024 Tlaltetela,Hombres,118,115,3,26
30 Veracruz de Ignacio de la Llave,24,024 Tlaltetela,Hombres,68,67,1,21
30 Veracruz de Ignacio de la Llave,24,024 Tlaltetela,Hombres,25,25,0,20
30 Veracruz de Ignacio de la Llave,24,024 Tlaltetela,Hombres,16,16,0,11
30 Veracruz de Ignacio de la Llave,24,024 Tlaltetela,Mujeres,911,905,6,4441
30 Veracruz de Ignacio de la Llave,24,024 Tlaltetela,Mujeres,27,26,1,471
30 Veracruz de Ignacio de la Llave,24,024 Tlaltetela,Mujeres,155,155,0,623
30 Veracruz de Ignacio de la Llave,24,024 Tlaltetela,Mujeres,202,201,1,521
30 Veracruz de Ignacio de la Llave,24,024 Tlaltetela,Mujeres,111,109,2,435
30 Veracruz de Ignacio de la Llave,24,024 Tlaltetela,Mujeres,111,111,0,442
30 Veracruz de Ignacio de la Llave,24,024 Tlaltetela,Mujeres,78,78,0,390
30 Veracruz de Ignacio de la Llave,24,024 Tlaltetela,Mujeres,71,70,1,332
30 Veracruz de Ignacio de la Llave,24,024 Tlaltetela,Mujeres,44,44,0,260
30 Veracruz de Ignacio de la Llave,24,024 Tlaltetela,Mujeres,46,45,1,218
30 Veracruz de Ignacio de la Llave,24,024 Tlaltetela,Mujeres,29,29,0,204
30 Veracruz de Ignacio de la Llave,24,024 Tlaltetela,Mujeres,16,16,0,144
30 Veracruz de Ignacio de la Llave,24,024 Tlaltetela,Mujeres,13,13,0,117
30 Veracruz de Ignacio de la Llave,24,024 Tlaltetela,Mujeres,7,7,0,109
30 Veracruz de Ignacio de la Llave,24,024 Tlaltetela,Mujeres,1,1,0,80
30 Veracruz de Ignacio de la Llave,24,024 Tlaltetela,Mujeres,0,0,0,46
30 Veracruz de Ignacio de la Llave,24,024 Tlaltetela,Mujeres,0,0,0,49
30 Veracruz de Ignacio de la Llave,183,183 Tlapacoyan,Total,23363,22901,462,19970
30 Veracruz de Ignacio de la Llave,183,183 Tlapacoyan,Total,329,310,19,3099
30 Veracruz de Ignacio de la Llave,183,183 Tlapacoyan,Total,2278,2191,87,3743
30 Veracruz de Ignacio de la Llave,183,183 Tlapacoyan,Total,2939,2862,77,1925
30 Veracruz de Ignacio de la Llave,183,183 Tlapacoyan,Total,2770,2714,56,1484
30 Veracruz de Ignacio de la Llave,183,183 Tlapacoyan,Total,2829,2790,39,1490
30 Veracruz de Ignacio de la Llave,183,183 Tlapacoyan,Total,2697,2665,32,1366
30 Veracruz de Ignacio de la Llave,183,183 Tlapacoyan,Total,2431,2403,28,1137
30 Veracruz de Ignacio de la Llave,183,183 Tlapacoyan,Total,1960,1927,33,984
30 Veracruz de Ignacio de la Llave,183,183 Tlapacoyan,Total,1629,1601,28,888
30 Veracruz de Ignacio de la Llave,183,183 Tlapacoyan,Total,1186,1168,18,818
30 Veracruz de Ignacio de la Llave,183,183 Tlapacoyan,Total,852,840,12,727
30 Veracruz de Ignacio de la Llave,183,183 Tlapacoyan,Total,635,621,14,655
30 Veracruz de Ignacio de la Llave,183,183 Tlapacoyan,Total,432,427,5,631
30 Veracruz de Ignacio de la Llave,183,183 Tlapacoyan,Total,233,225,8,415
30 Veracruz de Ignacio de la Llave,183,183 Tlapacoyan,Total,100,96,4,308
30 Veracruz de Ignacio de la Llave,183,183 Tlapacoyan,Total,63,61,2,300
30 Veracruz de Ignacio de la Llave,183,183 Tlapacoyan,Hombres,16501,16135,366,3990
30 Veracruz de Ignacio de la Llave,183,183 Tlapacoyan,Hombres,273,255,18,1433
30 Veracruz de Ignacio de la Llave,183,183 Tlapacoyan,Hombres,1713,1648,65,1261
30 Veracruz de Ignacio de la Llave,183,183 Tlapacoyan,Hombres,2014,1963,51,250
30 Veracruz de Ignacio de la Llave,183,183 Tlapacoyan,Hombres,1941,1898,43,56
30 Veracruz de Ignacio de la Llave,183,183 Tlapacoyan,Hombres,1923,1898,25,48
30 Veracruz de Ignacio de la Llave,183,183 Tlapacoyan,Hombres,1779,1754,25,48
30 Veracruz de Ignacio de la Llave,183,183 Tlapacoyan,Hombres,1681,1657,24,47
30 Veracruz de Ignacio de la Llave,183,183 Tlapacoyan,Hombres,1335,1305,30,32
30 Veracruz de Ignacio de la Llave,183,183 Tlapacoyan,Hombres,1136,1111,25,65
30 Veracruz de Ignacio de la Llave,183,183 Tlapacoyan,Hombres,865,849,16,74
30 Veracruz de Ignacio de la Llave,183,183 Tlapacoyan,Hombres,662,650,12,88
30 Veracruz de Ignacio de la Llave,183,183 Tlapacoyan,Hombres,493,480,13,109
30 Veracruz de Ignacio de la Llave,183,183 Tlapacoyan,Hombres,348,343,5,136
30 Veracruz de Ignacio de la Llave,183,183 Tlapacoyan,Hombres,192,184,8,109
30 Veracruz de Ignacio de la Llave,183,183 Tlapacoyan,Hombres,88,84,4,118
30 Veracruz de Ignacio de la Llave,183,183 Tlapacoyan,Hombres,58,56,2,116
30 Veracruz de Ignacio de la Llave,183,183 Tlapacoyan,Mujeres,6862,6766,96,15980
30 Veracruz de Ignacio de la Llave,183,183 Tlapacoyan,Mujeres,56,55,1,1666
30 Veracruz de Ignacio de la Llave,183,183 Tlapacoyan,Mujeres,565,543,22,2482
30 Veracruz de Ignacio de la Llave,183,183 Tlapacoyan,Mujeres,925,899,26,1675
30 Veracruz de Ignacio de la Llave,183,183 Tlapacoyan,Mujeres,829,816,13,1428
30 Veracruz de Ignacio de la Llave,183,183 Tlapacoyan,Mujeres,906,892,14,1442
30 Veracruz de Ignacio de la Llave,183,183 Tlapacoyan,Mujeres,918,911,7,1318
30 Veracruz de Ignacio de la Llave,183,183 Tlapacoyan,Mujeres,750,746,4,1090
30 Veracruz de Ignacio de la Llave,183,183 Tlapacoyan,Mujeres,625,622,3,952
30 Veracruz de Ignacio de la Llave,183,183 Tlapacoyan,Mujeres,493,490,3,823
30 Veracruz de Ignacio de la Llave,183,183 Tlapacoyan,Mujeres,321,319,2,744
30 Veracruz de Ignacio de la Llave,183,183 Tlapacoyan,Mujeres,190,190,0,639
30 Veracruz de Ignacio de la Llave,183,183 Tlapacoyan,Mujeres,142,141,1,546
30 Veracruz de Ignacio de la Llave,183,183 Tlapacoyan,Mujeres,84,84,0,495
30 Veracruz de Ignacio de la Llave,183,183 Tlapacoyan,Mujeres,41,41,0,306
30 Veracruz de Ignacio de la Llave,183,183 Tlapacoyan,Mujeres,12,12,0,190
30 Veracruz de Ignacio de la Llave,183,183 Tlapacoyan,Mujeres,5,5,0,184
30 Veracruz de Ignacio de la Llave,184,184 Tlaquilpa,Total,1846,1764,82,3000
30 Veracruz de Ignacio de la Llave,184,184 Tlaquilpa,Total,39,36,3,550
30 Veracruz de Ignacio de la Llave,184,184 Tlaquilpa,Total,218,208,10,558
30 Veracruz de Ignacio de la Llave,184,184 Tlaquilpa,Total,260,241,19,359
30 Veracruz de Ignacio de la Llave,184,184 Tlaquilpa,Total,220,211,9,278
30 Veracruz de Ignacio de la Llave,184,184 Tlaquilpa,Total,223,214,9,229
30 Veracruz de Ignacio de la Llave,184,184 Tlaquilpa,Total,172,168,4,212
30 Veracruz de Ignacio de la Llave,184,184 Tlaquilpa,Total,164,160,4,163
30 Veracruz de Ignacio de la Llave,184,184 Tlaquilpa,Total,144,136,8,126
30 Veracruz de Ignacio de la Llave,184,184 Tlaquilpa,Total,108,104,4,125
30 Veracruz de Ignacio de la Llave,184,184 Tlaquilpa,Total,109,103,6,101
30 Veracruz de Ignacio de la Llave,184,184 Tlaquilpa,Total,66,63,3,67
30 Veracruz de Ignacio de la Llave,184,184 Tlaquilpa,Total,55,53,2,64
30 Veracruz de Ignacio de la Llave,184,184 Tlaquilpa,Total,40,39,1,69
30 Veracruz de Ignacio de la Llave,184,184 Tlaquilpa,Total,18,18,0,40
30 Veracruz de Ignacio de la Llave,184,184 Tlaquilpa,Total,8,8,0,23
30 Veracruz de Ignacio de la Llave,184,184 Tlaquilpa,Total,2,2,0,36
30 Veracruz de Ignacio de la Llave,184,184 Tlaquilpa,Hombres,1488,1411,77,669
30 Veracruz de Ignacio de la Llave,184,184 Tlaquilpa,Hombres,33,30,3,244
30 Veracruz de Ignacio de la Llave,184,184 Tlaquilpa,Hombres,188,179,9,166
30 Veracruz de Ignacio de la Llave,184,184 Tlaquilpa,Hombres,198,181,17,52
30 Veracruz de Ignacio de la Llave,184,184 Tlaquilpa,Hombres,165,158,7,35
30 Veracruz de Ignacio de la Llave,184,184 Tlaquilpa,Hombres,180,171,9,21
30 Veracruz de Ignacio de la Llave,184,184 Tlaquilpa,Hombres,149,145,4,22
30 Veracruz de Ignacio de la Llave,184,184 Tlaquilpa,Hombres,144,140,4,14
30 Veracruz de Ignacio de la Llave,184,184 Tlaquilpa,Hombres,110,102,8,14
30 Veracruz de Ignacio de la Llave,184,184 Tlaquilpa,Hombres,82,78,4,14
30 Veracruz de Ignacio de la Llave,184,184 Tlaquilpa,Hombres,84,78,6,17
30 Veracruz de Ignacio de la Llave,184,184 Tlaquilpa,Hombres,55,52,3,9
30 Veracruz de Ignacio de la Llave,184,184 Tlaquilpa,Hombres,46,44,2,13
30 Veracruz de Ignacio de la Llave,184,184 Tlaquilpa,Hombres,30,29,1,17
30 Veracruz de Ignacio de la Llave,184,184 Tlaquilpa,Hombres,15,15,0,11
30 Veracruz de Ignacio de la Llave,184,184 Tlaquilpa,Hombres,7,7,0,8
30 Veracruz de Ignacio de la Llave,184,184 Tlaquilpa,Hombres,2,2,0,12
30 Veracruz de Ignacio de la Llave,184,184 Tlaquilpa,Mujeres,358,353,5,2331
30 Veracruz de Ignacio de la Llave,184,184 Tlaquilpa,Mujeres,6,6,0,306
30 Veracruz de Ignacio de la Llave,184,184 Tlaquilpa,Mujeres,30,29,1,392
30 Veracruz de Ignacio de la Llave,184,184 Tlaquilpa,Mujeres,62,60,2,307
30 Veracruz de Ignacio de la Llave,184,184 Tlaquilpa,Mujeres,55,53,2,243
30 Veracruz de Ignacio de la Llave,184,184 Tlaquilpa,Mujeres,43,43,0,208
30 Veracruz de Ignacio de la Llave,184,184 Tlaquilpa,Mujeres,23,23,0,190
30 Veracruz de Ignacio de la Llave,184,184 Tlaquilpa,Mujeres,20,20,0,149
30 Veracruz de Ignacio de la Llave,184,184 Tlaquilpa,Mujeres,34,34,0,112
30 Veracruz de Ignacio de la Llave,184,184 Tlaquilpa,Mujeres,26,26,0,111
30 Veracruz de Ignacio de la Llave,184,184 Tlaquilpa,Mujeres,25,25,0,84
30 Veracruz de Ignacio de la Llave,184,184 Tlaquilpa,Mujeres,11,11,0,58
30 Veracruz de Ignacio de la Llave,184,184 Tlaquilpa,Mujeres,9,9,0,51
30 Veracruz de Ignacio de la Llave,184,184 Tlaquilpa,Mujeres,10,10,0,52
30 Veracruz de Ignacio de la Llave,184,184 Tlaquilpa,Mujeres,3,3,0,29
30 Veracruz de Ignacio de la Llave,184,184 Tlaquilpa,Mujeres,1,1,0,15
30 Veracruz de Ignacio de la Llave,184,184 Tlaquilpa,Mujeres,0,0,0,24
30 Veracruz de Ignacio de la Llave,185,185 Tlilapan,Total,1792,1699,93,1731
30 Veracruz de Ignacio de la Llave,185,185 Tlilapan,Total,26,24,2,296
30 Veracruz de Ignacio de la Llave,185,185 Tlilapan,Total,182,158,24,375
30 Veracruz de Ignacio de la Llave,185,185 Tlilapan,Total,240,221,19,195
30 Veracruz de Ignacio de la Llave,185,185 Tlilapan,Total,271,261,10,152
30 Veracruz de Ignacio de la Llave,185,185 Tlilapan,Total,230,211,19,122
30 Veracruz de Ignacio de la Llave,185,185 Tlilapan,Total,208,204,4,127
30 Veracruz de Ignacio de la Llave,185,185 Tlilapan,Total,178,172,6,61
30 Veracruz de Ignacio de la Llave,185,185 Tlilapan,Total,154,150,4,67
30 Veracruz de Ignacio de la Llave,185,185 Tlilapan,Total,110,108,2,63
30 Veracruz de Ignacio de la Llave,185,185 Tlilapan,Total,89,87,2,64
30 Veracruz de Ignacio de la Llave,185,185 Tlilapan,Total,31,31,0,50
30 Veracruz de Ignacio de la Llave,185,185 Tlilapan,Total,31,31,0,24
30 Veracruz de Ignacio de la Llave,185,185 Tlilapan,Total,22,21,1,53
30 Veracruz de Ignacio de la Llave,185,185 Tlilapan,Total,12,12,0,46
30 Veracruz de Ignacio de la Llave,185,185 Tlilapan,Total,7,7,0,23
30 Veracruz de Ignacio de la Llave,185,185 Tlilapan,Total,1,1,0,13
30 Veracruz de Ignacio de la Llave,185,185 Tlilapan,Hombres,1207,1129,78,485
30 Veracruz de Ignacio de la Llave,185,185 Tlilapan,Hombres,21,19,2,144
30 Veracruz de Ignacio de la Llave,185,185 Tlilapan,Hombres,129,112,17,156
30 Veracruz de Ignacio de la Llave,185,185 Tlilapan,Hombres,165,149,16,33
30 Veracruz de Ignacio de la Llave,185,185 Tlilapan,Hombres,197,188,9,15
30 Veracruz de Ignacio de la Llave,185,185 Tlilapan,Hombres,153,137,16,12
30 Veracruz de Ignacio de la Llave,185,185 Tlilapan,Hombres,131,128,3,10
30 Veracruz de Ignacio de la Llave,185,185 Tlilapan,Hombres,119,113,6,6
30 Veracruz de Ignacio de la Llave,185,185 Tlilapan,Hombres,88,84,4,9
30 Veracruz de Ignacio de la Llave,185,185 Tlilapan,Hombres,65,63,2,17
30 Veracruz de Ignacio de la Llave,185,185 Tlilapan,Hombres,61,59,2,16
30 Veracruz de Ignacio de la Llave,185,185 Tlilapan,Hombres,25,25,0,14
30 Veracruz de Ignacio de la Llave,185,185 Tlilapan,Hombres,25,25,0,9
30 Veracruz de Ignacio de la Llave,185,185 Tlilapan,Hombres,14,13,1,13
30 Veracruz de Ignacio de la Llave,185,185 Tlilapan,Hombres,7,7,0,14
30 Veracruz de Ignacio de la Llave,185,185 Tlilapan,Hombres,6,6,0,10
30 Veracruz de Ignacio de la Llave,185,185 Tlilapan,Hombres,1,1,0,7
30 Veracruz de Ignacio de la Llave,185,185 Tlilapan,Mujeres,585,570,15,1246
30 Veracruz de Ignacio de la Llave,185,185 Tlilapan,Mujeres,5,5,0,152
30 Veracruz de Ignacio de la Llave,185,185 Tlilapan,Mujeres,53,46,7,219
30 Veracruz de Ignacio de la Llave,185,185 Tlilapan,Mujeres,75,72,3,162
30 Veracruz de Ignacio de la Llave,185,185 Tlilapan,Mujeres,74,73,1,137
30 Veracruz de Ignacio de la Llave,185,185 Tlilapan,Mujeres,77,74,3,110
30 Veracruz de Ignacio de la Llave,185,185 Tlilapan,Mujeres,77,76,1,117
30 Veracruz de Ignacio de la Llave,185,185 Tlilapan,Mujeres,59,59,0,55
30 Veracruz de Ignacio de la Llave,185,185 Tlilapan,Mujeres,66,66,0,58
30 Veracruz de Ignacio de la Llave,185,185 Tlilapan,Mujeres,45,45,0,46
30 Veracruz de Ignacio de la Llave,185,185 Tlilapan,Mujeres,28,28,0,48
30 Veracruz de Ignacio de la Llave,185,185 Tlilapan,Mujeres,6,6,0,36
30 Veracruz de Ignacio de la Llave,185,185 Tlilapan,Mujeres,6,6,0,15
30 Veracruz de Ignacio de la Llave,185,185 Tlilapan,Mujeres,8,8,0,40
30 Veracruz de Ignacio de la Llave,185,185 Tlilapan,Mujeres,5,5,0,32
30 Veracruz de Ignacio de la Llave,185,185 Tlilapan,Mujeres,1,1,0,13
30 Veracruz de Ignacio de la Llave,185,185 Tlilapan,Mujeres,0,0,0,6
30 Veracruz de Ignacio de la Llave,186,186 Tomatlán,Total,2848,2786,62,2479
30 Veracruz de Ignacio de la Llave,186,186 Tomatlán,Total,51,51,0,312
30 Veracruz de Ignacio de la Llave,186,186 Tomatlán,Total,221,218,3,437
30 Veracruz de Ignacio de la Llave,186,186 Tomatlán,Total,353,339,14,275
30 Veracruz de Ignacio de la Llave,186,186 Tomatlán,Total,361,345,16,171
30 Veracruz de Ignacio de la Llave,186,186 Tomatlán,Total,321,318,3,184
30 Veracruz de Ignacio de la Llave,186,186 Tomatlán,Total,323,319,4,161
30 Veracruz de Ignacio de la Llave,186,186 Tomatlán,Total,288,283,5,145
30 Veracruz de Ignacio de la Llave,186,186 Tomatlán,Total,258,252,6,124
30 Veracruz de Ignacio de la Llave,186,186 Tomatlán,Total,199,195,4,114
30 Veracruz de Ignacio de la Llave,186,186 Tomatlán,Total,160,158,2,106
30 Veracruz de Ignacio de la Llave,186,186 Tomatlán,Total,106,103,3,94
30 Veracruz de Ignacio de la Llave,186,186 Tomatlán,Total,87,86,1,96
30 Veracruz de Ignacio de la Llave,186,186 Tomatlán,Total,57,56,1,81
30 Veracruz de Ignacio de la Llave,186,186 Tomatlán,Total,39,39,0,82
30 Veracruz de Ignacio de la Llave,186,186 Tomatlán,Total,13,13,0,45
30 Veracruz de Ignacio de la Llave,186,186 Tomatlán,Total,11,11,0,52
30 Veracruz de Ignacio de la Llave,186,186 Tomatlán,Hombres,2051,1999,52,532
30 Veracruz de Ignacio de la Llave,186,186 Tomatlán,Hombres,44,44,0,149
30 Veracruz de Ignacio de la Llave,186,186 Tomatlán,Hombres,175,172,3,169
30 Veracruz de Ignacio de la Llave,186,186 Tomatlán,Hombres,244,235,9,51
30 Veracruz de Ignacio de la Llave,186,186 Tomatlán,Hombres,260,246,14,9
30 Veracruz de Ignacio de la Llave,186,186 Tomatlán,Hombres,222,220,2,7
30 Veracruz de Ignacio de la Llave,186,186 Tomatlán,Hombres,208,204,4,13
30 Veracruz de Ignacio de la Llave,186,186 Tomatlán,Hombres,191,186,5,8
30 Veracruz de Ignacio de la Llave,186,186 Tomatlán,Hombres,184,179,5,9
30 Veracruz de Ignacio de la Llave,186,186 Tomatlán,Hombres,135,131,4,8
30 Veracruz de Ignacio de la Llave,186,186 Tomatlán,Hombres,119,117,2,10
30 Veracruz de Ignacio de la Llave,186,186 Tomatlán,Hombres,89,86,3,13
30 Veracruz de Ignacio de la Llave,186,186 Tomatlán,Hombres,79,78,1,12
30 Veracruz de Ignacio de la Llave,186,186 Tomatlán,Hombres,48,48,0,20
30 Veracruz de Ignacio de la Llave,186,186 Tomatlán,Hombres,31,31,0,23
30 Veracruz de Ignacio de la Llave,186,186 Tomatlán,Hombres,11,11,0,13
30 Veracruz de Ignacio de la Llave,186,186 Tomatlán,Hombres,11,11,0,18
30 Veracruz de Ignacio de la Llave,186,186 Tomatlán,Mujeres,797,787,10,1947
30 Veracruz de Ignacio de la Llave,186,186 Tomatlán,Mujeres,7,7,0,163
30 Veracruz de Ignacio de la Llave,186,186 Tomatlán,Mujeres,46,46,0,268
30 Veracruz de Ignacio de la Llave,186,186 Tomatlán,Mujeres,109,104,5,224
30 Veracruz de Ignacio de la Llave,186,186 Tomatlán,Mujeres,101,99,2,162
30 Veracruz de Ignacio de la Llave,186,186 Tomatlán,Mujeres,99,98,1,177
30 Veracruz de Ignacio de la Llave,186,186 Tomatlán,Mujeres,115,115,0,148
30 Veracruz de Ignacio de la Llave,186,186 Tomatlán,Mujeres,97,97,0,137
30 Veracruz de Ignacio de la Llave,186,186 Tomatlán,Mujeres,74,73,1,115
30 Veracruz de Ignacio de la Llave,186,186 Tomatlán,Mujeres,64,64,0,106
30 Veracruz de Ignacio de la Llave,186,186 Tomatlán,Mujeres,41,41,0,96
30 Veracruz de Ignacio de la Llave,186,186 Tomatlán,Mujeres,17,17,0,81
30 Veracruz de Ignacio de la Llave,186,186 Tomatlán,Mujeres,8,8,0,84
30 Veracruz de Ignacio de la Llave,186,186 Tomatlán,Mujeres,9,8,1,61
30 Veracruz de Ignacio de la Llave,186,186 Tomatlán,Mujeres,8,8,0,59
30 Veracruz de Ignacio de la Llave,186,186 Tomatlán,Mujeres,2,2,0,32
30 Veracruz de Ignacio de la Llave,186,186 Tomatlán,Mujeres,0,0,0,34
30 Veracruz de Ignacio de la Llave,187,187 Tonayán,Total,1783,1741,42,2215
30 Veracruz de Ignacio de la Llave,187,187 Tonayán,Total,59,58,1,364
30 Veracruz de Ignacio de la Llave,187,187 Tonayán,Total,287,282,5,417
30 Veracruz de Ignacio de la Llave,187,187 Tonayán,Total,286,277,9,232
30 Veracruz de Ignacio de la Llave,187,187 Tonayán,Total,187,184,3,194
30 Veracruz de Ignacio de la Llave,187,187 Tonayán,Total,223,218,5,178
30 Veracruz de Ignacio de la Llave,187,187 Tonayán,Total,190,182,8,163
30 Veracruz de Ignacio de la Llave,187,187 Tonayán,Total,161,158,3,131
30 Veracruz de Ignacio de la Llave,187,187 Tonayán,Total,96,93,3,99
30 Veracruz de Ignacio de la Llave,187,187 Tonayán,Total,85,84,1,74
30 Veracruz de Ignacio de la Llave,187,187 Tonayán,Total,63,63,0,68
30 Veracruz de Ignacio de la Llave,187,187 Tonayán,Total,53,50,3,74
30 Veracruz de Ignacio de la Llave,187,187 Tonayán,Total,38,38,0,62
30 Veracruz de Ignacio de la Llave,187,187 Tonayán,Total,30,29,1,58
30 Veracruz de Ignacio de la Llave,187,187 Tonayán,Total,17,17,0,40
30 Veracruz de Ignacio de la Llave,187,187 Tonayán,Total,2,2,0,28
30 Veracruz de Ignacio de la Llave,187,187 Tonayán,Total,6,6,0,33
30 Veracruz de Ignacio de la Llave,187,187 Tonayán,Hombres,1503,1461,42,437
30 Veracruz de Ignacio de la Llave,187,187 Tonayán,Hombres,54,53,1,153
30 Veracruz de Ignacio de la Llave,187,187 Tonayán,Hombres,245,240,5,114
30 Veracruz de Ignacio de la Llave,187,187 Tonayán,Hombres,231,222,9,30
30 Veracruz de Ignacio de la Llave,187,187 Tonayán,Hombres,156,153,3,18
30 Veracruz de Ignacio de la Llave,187,187 Tonayán,Hombres,191,186,5,15
30 Veracruz de Ignacio de la Llave,187,187 Tonayán,Hombres,160,152,8,7
30 Veracruz de Ignacio de la Llave,187,187 Tonayán,Hombres,136,133,3,12
30 Veracruz de Ignacio de la Llave,187,187 Tonayán,Hombres,83,80,3,11
30 Veracruz de Ignacio de la Llave,187,187 Tonayán,Hombres,69,68,1,8
30 Veracruz de Ignacio de la Llave,187,187 Tonayán,Hombres,49,49,0,10
30 Veracruz de Ignacio de la Llave,187,187 Tonayán,Hombres,48,45,3,14
30 Veracruz de Ignacio de la Llave,187,187 Tonayán,Hombres,33,33,0,7
30 Veracruz de Ignacio de la Llave,187,187 Tonayán,Hombres,26,25,1,14
30 Veracruz de Ignacio de la Llave,187,187 Tonayán,Hombres,15,15,0,9
30 Veracruz de Ignacio de la Llave,187,187 Tonayán,Hombres,2,2,0,7
30 Veracruz de Ignacio de la Llave,187,187 Tonayán,Hombres,5,5,0,8
30 Veracruz de Ignacio de la Llave,187,187 Tonayán,Mujeres,280,280,0,1778
30 Veracruz de Ignacio de la Llave,187,187 Tonayán,Mujeres,5,5,0,211
30 Veracruz de Ignacio de la Llave,187,187 Tonayán,Mujeres,42,42,0,303
30 Veracruz de Ignacio de la Llave,187,187 Tonayán,Mujeres,55,55,0,202
30 Veracruz de Ignacio de la Llave,187,187 Tonayán,Mujeres,31,31,0,176
30 Veracruz de Ignacio de la Llave,187,187 Tonayán,Mujeres,32,32,0,163
30 Veracruz de Ignacio de la Llave,187,187 Tonayán,Mujeres,30,30,0,156
30 Veracruz de Ignacio de la Llave,187,187 Tonayán,Mujeres,25,25,0,119
30 Veracruz de Ignacio de la Llave,187,187 Tonayán,Mujeres,13,13,0,88
30 Veracruz de Ignacio de la Llave,187,187 Tonayán,Mujeres,16,16,0,66
30 Veracruz de Ignacio de la Llave,187,187 Tonayán,Mujeres,14,14,0,58
30 Veracruz de Ignacio de la Llave,187,187 Tonayán,Mujeres,5,5,0,60
30 Veracruz de Ignacio de la Llave,187,187 Tonayán,Mujeres,5,5,0,55
30 Veracruz de Ignacio de la Llave,187,187 Tonayán,Mujeres,4,4,0,44
30 Veracruz de Ignacio de la Llave,187,187 Tonayán,Mujeres,2,2,0,31
30 Veracruz de Ignacio de la Llave,187,187 Tonayán,Mujeres,0,0,0,21
30 Veracruz de Ignacio de la Llave,187,187 Tonayán,Mujeres,1,1,0,25
30 Veracruz de Ignacio de la Llave,188,188 Totutla,Total,6013,5907,106,6433
30 Veracruz de Ignacio de la Llave,188,188 Totutla,Total,87,87,0,959
30 Veracruz de Ignacio de la Llave,188,188 Totutla,Total,618,605,13,1086
30 Veracruz de Ignacio de la Llave,188,188 Totutla,Total,868,847,21,643
30 Veracruz de Ignacio de la Llave,188,188 Totutla,Total,703,690,13,525
30 Veracruz de Ignacio de la Llave,188,188 Totutla,Total,700,690,10,523
30 Veracruz de Ignacio de la Llave,188,188 Totutla,Total,655,649,6,471
30 Veracruz de Ignacio de la Llave,188,188 Totutla,Total,524,516,8,386
30 Veracruz de Ignacio de la Llave,188,188 Totutla,Total,445,436,9,357
30 Veracruz de Ignacio de la Llave,188,188 Totutla,Total,436,427,9,281
30 Veracruz de Ignacio de la Llave,188,188 Totutla,Total,312,304,8,273
30 Veracruz de Ignacio de la Llave,188,188 Totutla,Total,223,223,0,231
30 Veracruz de Ignacio de la Llave,188,188 Totutla,Total,182,176,6,166
30 Veracruz de Ignacio de la Llave,188,188 Totutla,Total,124,123,1,189
30 Veracruz de Ignacio de la Llave,188,188 Totutla,Total,91,90,1,135
30 Veracruz de Ignacio de la Llave,188,188 Totutla,Total,28,28,0,100
30 Veracruz de Ignacio de la Llave,188,188 Totutla,Total,17,16,1,108
30 Veracruz de Ignacio de la Llave,188,188 Totutla,Hombres,5015,4918,97,1162
30 Veracruz de Ignacio de la Llave,188,188 Totutla,Hombres,80,80,0,431
30 Veracruz de Ignacio de la Llave,188,188 Totutla,Hombres,508,499,9,379
30 Veracruz de Ignacio de la Llave,188,188 Totutla,Hombres,679,660,19,61
30 Veracruz de Ignacio de la Llave,188,188 Totutla,Hombres,573,563,10,26
30 Veracruz de Ignacio de la Llave,188,188 Totutla,Hombres,579,569,10,15
30 Veracruz de Ignacio de la Llave,188,188 Totutla,Hombres,543,537,6,19
30 Veracruz de Ignacio de la Llave,188,188 Totutla,Hombres,448,440,8,14
30 Veracruz de Ignacio de la Llave,188,188 Totutla,Hombres,374,365,9,22
30 Veracruz de Ignacio de la Llave,188,188 Totutla,Hombres,356,347,9,15
30 Veracruz de Ignacio de la Llave,188,188 Totutla,Hombres,276,268,8,18
30 Veracruz de Ignacio de la Llave,188,188 Totutla,Hombres,193,193,0,21
30 Veracruz de Ignacio de la Llave,188,188 Totutla,Hombres,162,156,6,16
30 Veracruz de Ignacio de la Llave,188,188 Totutla,Hombres,113,112,1,32
30 Veracruz de Ignacio de la Llave,188,188 Totutla,Hombres,88,87,1,24
30 Veracruz de Ignacio de la Llave,188,188 Totutla,Hombres,27,27,0,26
30 Veracruz de Ignacio de la Llave,188,188 Totutla,Hombres,16,15,1,43
30 Veracruz de Ignacio de la Llave,188,188 Totutla,Mujeres,998,989,9,5271
30 Veracruz de Ignacio de la Llave,188,188 Totutla,Mujeres,7,7,0,528
30 Veracruz de Ignacio de la Llave,188,188 Totutla,Mujeres,110,106,4,707
30 Veracruz de Ignacio de la Llave,188,188 Totutla,Mujeres,189,187,2,582
30 Veracruz de Ignacio de la Llave,188,188 Totutla,Mujeres,130,127,3,499
30 Veracruz de Ignacio de la Llave,188,188 Totutla,Mujeres,121,121,0,508
30 Veracruz de Ignacio de la Llave,188,188 Totutla,Mujeres,112,112,0,452
30 Veracruz de Ignacio de la Llave,188,188 Totutla,Mujeres,76,76,0,372
30 Veracruz de Ignacio de la Llave,188,188 Totutla,Mujeres,71,71,0,335
30 Veracruz de Ignacio de la Llave,188,188 Totutla,Mujeres,80,80,0,266
30 Veracruz de Ignacio de la Llave,188,188 Totutla,Mujeres,36,36,0,255
30 Veracruz de Ignacio de la Llave,188,188 Totutla,Mujeres,30,30,0,210
30 Veracruz de Ignacio de la Llave,188,188 Totutla,Mujeres,20,20,0,150
30 Veracruz de Ignacio de la Llave,188,188 Totutla,Mujeres,11,11,0,157
30 Veracruz de Ignacio de la Llave,188,188 Totutla,Mujeres,3,3,0,111
30 Veracruz de Ignacio de la Llave,188,188 Totutla,Mujeres,1,1,0,74
30 Veracruz de Ignacio de la Llave,188,188 Totutla,Mujeres,1,1,0,65
30 Veracruz de Ignacio de la Llave,207,207 Tres Valles,Total,16466,15971,495,18459
30 Veracruz de Ignacio de la Llave,207,207 Tres Valles,Total,166,148,18,2562
30 Veracruz de Ignacio de la Llave,207,207 Tres Valles,Total,1356,1294,62,3275
30 Veracruz de Ignacio de la Llave,207,207 Tres Valles,Total,2037,1944,93,1739
30 Veracruz de Ignacio de la Llave,207,207 Tres Valles,Total,1848,1775,73,1246
30 Veracruz de Ignacio de la Llave,207,207 Tres Valles,Total,1775,1728,47,1197
30 Veracruz de Ignacio de la Llave,207,207 Tres Valles,Total,1922,1877,45,1281
30 Veracruz de Ignacio de la Llave,207,207 Tres Valles,Total,1814,1778,36,1183
30 Veracruz de Ignacio de la Llave,207,207 Tres Valles,Total,1615,1591,24,1027
30 Veracruz de Ignacio de la Llave,207,207 Tres Valles,Total,1272,1246,26,883
30 Veracruz de Ignacio de la Llave,207,207 Tres Valles,Total,1016,992,24,842
30 Veracruz de Ignacio de la Llave,207,207 Tres Valles,Total,637,621,16,778
30 Veracruz de Ignacio de la Llave,207,207 Tres Valles,Total,427,414,13,718
30 Veracruz de Ignacio de la Llave,207,207 Tres Valles,Total,318,309,9,653
30 Veracruz de Ignacio de la Llave,207,207 Tres Valles,Total,162,155,7,448
30 Veracruz de Ignacio de la Llave,207,207 Tres Valles,Total,64,62,2,321
30 Veracruz de Ignacio de la Llave,207,207 Tres Valles,Total,37,37,0,306
30 Veracruz de Ignacio de la Llave,207,207 Tres Valles,Hombres,12554,12140,414,4177
30 Veracruz de Ignacio de la Llave,207,207 Tres Valles,Hombres,149,131,18,1235
30 Veracruz de Ignacio de la Llave,207,207 Tres Valles,Hombres,1098,1044,54,1264
30 Veracruz de Ignacio de la Llave,207,207 Tres Valles,Hombres,1524,1455,69,295
30 Veracruz de Ignacio de la Llave,207,207 Tres Valles,Hombres,1340,1284,56,75
30 Veracruz de Ignacio de la Llave,207,207 Tres Valles,Hombres,1258,1218,40,46
30 Veracruz de Ignacio de la Llave,207,207 Tres Valles,Hombres,1379,1343,36,33
30 Veracruz de Ignacio de la Llave,207,207 Tres Valles,Hombres,1349,1318,31,35
30 Veracruz de Ignacio de la Llave,207,207 Tres Valles,Hombres,1222,1201,21,41
30 Veracruz de Ignacio de la Llave,207,207 Tres Valles,Hombres,1003,982,21,72
30 Veracruz de Ignacio de la Llave,207,207 Tres Valles,Hombres,816,792,24,71
30 Veracruz de Ignacio de la Llave,207,207 Tres Valles,Hombres,542,526,16,187
30 Veracruz de Ignacio de la Llave,207,207 Tres Valles,Hombres,376,364,12,195
30 Veracruz de Ignacio de la Llave,207,207 Tres Valles,Hombres,268,260,8,195
30 Veracruz de Ignacio de la Llave,207,207 Tres Valles,Hombres,143,137,6,172
30 Veracruz de Ignacio de la Llave,207,207 Tres Valles,Hombres,54,52,2,126
30 Veracruz de Ignacio de la Llave,207,207 Tres Valles,Hombres,33,33,0,135
30 Veracruz de Ignacio de la Llave,207,207 Tres Valles,Mujeres,3912,3831,81,14282
30 Veracruz de Ignacio de la Llave,207,207 Tres Valles,Mujeres,17,17,0,1327
30 Veracruz de Ignacio de la Llave,207,207 Tres Valles,Mujeres,258,250,8,2011
30 Veracruz de Ignacio de la Llave,207,207 Tres Valles,Mujeres,513,489,24,1444
30 Veracruz de Ignacio de la Llave,207,207 Tres Valles,Mujeres,508,491,17,1171
30 Veracruz de Ignacio de la Llave,207,207 Tres Valles,Mujeres,517,510,7,1151
30 Veracruz de Ignacio de la Llave,207,207 Tres Valles,Mujeres,543,534,9,1248
30 Veracruz de Ignacio de la Llave,207,207 Tres Valles,Mujeres,465,460,5,1148
30 Veracruz de Ignacio de la Llave,207,207 Tres Valles,Mujeres,393,390,3,986
30 Veracruz de Ignacio de la Llave,207,207 Tres Valles,Mujeres,269,264,5,811
30 Veracruz de Ignacio de la Llave,207,207 Tres Valles,Mujeres,200,200,0,771
30 Veracruz de Ignacio de la Llave,207,207 Tres Valles,Mujeres,95,95,0,591
30 Veracruz de Ignacio de la Llave,207,207 Tres Valles,Mujeres,51,50,1,523
30 Veracruz de Ignacio de la Llave,207,207 Tres Valles,Mujeres,50,49,1,458
30 Veracruz de Ignacio de la Llave,207,207 Tres Valles,Mujeres,19,18,1,276
30 Veracruz de Ignacio de la Llave,207,207 Tres Valles,Mujeres,10,10,0,195
30 Veracruz de Ignacio de la Llave,207,207 Tres Valles,Mujeres,4,4,0,171
30 Veracruz de Ignacio de la Llave,189,189 Tuxpan,Total,58479,55635,2844,52544
30 Veracruz de Ignacio de la Llave,189,189 Tuxpan,Total,196,184,12,7567
30 Veracruz de Ignacio de la Llave,189,189 Tuxpan,Total,3147,2859,288,10366
30 Veracruz de Ignacio de la Llave,189,189 Tuxpan,Total,6681,6155,526,4945
30 Veracruz de Ignacio de la Llave,189,189 Tuxpan,Total,7174,6757,417,3016
30 Veracruz de Ignacio de la Llave,189,189 Tuxpan,Total,7054,6781,273,2997
30 Veracruz de Ignacio de la Llave,189,189 Tuxpan,Total,7499,7217,282,3127
30 Veracruz de Ignacio de la Llave,189,189 Tuxpan,Total,7226,6958,268,2962
30 Veracruz de Ignacio de la Llave,189,189 Tuxpan,Total,6179,5953,226,2571
30 Veracruz de Ignacio de la Llave,189,189 Tuxpan,Total,4575,4380,195,2560
30 Veracruz de Ignacio de la Llave,189,189 Tuxpan,Total,3315,3173,142,2425
30 Veracruz de Ignacio de la Llave,189,189 Tuxpan,Total,2258,2152,106,2617
30 Veracruz de Ignacio de la Llave,189,189 Tuxpan,Total,1486,1436,50,2284
30 Veracruz de Ignacio de la Llave,189,189 Tuxpan,Total,953,914,39,1991
30 Veracruz de Ignacio de la Llave,189,189 Tuxpan,Total,452,443,9,1381
30 Veracruz de Ignacio de la Llave,189,189 Tuxpan,Total,185,174,11,924
30 Veracruz de Ignacio de la Llave,189,189 Tuxpan,Total,99,99,0,811
30 Veracruz de Ignacio de la Llave,189,189 Tuxpan,Hombres,39291,36982,2309,13934
30 Veracruz de Ignacio de la Llave,189,189 Tuxpan,Hombres,135,128,7,3898
30 Veracruz de Ignacio de la Llave,189,189 Tuxpan,Hombres,2222,1993,229,4441
30 Veracruz de Ignacio de la Llave,189,189 Tuxpan,Hombres,4344,3976,368,1221
30 Veracruz de Ignacio de la Llave,189,189 Tuxpan,Hombres,4706,4399,307,228
30 Veracruz de Ignacio de la Llave,189,189 Tuxpan,Hombres,4582,4363,219,145
30 Veracruz de Ignacio de la Llave,189,189 Tuxpan,Hombres,4824,4590,234,127
30 Veracruz de Ignacio de la Llave,189,189 Tuxpan,Hombres,4587,4357,230,149
30 Veracruz de Ignacio de la Llave,189,189 Tuxpan,Hombres,4110,3911,199,156
30 Veracruz de Ignacio de la Llave,189,189 Tuxpan,Hombres,3179,2997,182,267
30 Veracruz de Ignacio de la Llave,189,189 Tuxpan,Hombres,2354,2222,132,355
30 Veracruz de Ignacio de la Llave,189,189 Tuxpan,Hombres,1670,1571,99,619
30 Veracruz de Ignacio de la Llave,189,189 Tuxpan,Hombres,1168,1119,49,607
30 Veracruz de Ignacio de la Llave,189,189 Tuxpan,Hombres,770,734,36,602
30 Veracruz de Ignacio de la Llave,189,189 Tuxpan,Hombres,393,384,9,485
30 Veracruz de Ignacio de la Llave,189,189 Tuxpan,Hombres,159,150,9,335
30 Veracruz de Ignacio de la Llave,189,189 Tuxpan,Hombres,88,88,0,299
30 Veracruz de Ignacio de la Llave,189,189 Tuxpan,Mujeres,19188,18653,535,38610
30 Veracruz de Ignacio de la Llave,189,189 Tuxpan,Mujeres,61,56,5,3669
30 Veracruz de Ignacio de la Llave,189,189 Tuxpan,Mujeres,925,866,59,5925
30 Veracruz de Ignacio de la Llave,189,189 Tuxpan,Mujeres,2337,2179,158,3724
30 Veracruz de Ignacio de la Llave,189,189 Tuxpan,Mujeres,2468,2358,110,2788
30 Veracruz de Ignacio de la Llave,189,189 Tuxpan,Mujeres,2472,2418,54,2852
30 Veracruz de Ignacio de la Llave,189,189 Tuxpan,Mujeres,2675,2627,48,3000
30 Veracruz de Ignacio de la Llave,189,189 Tuxpan,Mujeres,2639,2601,38,2813
30 Veracruz de Ignacio de la Llave,189,189 Tuxpan,Mujeres,2069,2042,27,2415
30 Veracruz de Ignacio de la Llave,189,189 Tuxpan,Mujeres,1396,1383,13,2293
30 Veracruz de Ignacio de la Llave,189,189 Tuxpan,Mujeres,961,951,10,2070
30 Veracruz de Ignacio de la Llave,189,189 Tuxpan,Mujeres,588,581,7,1998
30 Veracruz de Ignacio de la Llave,189,189 Tuxpan,Mujeres,318,317,1,1677
30 Veracruz de Ignacio de la Llave,189,189 Tuxpan,Mujeres,183,180,3,1389
30 Veracruz de Ignacio de la Llave,189,189 Tuxpan,Mujeres,59,59,0,896
30 Veracruz de Ignacio de la Llave,189,189 Tuxpan,Mujeres,26,24,2,589
30 Veracruz de Ignacio de la Llave,189,189 Tuxpan,Mujeres,11,11,0,512
30 Veracruz de Ignacio de la Llave,190,190 Tuxtilla,Total,731,672,59,1105
30 Veracruz de Ignacio de la Llave,190,190 Tuxtilla,Total,4,4,0,102
30 Veracruz de Ignacio de la Llave,190,190 Tuxtilla,Total,46,39,7,159
30 Veracruz de Ignacio de la Llave,190,190 Tuxtilla,Total,80,72,8,71
30 Veracruz de Ignacio de la Llave,190,190 Tuxtilla,Total,62,58,4,55
30 Veracruz de Ignacio de la Llave,190,190 Tuxtilla,Total,66,56,10,54
30 Veracruz de Ignacio de la Llave,190,190 Tuxtilla,Total,78,75,3,60
30 Veracruz de Ignacio de la Llave,190,190 Tuxtilla,Total,100,95,5,59
30 Veracruz de Ignacio de la Llave,190,190 Tuxtilla,Total,102,94,8,69
30 Veracruz de Ignacio de la Llave,190,190 Tuxtilla,Total,65,59,6,61
30 Veracruz de Ignacio de la Llave,190,190 Tuxtilla,Total,59,54,5,79
30 Veracruz de Ignacio de la Llave,190,190 Tuxtilla,Total,36,35,1,77
30 Veracruz de Ignacio de la Llave,190,190 Tuxtilla,Total,19,18,1,68
30 Veracruz de Ignacio de la Llave,190,190 Tuxtilla,Total,8,7,1,72
30 Veracruz de Ignacio de la Llave,190,190 Tuxtilla,Total,3,3,0,60
30 Veracruz de Ignacio de la Llave,190,190 Tuxtilla,Total,3,3,0,28
30 Veracruz de Ignacio de la Llave,190,190 Tuxtilla,Total,0,0,0,31
30 Veracruz de Ignacio de la Llave,190,190 Tuxtilla,Hombres,543,495,48,358
30 Veracruz de Ignacio de la Llave,190,190 Tuxtilla,Hombres,3,3,0,51
30 Veracruz de Ignacio de la Llave,190,190 Tuxtilla,Hombres,34,29,5,75
30 Veracruz de Ignacio de la Llave,190,190 Tuxtilla,Hombres,64,59,5,23
30 Veracruz de Ignacio de la Llave,190,190 Tuxtilla,Hombres,43,40,3,5
30 Veracruz de Ignacio de la Llave,190,190 Tuxtilla,Hombres,39,32,7,10
30 Veracruz de Ignacio de la Llave,190,190 Tuxtilla,Hombres,50,47,3,6
30 Veracruz de Ignacio de la Llave,190,190 Tuxtilla,Hombres,73,69,4,6
30 Veracruz de Ignacio de la Llave,190,190 Tuxtilla,Hombres,80,73,7,11
30 Veracruz de Ignacio de la Llave,190,190 Tuxtilla,Hombres,49,43,6,11
30 Veracruz de Ignacio de la Llave,190,190 Tuxtilla,Hombres,47,42,5,14
30 Veracruz de Ignacio de la Llave,190,190 Tuxtilla,Hombres,30,29,1,25
30 Veracruz de Ignacio de la Llave,190,190 Tuxtilla,Hombres,17,16,1,27
30 Veracruz de Ignacio de la Llave,190,190 Tuxtilla,Hombres,8,7,1,39
30 Veracruz de Ignacio de la Llave,190,190 Tuxtilla,Hombres,3,3,0,24
30 Veracruz de Ignacio de la Llave,190,190 Tuxtilla,Hombres,3,3,0,15
30 Veracruz de Ignacio de la Llave,190,190 Tuxtilla,Hombres,0,0,0,16
30 Veracruz de Ignacio de la Llave,190,190 Tuxtilla,Mujeres,188,177,11,747
30 Veracruz de Ignacio de la Llave,190,190 Tuxtilla,Mujeres,1,1,0,51
30 Veracruz de Ignacio de la Llave,190,190 Tuxtilla,Mujeres,12,10,2,84
30 Veracruz de Ignacio de la Llave,190,190 Tuxtilla,Mujeres,16,13,3,48
30 Veracruz de Ignacio de la Llave,190,190 Tuxtilla,Mujeres,19,18,1,50
30 Veracruz de Ignacio de la Llave,190,190 Tuxtilla,Mujeres,27,24,3,44
30 Veracruz de Ignacio de la Llave,190,190 Tuxtilla,Mujeres,28,28,0,54
30 Veracruz de Ignacio de la Llave,190,190 Tuxtilla,Mujeres,27,26,1,53
30 Veracruz de Ignacio de la Llave,190,190 Tuxtilla,Mujeres,22,21,1,58
30 Veracruz de Ignacio de la Llave,190,190 Tuxtilla,Mujeres,16,16,0,50
30 Veracruz de Ignacio de la Llave,190,190 Tuxtilla,Mujeres,12,12,0,65
30 Veracruz de Ignacio de la Llave,190,190 Tuxtilla,Mujeres,6,6,0,52
30 Veracruz de Ignacio de la Llave,190,190 Tuxtilla,Mujeres,2,2,0,41
30 Veracruz de Ignacio de la Llave,190,190 Tuxtilla,Mujeres,0,0,0,33
30 Veracruz de Ignacio de la Llave,190,190 Tuxtilla,Mujeres,0,0,0,36
30 Veracruz de Ignacio de la Llave,190,190 Tuxtilla,Mujeres,0,0,0,13
30 Veracruz de Ignacio de la Llave,190,190 Tuxtilla,Mujeres,0,0,0,15
30 Veracruz de Ignacio de la Llave,191,191 Ursulo Galván,Total,10861,10388,473,12724
30 Veracruz de Ignacio de la Llave,191,191 Ursulo Galván,Total,43,37,6,1422
30 Veracruz de Ignacio de la Llave,191,191 Ursulo Galván,Total,625,563,62,1971
30 Veracruz de Ignacio de la Llave,191,191 Ursulo Galván,Total,1120,1039,81,1053
30 Veracruz de Ignacio de la Llave,191,191 Ursulo Galván,Total,1257,1188,69,613
30 Veracruz de Ignacio de la Llave,191,191 Ursulo Galván,Total,1142,1088,54,667
30 Veracruz de Ignacio de la Llave,191,191 Ursulo Galván,Total,1429,1389,40,839
30 Veracruz de Ignacio de la Llave,191,191 Ursulo Galván,Total,1439,1392,47,852
30 Veracruz de Ignacio de la Llave,191,191 Ursulo Galván,Total,1212,1178,34,776
30 Veracruz de Ignacio de la Llave,191,191 Ursulo Galván,Total,1012,970,42,743
30 Veracruz de Ignacio de la Llave,191,191 Ursulo Galván,Total,731,711,20,682
30 Veracruz de Ignacio de la Llave,191,191 Ursulo Galván,Total,391,381,10,849
30 Veracruz de Ignacio de la Llave,191,191 Ursulo Galván,Total,223,216,7,659
30 Veracruz de Ignacio de la Llave,191,191 Ursulo Galván,Total,133,133,0,618
30 Veracruz de Ignacio de la Llave,191,191 Ursulo Galván,Total,61,60,1,446
30 Veracruz de Ignacio de la Llave,191,191 Ursulo Galván,Total,27,27,0,316
30 Veracruz de Ignacio de la Llave,191,191 Ursulo Galván,Total,16,16,0,218
30 Veracruz de Ignacio de la Llave,191,191 Ursulo Galván,Hombres,7823,7413,410,3456
30 Veracruz de Ignacio de la Llave,191,191 Ursulo Galván,Hombres,38,32,6,712
30 Veracruz de Ignacio de la Llave,191,191 Ursulo Galván,Hombres,480,427,53,840
30 Veracruz de Ignacio de la Llave,191,191 Ursulo Galván,Hombres,757,701,56,310
30 Veracruz de Ignacio de la Llave,191,191 Ursulo Galván,Hombres,851,792,59,66
30 Veracruz de Ignacio de la Llave,191,191 Ursulo Galván,Hombres,736,692,44,36
30 Veracruz de Ignacio de la Llave,191,191 Ursulo Galván,Hombres,1006,968,38,41
30 Veracruz de Ignacio de la Llave,191,191 Ursulo Galván,Hombres,1008,962,46,45
30 Veracruz de Ignacio de la Llave,191,191 Ursulo Galván,Hombres,852,821,31,50
30 Veracruz de Ignacio de la Llave,191,191 Ursulo Galván,Hombres,786,746,40,80
30 Veracruz de Ignacio de la Llave,191,191 Ursulo Galván,Hombres,599,579,20,112
30 Veracruz de Ignacio de la Llave,191,191 Ursulo Galván,Hombres,313,304,9,267
30 Veracruz de Ignacio de la Llave,191,191 Ursulo Galván,Hombres,196,189,7,252
30 Veracruz de Ignacio de la Llave,191,191 Ursulo Galván,Hombres,109,109,0,228
30 Veracruz de Ignacio de la Llave,191,191 Ursulo Galván,Hombres,57,56,1,195
30 Veracruz de Ignacio de la Llave,191,191 Ursulo Galván,Hombres,24,24,0,137
30 Veracruz de Ignacio de la Llave,191,191 Ursulo Galván,Hombres,11,11,0,85
30 Veracruz de Ignacio de la Llave,191,191 Ursulo Galván,Mujeres,3038,2975,63,9268
30 Veracruz de Ignacio de la Llave,191,191 Ursulo Galván,Mujeres,5,5,0,710
30 Veracruz de Ignacio de la Llave,191,191 Ursulo Galván,Mujeres,145,136,9,1131
30 Veracruz de Ignacio de la Llave,191,191 Ursulo Galván,Mujeres,363,338,25,743
30 Veracruz de Ignacio de la Llave,191,191 Ursulo Galván,Mujeres,406,396,10,547
30 Veracruz de Ignacio de la Llave,191,191 Ursulo Galván,Mujeres,406,396,10,631
30 Veracruz de Ignacio de la Llave,191,191 Ursulo Galván,Mujeres,423,421,2,798
30 Veracruz de Ignacio de la Llave,191,191 Ursulo Galván,Mujeres,431,430,1,807
30 Veracruz de Ignacio de la Llave,191,191 Ursulo Galván,Mujeres,360,357,3,726
30 Veracruz de Ignacio de la Llave,191,191 Ursulo Galván,Mujeres,226,224,2,663
30 Veracruz de Ignacio de la Llave,191,191 Ursulo Galván,Mujeres,132,132,0,570
30 Veracruz de Ignacio de la Llave,191,191 Ursulo Galván,Mujeres,78,77,1,582
30 Veracruz de Ignacio de la Llave,191,191 Ursulo Galván,Mujeres,27,27,0,407
30 Veracruz de Ignacio de la Llave,191,191 Ursulo Galván,Mujeres,24,24,0,390
30 Veracruz de Ignacio de la Llave,191,191 Ursulo Galván,Mujeres,4,4,0,251
30 Veracruz de Ignacio de la Llave,191,191 Ursulo Galván,Mujeres,3,3,0,179
30 Veracruz de Ignacio de la Llave,191,191 Ursulo Galván,Mujeres,5,5,0,133
30 Veracruz de Ignacio de la Llave,210,210 Uxpanapa,Total,8774,8601,173,10843
30 Veracruz de Ignacio de la Llave,210,210 Uxpanapa,Total,190,181,9,1973
30 Veracruz de Ignacio de la Llave,210,210 Uxpanapa,Total,1165,1100,65,2235
30 Veracruz de Ignacio de la Llave,210,210 Uxpanapa,Total,1181,1145,36,1083
30 Veracruz de Ignacio de la Llave,210,210 Uxpanapa,Total,1015,1003,12,900
30 Veracruz de Ignacio de la Llave,210,210 Uxpanapa,Total,938,925,13,878
30 Veracruz de Ignacio de la Llave,210,210 Uxpanapa,Total,877,868,9,717
30 Veracruz de Ignacio de la Llave,210,210 Uxpanapa,Total,748,740,8,562
30 Veracruz de Ignacio de la Llave,210,210 Uxpanapa,Total,610,605,5,577
30 Veracruz de Ignacio de la Llave,210,210 Uxpanapa,Total,550,544,6,463
30 Veracruz de Ignacio de la Llave,210,210 Uxpanapa,Total,492,487,5,409
30 Veracruz de Ignacio de la Llave,210,210 Uxpanapa,Total,355,353,2,334
30 Veracruz de Ignacio de la Llave,210,210 Uxpanapa,Total,292,290,2,230
30 Veracruz de Ignacio de la Llave,210,210 Uxpanapa,Total,188,187,1,198
30 Veracruz de Ignacio de la Llave,210,210 Uxpanapa,Total,92,92,0,126
30 Veracruz de Ignacio de la Llave,210,210 Uxpanapa,Total,47,47,0,67
30 Veracruz de Ignacio de la Llave,210,210 Uxpanapa,Total,34,34,0,91
30 Veracruz de Ignacio de la Llave,210,210 Uxpanapa,Hombres,7739,7603,136,2068
30 Veracruz de Ignacio de la Llave,210,210 Uxpanapa,Hombres,159,154,5,941
30 Veracruz de Ignacio de la Llave,210,210 Uxpanapa,Hombres,970,920,50,739
30 Veracruz de Ignacio de la Llave,210,210 Uxpanapa,Hombres,978,955,23,77
30 Veracruz de Ignacio de la Llave,210,210 Uxpanapa,Hombres,865,856,9,30
30 Veracruz de Ignacio de la Llave,210,210 Uxpanapa,Hombres,812,800,12,22
30 Veracruz de Ignacio de la Llave,210,210 Uxpanapa,Hombres,772,763,9,17
30 Veracruz de Ignacio de la Llave,210,210 Uxpanapa,Hombres,676,668,8,16
30 Veracruz de Ignacio de la Llave,210,210 Uxpanapa,Hombres,560,555,5,11
30 Veracruz de Ignacio de la Llave,210,210 Uxpanapa,Hombres,500,495,5,15
30 Veracruz de Ignacio de la Llave,210,210 Uxpanapa,Hombres,469,464,5,28
30 Veracruz de Ignacio de la Llave,210,210 Uxpanapa,Hombres,347,345,2,24
30 Veracruz de Ignacio de la Llave,210,210 Uxpanapa,Hombres,277,275,2,25
30 Veracruz de Ignacio de la Llave,210,210 Uxpanapa,Hombres,184,183,1,40
30 Veracruz de Ignacio de la Llave,210,210 Uxpanapa,Hombres,91,91,0,24
30 Veracruz de Ignacio de la Llave,210,210 Uxpanapa,Hombres,47,47,0,24
30 Veracruz de Ignacio de la Llave,210,210 Uxpanapa,Hombres,32,32,0,35
30 Veracruz de Ignacio de la Llave,210,210 Uxpanapa,Mujeres,1035,998,37,8775
30 Veracruz de Ignacio de la Llave,210,210 Uxpanapa,Mujeres,31,27,4,1032
30 Veracruz de Ignacio de la Llave,210,210 Uxpanapa,Mujeres,195,180,15,1496
30 Veracruz de Ignacio de la Llave,210,210 Uxpanapa,Mujeres,203,190,13,1006
30 Veracruz de Ignacio de la Llave,210,210 Uxpanapa,Mujeres,150,147,3,870
30 Veracruz de Ignacio de la Llave,210,210 Uxpanapa,Mujeres,126,125,1,856
30 Veracruz de Ignacio de la Llave,210,210 Uxpanapa,Mujeres,105,105,0,700
30 Veracruz de Ignacio de la Llave,210,210 Uxpanapa,Mujeres,72,72,0,546
30 Veracruz de Ignacio de la Llave,210,210 Uxpanapa,Mujeres,50,50,0,566
30 Veracruz de Ignacio de la Llave,210,210 Uxpanapa,Mujeres,50,49,1,448
30 Veracruz de Ignacio de la Llave,210,210 Uxpanapa,Mujeres,23,23,0,381
30 Veracruz de Ignacio de la Llave,210,210 Uxpanapa,Mujeres,8,8,0,310
30 Veracruz de Ignacio de la Llave,210,210 Uxpanapa,Mujeres,15,15,0,205
30 Veracruz de Ignacio de la Llave,210,210 Uxpanapa,Mujeres,4,4,0,158
30 Veracruz de Ignacio de la Llave,210,210 Uxpanapa,Mujeres,1,1,0,102
30 Veracruz de Ignacio de la Llave,210,210 Uxpanapa,Mujeres,0,0,0,43
30 Veracruz de Ignacio de la Llave,210,210 Uxpanapa,Mujeres,2,2,0,56
30 Veracruz de Ignacio de la Llave,192,192 Vega de Alatorre,Total,7945,7707,238,7429
30 Veracruz de Ignacio de la Llave,192,192 Vega de Alatorre,Total,77,73,4,1094
30 Veracruz de Ignacio de la Llave,192,192 Vega de Alatorre,Total,649,610,39,1337
30 Veracruz de Ignacio de la Llave,192,192 Vega de Alatorre,Total,875,832,43,576
30 Veracruz de Ignacio de la Llave,192,192 Vega de Alatorre,Total,732,707,25,417
30 Veracruz de Ignacio de la Llave,192,192 Vega de Alatorre,Total,783,764,19,463
30 Veracruz de Ignacio de la Llave,192,192 Vega de Alatorre,Total,887,864,23,461
30 Veracruz de Ignacio de la Llave,192,192 Vega de Alatorre,Total,937,914,23,421
30 Veracruz de Ignacio de la Llave,192,192 Vega de Alatorre,Total,769,747,22,406
30 Veracruz de Ignacio de la Llave,192,192 Vega de Alatorre,Total,655,644,11,399
30 Veracruz de Ignacio de la Llave,192,192 Vega de Alatorre,Total,532,529,3,360
30 Veracruz de Ignacio de la Llave,192,192 Vega de Alatorre,Total,389,379,10,332
30 Veracruz de Ignacio de la Llave,192,192 Vega de Alatorre,Total,274,266,8,280
30 Veracruz de Ignacio de la Llave,192,192 Vega de Alatorre,Total,209,204,5,351
30 Veracruz de Ignacio de la Llave,192,192 Vega de Alatorre,Total,113,112,1,225
30 Veracruz de Ignacio de la Llave,192,192 Vega de Alatorre,Total,41,39,2,139
30 Veracruz de Ignacio de la Llave,192,192 Vega de Alatorre,Total,23,23,0,168
30 Veracruz de Ignacio de la Llave,192,192 Vega de Alatorre,Hombres,5629,5438,191,1726
30 Veracruz de Ignacio de la Llave,192,192 Vega de Alatorre,Hombres,59,57,2,515
30 Veracruz de Ignacio de la Llave,192,192 Vega de Alatorre,Hombres,467,439,28,552
30 Veracruz de Ignacio de la Llave,192,192 Vega de Alatorre,Hombres,591,559,32,97
30 Veracruz de Ignacio de la Llave,192,192 Vega de Alatorre,Hombres,479,460,19,38
30 Veracruz de Ignacio de la Llave,192,192 Vega de Alatorre,Hombres,521,505,16,19
30 Veracruz de Ignacio de la Llave,192,192 Vega de Alatorre,Hombres,588,568,20,25
30 Veracruz de Ignacio de la Llave,192,192 Vega de Alatorre,Hombres,639,622,17,20
30 Veracruz de Ignacio de la Llave,192,192 Vega de Alatorre,Hombres,535,514,21,17
30 Veracruz de Ignacio de la Llave,192,192 Vega de Alatorre,Hombres,488,478,10,39
30 Veracruz de Ignacio de la Llave,192,192 Vega de Alatorre,Hombres,402,400,2,32
30 Veracruz de Ignacio de la Llave,192,192 Vega de Alatorre,Hombres,316,308,8,43
30 Veracruz de Ignacio de la Llave,192,192 Vega de Alatorre,Hombres,223,215,8,50
30 Veracruz de Ignacio de la Llave,192,192 Vega de Alatorre,Hombres,175,170,5,89
30 Veracruz de Ignacio de la Llave,192,192 Vega de Alatorre,Hombres,92,91,1,77
30 Veracruz de Ignacio de la Llave,192,192 Vega de Alatorre,Hombres,34,32,2,49
30 Veracruz de Ignacio de la Llave,192,192 Vega de Alatorre,Hombres,20,20,0,64
30 Veracruz de Ignacio de la Llave,192,192 Vega de Alatorre,Mujeres,2316,2269,47,5703
30 Veracruz de Ignacio de la Llave,192,192 Vega de Alatorre,Mujeres,18,16,2,579
30 Veracruz de Ignacio de la Llave,192,192 Vega de Alatorre,Mujeres,182,171,11,785
30 Veracruz de Ignacio de la Llave,192,192 Vega de Alatorre,Mujeres,284,273,11,479
30 Veracruz de Ignacio de la Llave,192,192 Vega de Alatorre,Mujeres,253,247,6,379
30 Veracruz de Ignacio de la Llave,192,192 Vega de Alatorre,Mujeres,262,259,3,444
30 Veracruz de Ignacio de la Llave,192,192 Vega de Alatorre,Mujeres,299,296,3,436
30 Veracruz de Ignacio de la Llave,192,192 Vega de Alatorre,Mujeres,298,292,6,401
30 Veracruz de Ignacio de la Llave,192,192 Vega de Alatorre,Mujeres,234,233,1,389
30 Veracruz de Ignacio de la Llave,192,192 Vega de Alatorre,Mujeres,167,166,1,360
30 Veracruz de Ignacio de la Llave,192,192 Vega de Alatorre,Mujeres,130,129,1,328
30 Veracruz de Ignacio de la Llave,192,192 Vega de Alatorre,Mujeres,73,71,2,289
30 Veracruz de Ignacio de la Llave,192,192 Vega de Alatorre,Mujeres,51,51,0,230
30 Veracruz de Ignacio de la Llave,192,192 Vega de Alatorre,Mujeres,34,34,0,262
30 Veracruz de Ignacio de la Llave,192,192 Vega de Alatorre,Mujeres,21,21,0,148
30 Veracruz de Ignacio de la Llave,192,192 Vega de Alatorre,Mujeres,7,7,0,90
30 Veracruz de Ignacio de la Llave,192,192 Vega de Alatorre,Mujeres,3,3,0,104
30 Veracruz de Ignacio de la Llave,193,193 Veracruz,Total,236884,227432,9452,188604
30 Veracruz de Ignacio de la Llave,193,193 Veracruz,Total,672,571,101,24074
30 Veracruz de Ignacio de la Llave,193,193 Veracruz,Total,11353,10169,1184,34948
30 Veracruz de Ignacio de la Llave,193,193 Veracruz,Total,27157,25367,1790,20155
30 Veracruz de Ignacio de la Llave,193,193 Veracruz,Total,32641,31095,1546,11294
30 Veracruz de Ignacio de la Llave,193,193 Veracruz,Total,31066,30060,1006,10244
30 Veracruz de Ignacio de la Llave,193,193 Veracruz,Total,32249,31426,823,10377
30 Veracruz de Ignacio de la Llave,193,193 Veracruz,Total,29271,28559,712,9488
30 Veracruz de Ignacio de la Llave,193,193 Veracruz,Total,24363,23708,655,8807
30 Veracruz de Ignacio de la Llave,193,193 Veracruz,Total,19885,19344,541,9596
30 Veracruz de Ignacio de la Llave,193,193 Veracruz,Total,13506,13062,444,9523
30 Veracruz de Ignacio de la Llave,193,193 Veracruz,Total,7492,7204,288,10571
30 Veracruz de Ignacio de la Llave,193,193 Veracruz,Total,3693,3535,158,8737
30 Veracruz de Ignacio de la Llave,193,193 Veracruz,Total,1957,1865,92,7768
30 Veracruz de Ignacio de la Llave,193,193 Veracruz,Total,979,920,59,5730
30 Veracruz de Ignacio de la Llave,193,193 Veracruz,Total,392,358,34,4049
30 Veracruz de Ignacio de la Llave,193,193 Veracruz,Total,208,189,19,3243
30 Veracruz de Ignacio de la Llave,193,193 Veracruz,Hombres,145496,138679,6817,51776
30 Veracruz de Ignacio de la Llave,193,193 Veracruz,Hombres,503,421,82,12040
30 Veracruz de Ignacio de la Llave,193,193 Veracruz,Hombres,7850,6957,893,15215
30 Veracruz de Ignacio de la Llave,193,193 Veracruz,Hombres,16600,15473,1127,6223
30 Veracruz de Ignacio de la Llave,193,193 Veracruz,Hombres,19635,18666,969,1172
30 Veracruz de Ignacio de la Llave,193,193 Veracruz,Hombres,18530,17837,693,479
30 Veracruz de Ignacio de la Llave,193,193 Veracruz,Hombres,19181,18603,578,383
30 Veracruz de Ignacio de la Llave,193,193 Veracruz,Hombres,17257,16739,518,459
30 Veracruz de Ignacio de la Llave,193,193 Veracruz,Hombres,14692,14166,526,538
30 Veracruz de Ignacio de la Llave,193,193 Veracruz,Hombres,12335,11891,444,991
30 Veracruz de Ignacio de la Llave,193,193 Veracruz,Hombres,8864,8476,388,1630
30 Veracruz de Ignacio de la Llave,193,193 Veracruz,Hombres,5018,4755,263,2901
30 Veracruz de Ignacio de la Llave,193,193 Veracruz,Hombres,2519,2369,150,2887
30 Veracruz de Ignacio de la Llave,193,193 Veracruz,Hombres,1351,1268,83,2571
30 Veracruz de Ignacio de la Llave,193,193 Veracruz,Hombres,711,653,58,1916
30 Veracruz de Ignacio de la Llave,193,193 Veracruz,Hombres,299,269,30,1377
30 Veracruz de Ignacio de la Llave,193,193 Veracruz,Hombres,151,136,15,994
30 Veracruz de Ignacio de la Llave,193,193 Veracruz,Mujeres,91388,88753,2635,136828
30 Veracruz de Ignacio de la Llave,193,193 Veracruz,Mujeres,169,150,19,12034
30 Veracruz de Ignacio de la Llave,193,193 Veracruz,Mujeres,3503,3212,291,19733
30 Veracruz de Ignacio de la Llave,193,193 Veracruz,Mujeres,10557,9894,663,13932
30 Veracruz de Ignacio de la Llave,193,193 Veracruz,Mujeres,13006,12429,577,10122
30 Veracruz de Ignacio de la Llave,193,193 Veracruz,Mujeres,12536,12223,313,9765
30 Veracruz de Ignacio de la Llave,193,193 Veracruz,Mujeres,13068,12823,245,9994
30 Veracruz de Ignacio de la Llave,193,193 Veracruz,Mujeres,12014,11820,194,9029
30 Veracruz de Ignacio de la Llave,193,193 Veracruz,Mujeres,9671,9542,129,8269
30 Veracruz de Ignacio de la Llave,193,193 Veracruz,Mujeres,7550,7453,97,8605
30 Veracruz de Ignacio de la Llave,193,193 Veracruz,Mujeres,4642,4586,56,7893
30 Veracruz de Ignacio de la Llave,193,193 Veracruz,Mujeres,2474,2449,25,7670
30 Veracruz de Ignacio de la Llave,193,193 Veracruz,Mujeres,1174,1166,8,5850
30 Veracruz de Ignacio de la Llave,193,193 Veracruz,Mujeres,606,597,9,5197
30 Veracruz de Ignacio de la Llave,193,193 Veracruz,Mujeres,268,267,1,3814
30 Veracruz de Ignacio de la Llave,193,193 Veracruz,Mujeres,93,89,4,2672
30 Veracruz de Ignacio de la Llave,193,193 Veracruz,Mujeres,57,53,4,2249
30 Veracruz de Ignacio de la Llave,194,194 Villa Aldama,Total,3254,3179,75,4052
30 Veracruz de Ignacio de la Llave,194,194 Villa Aldama,Total,39,38,1,688
30 Veracruz de Ignacio de la Llave,194,194 Villa Aldama,Total,387,373,14,756
30 Veracruz de Ignacio de la Llave,194,194 Villa Aldama,Total,512,505,7,424
30 Veracruz de Ignacio de la Llave,194,194 Villa Aldama,Total,453,447,6,367
30 Veracruz de Ignacio de la Llave,194,194 Villa Aldama,Total,421,416,5,365
30 Veracruz de Ignacio de la Llave,194,194 Villa Aldama,Total,374,364,10,261
30 Veracruz de Ignacio de la Llave,194,194 Villa Aldama,Total,300,291,9,224
30 Veracruz de Ignacio de la Llave,194,194 Villa Aldama,Total,262,254,8,206
30 Veracruz de Ignacio de la Llave,194,194 Villa Aldama,Total,162,156,6,175
30 Veracruz de Ignacio de la Llave,194,194 Villa Aldama,Total,130,126,4,140
30 Veracruz de Ignacio de la Llave,194,194 Villa Aldama,Total,71,68,3,110
30 Veracruz de Ignacio de la Llave,194,194 Villa Aldama,Total,56,54,2,85
30 Veracruz de Ignacio de la Llave,194,194 Villa Aldama,Total,51,51,0,92
30 Veracruz de Ignacio de la Llave,194,194 Villa Aldama,Total,18,18,0,57
30 Veracruz de Ignacio de la Llave,194,194 Villa Aldama,Total,10,10,0,43
30 Veracruz de Ignacio de la Llave,194,194 Villa Aldama,Total,8,8,0,59
30 Veracruz de Ignacio de la Llave,194,194 Villa Aldama,Hombres,2743,2671,72,795
30 Veracruz de Ignacio de la Llave,194,194 Villa Aldama,Hombres,34,34,0,318
30 Veracruz de Ignacio de la Llave,194,194 Villa Aldama,Hombres,322,308,14,279
30 Veracruz de Ignacio de la Llave,194,194 Villa Aldama,Hombres,415,409,6,33
30 Veracruz de Ignacio de la Llave,194,194 Villa Aldama,Hombres,383,377,6,9
30 Veracruz de Ignacio de la Llave,194,194 Villa Aldama,Hombres,354,349,5,8
30 Veracruz de Ignacio de la Llave,194,194 Villa Aldama,Hombres,312,302,10,9
30 Veracruz de Ignacio de la Llave,194,194 Villa Aldama,Hombres,257,248,9,7
30 Veracruz de Ignacio de la Llave,194,194 Villa Aldama,Hombres,227,219,8,8
30 Veracruz de Ignacio de la Llave,194,194 Villa Aldama,Hombres,140,134,6,16
30 Veracruz de Ignacio de la Llave,194,194 Villa Aldama,Hombres,112,109,3,13
30 Veracruz de Ignacio de la Llave,194,194 Villa Aldama,Hombres,63,60,3,16
30 Veracruz de Ignacio de la Llave,194,194 Villa Aldama,Hombres,50,48,2,18
30 Veracruz de Ignacio de la Llave,194,194 Villa Aldama,Hombres,45,45,0,21
30 Veracruz de Ignacio de la Llave,194,194 Villa Aldama,Hombres,14,14,0,14
30 Veracruz de Ignacio de la Llave,194,194 Villa Aldama,Hombres,9,9,0,12
30 Veracruz de Ignacio de la Llave,194,194 Villa Aldama,Hombres,6,6,0,14
30 Veracruz de Ignacio de la Llave,194,194 Villa Aldama,Mujeres,511,508,3,3257
30 Veracruz de Ignacio de la Llave,194,194 Villa Aldama,Mujeres,5,4,1,370
30 Veracruz de Ignacio de la Llave,194,194 Villa Aldama,Mujeres,65,65,0,477
30 Veracruz de Ignacio de la Llave,194,194 Villa Aldama,Mujeres,97,96,1,391
30 Veracruz de Ignacio de la Llave,194,194 Villa Aldama,Mujeres,70,70,0,358
30 Veracruz de Ignacio de la Llave,194,194 Villa Aldama,Mujeres,67,67,0,357
30 Veracruz de Ignacio de la Llave,194,194 Villa Aldama,Mujeres,62,62,0,252
30 Veracruz de Ignacio de la Llave,194,194 Villa Aldama,Mujeres,43,43,0,217
30 Veracruz de Ignacio de la Llave,194,194 Villa Aldama,Mujeres,35,35,0,198
30 Veracruz de Ignacio de la Llave,194,194 Villa Aldama,Mujeres,22,22,0,159
30 Veracruz de Ignacio de la Llave,194,194 Villa Aldama,Mujeres,18,17,1,127
30 Veracruz de Ignacio de la Llave,194,194 Villa Aldama,Mujeres,8,8,0,94
30 Veracruz de Ignacio de la Llave,194,194 Villa Aldama,Mujeres,6,6,0,67
30 Veracruz de Ignacio de la Llave,194,194 Villa Aldama,Mujeres,6,6,0,71
30 Veracruz de Ignacio de la Llave,194,194 Villa Aldama,Mujeres,4,4,0,43
30 Veracruz de Ignacio de la Llave,194,194 Villa Aldama,Mujeres,1,1,0,31
30 Veracruz de Ignacio de la Llave,194,194 Villa Aldama,Mujeres,2,2,0,45
30 Veracruz de Ignacio de la Llave,87,087 Xalapa,Total,198673,192193,6480,152004
30 Veracruz de Ignacio de la Llave,87,087 Xalapa,Total,639,590,49,20863
30 Veracruz de Ignacio de la Llave,87,087 Xalapa,Total,9646,8879,767,31655
30 Veracruz de Ignacio de la Llave,87,087 Xalapa,Total,21571,20297,1274,20890
30 Veracruz de Ignacio de la Llave,87,087 Xalapa,Total,27089,25956,1133,9036
30 Veracruz de Ignacio de la Llave,87,087 Xalapa,Total,26526,25836,690,7456
30 Veracruz de Ignacio de la Llave,87,087 Xalapa,Total,26775,26210,565,7044
30 Veracruz de Ignacio de la Llave,87,087 Xalapa,Total,24183,23706,477,6187
30 Veracruz de Ignacio de la Llave,87,087 Xalapa,Total,20519,20125,394,6000
30 Veracruz de Ignacio de la Llave,87,087 Xalapa,Total,16847,16491,356,6797
30 Veracruz de Ignacio de la Llave,87,087 Xalapa,Total,11172,10866,306,7083
30 Veracruz de Ignacio de la Llave,87,087 Xalapa,Total,6719,6522,197,7416
30 Veracruz de Ignacio de la Llave,87,087 Xalapa,Total,3407,3283,124,6149
30 Veracruz de Ignacio de la Llave,87,087 Xalapa,Total,1926,1849,77,5490
30 Veracruz de Ignacio de la Llave,87,087 Xalapa,Total,1015,970,45,4209
30 Veracruz de Ignacio de la Llave,87,087 Xalapa,Total,421,408,13,3020
30 Veracruz de Ignacio de la Llave,87,087 Xalapa,Total,218,205,13,2709
30 Veracruz de Ignacio de la Llave,87,087 Xalapa,Hombres,114583,110026,4557,44628
30 Veracruz de Ignacio de la Llave,87,087 Xalapa,Hombres,501,454,47,10421
30 Veracruz de Ignacio de la Llave,87,087 Xalapa,Hombres,6566,5984,582,13907
30 Veracruz de Ignacio de la Llave,87,087 Xalapa,Hombres,12698,11960,738,7305
30 Veracruz de Ignacio de la Llave,87,087 Xalapa,Hombres,15161,14477,684,1444
30 Veracruz de Ignacio de la Llave,87,087 Xalapa,Hombres,14835,14389,446,433
30 Veracruz de Ignacio de la Llave,87,087 Xalapa,Hombres,14618,14210,408,335
30 Veracruz de Ignacio de la Llave,87,087 Xalapa,Hombres,13100,12746,354,282
30 Veracruz de Ignacio de la Llave,87,087 Xalapa,Hombres,11283,10980,303,343
30 Veracruz de Ignacio de la Llave,87,087 Xalapa,Hombres,9696,9393,303,708
30 Veracruz de Ignacio de la Llave,87,087 Xalapa,Hombres,6885,6614,271,1237
30 Veracruz de Ignacio de la Llave,87,087 Xalapa,Hombres,4370,4201,169,1787
30 Veracruz de Ignacio de la Llave,87,087 Xalapa,Hombres,2324,2212,112,1721
30 Veracruz de Ignacio de la Llave,87,087 Xalapa,Hombres,1346,1274,72,1595
30 Veracruz de Ignacio de la Llave,87,087 Xalapa,Hombres,729,686,43,1297
30 Veracruz de Ignacio de la Llave,87,087 Xalapa,Hombres,314,302,12,950
30 Veracruz de Ignacio de la Llave,87,087 Xalapa,Hombres,157,144,13,863
30 Veracruz de Ignacio de la Llave,87,087 Xalapa,Mujeres,84090,82167,1923,107376
30 Veracruz de Ignacio de la Llave,87,087 Xalapa,Mujeres,138,136,2,10442
30 Veracruz de Ignacio de la Llave,87,087 Xalapa,Mujeres,3080,2895,185,17748
30 Veracruz de Ignacio de la Llave,87,087 Xalapa,Mujeres,8873,8337,536,13585
30 Veracruz de Ignacio de la Llave,87,087 Xalapa,Mujeres,11928,11479,449,7592
30 Veracruz de Ignacio de la Llave,87,087 Xalapa,Mujeres,11691,11447,244,7023
30 Veracruz de Ignacio de la Llave,87,087 Xalapa,Mujeres,12157,12000,157,6709
30 Veracruz de Ignacio de la Llave,87,087 Xalapa,Mujeres,11083,10960,123,5905
30 Veracruz de Ignacio de la Llave,87,087 Xalapa,Mujeres,9236,9145,91,5657
30 Veracruz de Ignacio de la Llave,87,087 Xalapa,Mujeres,7151,7098,53,6089
30 Veracruz de Ignacio de la Llave,87,087 Xalapa,Mujeres,4287,4252,35,5846
30 Veracruz de Ignacio de la Llave,87,087 Xalapa,Mujeres,2349,2321,28,5629
30 Veracruz de Ignacio de la Llave,87,087 Xalapa,Mujeres,1083,1071,12,4428
30 Veracruz de Ignacio de la Llave,87,087 Xalapa,Mujeres,580,575,5,3895
30 Veracruz de Ignacio de la Llave,87,087 Xalapa,Mujeres,286,284,2,2912
30 Veracruz de Ignacio de la Llave,87,087 Xalapa,Mujeres,107,106,1,2070
30 Veracruz de Ignacio de la Llave,87,087 Xalapa,Mujeres,61,61,0,1846
30 Veracruz de Ignacio de la Llave,92,092 Xico,Total,13796,13307,489,12464
30 Veracruz de Ignacio de la Llave,92,092 Xico,Total,216,206,10,1868
30 Veracruz de Ignacio de la Llave,92,092 Xico,Total,1270,1176,94,2121
30 Veracruz de Ignacio de la Llave,92,092 Xico,Total,1771,1675,96,1394
30 Veracruz de Ignacio de la Llave,92,092 Xico,Total,1864,1794,70,1114
30 Veracruz de Ignacio de la Llave,92,092 Xico,Total,1828,1780,48,974
30 Veracruz de Ignacio de la Llave,92,092 Xico,Total,1647,1608,39,784
30 Veracruz de Ignacio de la Llave,92,092 Xico,Total,1282,1250,32,633
30 Veracruz de Ignacio de la Llave,92,092 Xico,Total,1048,1023,25,579
30 Veracruz de Ignacio de la Llave,92,092 Xico,Total,886,867,19,553
30 Veracruz de Ignacio de la Llave,92,092 Xico,Total,691,663,28,548
30 Veracruz de Ignacio de la Llave,92,092 Xico,Total,508,496,12,486
30 Veracruz de Ignacio de la Llave,92,092 Xico,Total,319,308,11,378
30 Veracruz de Ignacio de la Llave,92,092 Xico,Total,242,240,2,369
30 Veracruz de Ignacio de la Llave,92,092 Xico,Total,135,133,2,266
30 Veracruz de Ignacio de la Llave,92,092 Xico,Total,52,51,1,179
30 Veracruz de Ignacio de la Llave,92,092 Xico,Total,37,37,0,218
30 Veracruz de Ignacio de la Llave,92,092 Xico,Hombres,10125,9709,416,2542
30 Veracruz de Ignacio de la Llave,92,092 Xico,Hombres,148,138,10,892
30 Veracruz de Ignacio de la Llave,92,092 Xico,Hombres,984,903,81,727
30 Veracruz de Ignacio de la Llave,92,092 Xico,Hombres,1361,1286,75,236
30 Veracruz de Ignacio de la Llave,92,092 Xico,Hombres,1374,1319,55,76
30 Veracruz de Ignacio de la Llave,92,092 Xico,Hombres,1286,1247,39,25
30 Veracruz de Ignacio de la Llave,92,092 Xico,Hombres,1185,1150,35,27
30 Veracruz de Ignacio de la Llave,92,092 Xico,Hombres,853,824,29,30
30 Veracruz de Ignacio de la Llave,92,092 Xico,Hombres,742,719,23,29
30 Veracruz de Ignacio de la Llave,92,092 Xico,Hombres,597,582,15,37
30 Veracruz de Ignacio de la Llave,92,092 Xico,Hombres,528,501,27,63
30 Veracruz de Ignacio de la Llave,92,092 Xico,Hombres,406,394,12,73
30 Veracruz de Ignacio de la Llave,92,092 Xico,Hombres,257,247,10,69
30 Veracruz de Ignacio de la Llave,92,092 Xico,Hombres,208,206,2,85
30 Veracruz de Ignacio de la Llave,92,092 Xico,Hombres,117,115,2,48
30 Veracruz de Ignacio de la Llave,92,092 Xico,Hombres,46,45,1,49
30 Veracruz de Ignacio de la Llave,92,092 Xico,Hombres,33,33,0,76
30 Veracruz de Ignacio de la Llave,92,092 Xico,Mujeres,3671,3598,73,9922
30 Veracruz de Ignacio de la Llave,92,092 Xico,Mujeres,68,68,0,976
30 Veracruz de Ignacio de la Llave,92,092 Xico,Mujeres,286,273,13,1394
30 Veracruz de Ignacio de la Llave,92,092 Xico,Mujeres,410,389,21,1158
30 Veracruz de Ignacio de la Llave,92,092 Xico,Mujeres,490,475,15,1038
30 Veracruz de Ignacio de la Llave,92,092 Xico,Mujeres,542,533,9,949
30 Veracruz de Ignacio de la Llave,92,092 Xico,Mujeres,462,458,4,757
30 Veracruz de Ignacio de la Llave,92,092 Xico,Mujeres,429,426,3,603
30 Veracruz de Ignacio de la Llave,92,092 Xico,Mujeres,306,304,2,550
30 Veracruz de Ignacio de la Llave,92,092 Xico,Mujeres,289,285,4,516
30 Veracruz de Ignacio de la Llave,92,092 Xico,Mujeres,163,162,1,485
30 Veracruz de Ignacio de la Llave,92,092 Xico,Mujeres,102,102,0,413
30 Veracruz de Ignacio de la Llave,92,092 Xico,Mujeres,62,61,1,309
30 Veracruz de Ignacio de la Llave,92,092 Xico,Mujeres,34,34,0,284
30 Veracruz de Ignacio de la Llave,92,092 Xico,Mujeres,18,18,0,218
30 Veracruz de Ignacio de la Llave,92,092 Xico,Mujeres,6,6,0,130
30 Veracruz de Ignacio de la Llave,92,092 Xico,Mujeres,4,4,0,142
30 Veracruz de Ignacio de la Llave,195,195 Xoxocotla,Total,1212,1149,63,2414
30 Veracruz de Ignacio de la Llave,195,195 Xoxocotla,Total,20,17,3,414
30 Veracruz de Ignacio de la Llave,195,195 Xoxocotla,Total,123,114,9,522
30 Veracruz de Ignacio de la Llave,195,195 Xoxocotla,Total,184,173,11,248
30 Veracruz de Ignacio de la Llave,195,195 Xoxocotla,Total,168,159,9,216
30 Veracruz de Ignacio de la Llave,195,195 Xoxocotla,Total,150,146,4,175
30 Veracruz de Ignacio de la Llave,195,195 Xoxocotla,Total,145,140,5,142
30 Veracruz de Ignacio de la Llave,195,195 Xoxocotla,Total,107,101,6,153
30 Veracruz de Ignacio de la Llave,195,195 Xoxocotla,Total,94,92,2,119
30 Veracruz de Ignacio de la Llave,195,195 Xoxocotla,Total,64,59,5,79
30 Veracruz de Ignacio de la Llave,195,195 Xoxocotla,Total,65,62,3,85
30 Veracruz de Ignacio de la Llave,195,195 Xoxocotla,Total,37,35,2,55
30 Veracruz de Ignacio de la Llave,195,195 Xoxocotla,Total,27,27,0,62
30 Veracruz de Ignacio de la Llave,195,195 Xoxocotla,Total,16,15,1,47
30 Veracruz de Ignacio de la Llave,195,195 Xoxocotla,Total,9,7,2,39
30 Veracruz de Ignacio de la Llave,195,195 Xoxocotla,Total,2,2,0,34
30 Veracruz de Ignacio de la Llave,195,195 Xoxocotla,Total,1,0,1,24
30 Veracruz de Ignacio de la Llave,195,195 Xoxocotla,Hombres,1100,1040,60,713
30 Veracruz de Ignacio de la Llave,195,195 Xoxocotla,Hombres,18,15,3,214
30 Veracruz de Ignacio de la Llave,195,195 Xoxocotla,Hombres,108,101,7,208
30 Veracruz de Ignacio de la Llave,195,195 Xoxocotla,Hombres,163,152,11,58
30 Veracruz de Ignacio de la Llave,195,195 Xoxocotla,Hombres,151,142,9,40
30 Veracruz de Ignacio de la Llave,195,195 Xoxocotla,Hombres,140,136,4,30
30 Veracruz de Ignacio de la Llave,195,195 Xoxocotla,Hombres,131,126,5,22
30 Veracruz de Ignacio de la Llave,195,195 Xoxocotla,Hombres,98,92,6,25
30 Veracruz de Ignacio de la Llave,195,195 Xoxocotla,Hombres,88,86,2,21
30 Veracruz de Ignacio de la Llave,195,195 Xoxocotla,Hombres,57,52,5,16
30 Veracruz de Ignacio de la Llave,195,195 Xoxocotla,Hombres,63,60,3,15
30 Veracruz de Ignacio de la Llave,195,195 Xoxocotla,Hombres,34,32,2,10
30 Veracruz de Ignacio de la Llave,195,195 Xoxocotla,Hombres,23,23,0,15
30 Veracruz de Ignacio de la Llave,195,195 Xoxocotla,Hombres,15,14,1,13
30 Veracruz de Ignacio de la Llave,195,195 Xoxocotla,Hombres,9,7,2,10
30 Veracruz de Ignacio de la Llave,195,195 Xoxocotla,Hombres,2,2,0,10
30 Veracruz de Ignacio de la Llave,195,195 Xoxocotla,Hombres,0,0,0,6
30 Veracruz de Ignacio de la Llave,195,195 Xoxocotla,Mujeres,112,109,3,1701
30 Veracruz de Ignacio de la Llave,195,195 Xoxocotla,Mujeres,2,2,0,200
30 Veracruz de Ignacio de la Llave,195,195 Xoxocotla,Mujeres,15,13,2,314
30 Veracruz de Ignacio de la Llave,195,195 Xoxocotla,Mujeres,21,21,0,190
30 Veracruz de Ignacio de la Llave,195,195 Xoxocotla,Mujeres,17,17,0,176
30 Veracruz de Ignacio de la Llave,195,195 Xoxocotla,Mujeres,10,10,0,145
30 Veracruz de Ignacio de la Llave,195,195 Xoxocotla,Mujeres,14,14,0,120
30 Veracruz de Ignacio de la Llave,195,195 Xoxocotla,Mujeres,9,9,0,128
30 Veracruz de Ignacio de la Llave,195,195 Xoxocotla,Mujeres,6,6,0,98
30 Veracruz de Ignacio de la Llave,195,195 Xoxocotla,Mujeres,7,7,0,63
30 Veracruz de Ignacio de la Llave,195,195 Xoxocotla,Mujeres,2,2,0,70
30 Veracruz de Ignacio de la Llave,195,195 Xoxocotla,Mujeres,3,3,0,45
30 Veracruz de Ignacio de la Llave,195,195 Xoxocotla,Mujeres,4,4,0,47
30 Veracruz de Ignacio de la Llave,195,195 Xoxocotla,Mujeres,1,1,0,34
30 Veracruz de Ignacio de la Llave,195,195 Xoxocotla,Mujeres,0,0,0,29
30 Veracruz de Ignacio de la Llave,195,195 Xoxocotla,Mujeres,0,0,0,24
30 Veracruz de Ignacio de la Llave,195,195 Xoxocotla,Mujeres,1,0,1,18
30 Veracruz de Ignacio de la Llave,196,196 Yanga,Total,6279,6061,218,7308
30 Veracruz de Ignacio de la Llave,196,196 Yanga,Total,50,49,1,845
30 Veracruz de Ignacio de la Llave,196,196 Yanga,Total,530,488,42,1097
30 Veracruz de Ignacio de la Llave,196,196 Yanga,Total,770,729,41,661
30 Veracruz de Ignacio de la Llave,196,196 Yanga,Total,720,690,30,455
30 Veracruz de Ignacio de la Llave,196,196 Yanga,Total,678,657,21,467
30 Veracruz de Ignacio de la Llave,196,196 Yanga,Total,781,760,21,499
30 Veracruz de Ignacio de la Llave,196,196 Yanga,Total,692,679,13,467
30 Veracruz de Ignacio de la Llave,196,196 Yanga,Total,609,595,14,429
30 Veracruz de Ignacio de la Llave,196,196 Yanga,Total,474,462,12,363
30 Veracruz de Ignacio de la Llave,196,196 Yanga,Total,397,390,7,379
30 Veracruz de Ignacio de la Llave,196,196 Yanga,Total,267,257,10,383
30 Veracruz de Ignacio de la Llave,196,196 Yanga,Total,157,155,2,348
30 Veracruz de Ignacio de la Llave,196,196 Yanga,Total,97,95,2,306
30 Veracruz de Ignacio de la Llave,196,196 Yanga,Total,37,35,2,264
30 Veracruz de Ignacio de la Llave,196,196 Yanga,Total,14,14,0,164
30 Veracruz de Ignacio de la Llave,196,196 Yanga,Total,6,6,0,181
30 Veracruz de Ignacio de la Llave,196,196 Yanga,Hombres,4569,4386,183,1717
30 Veracruz de Ignacio de la Llave,196,196 Yanga,Hombres,38,37,1,409
30 Veracruz de Ignacio de la Llave,196,196 Yanga,Hombres,404,367,37,399
30 Veracruz de Ignacio de la Llave,196,196 Yanga,Hombres,528,497,31,132
30 Veracruz de Ignacio de la Llave,196,196 Yanga,Hombres,477,459,18,38
30 Veracruz de Ignacio de la Llave,196,196 Yanga,Hombres,466,447,19,24
30 Veracruz de Ignacio de la Llave,196,196 Yanga,Hombres,562,545,17,30
30 Veracruz de Ignacio de la Llave,196,196 Yanga,Hombres,497,485,12,33
30 Veracruz de Ignacio de la Llave,196,196 Yanga,Hombres,454,440,14,23
30 Veracruz de Ignacio de la Llave,196,196 Yanga,Hombres,353,341,12,35
30 Veracruz de Ignacio de la Llave,196,196 Yanga,Hombres,303,296,7,38
30 Veracruz de Ignacio de la Llave,196,196 Yanga,Hombres,220,210,10,98
30 Veracruz de Ignacio de la Llave,196,196 Yanga,Hombres,136,134,2,102
30 Veracruz de Ignacio de la Llave,196,196 Yanga,Hombres,81,80,1,123
30 Veracruz de Ignacio de la Llave,196,196 Yanga,Hombres,33,31,2,91
30 Veracruz de Ignacio de la Llave,196,196 Yanga,Hombres,11,11,0,57
30 Veracruz de Ignacio de la Llave,196,196 Yanga,Hombres,6,6,0,85
30 Veracruz de Ignacio de la Llave,196,196 Yanga,Mujeres,1710,1675,35,5591
30 Veracruz de Ignacio de la Llave,196,196 Yanga,Mujeres,12,12,0,436
30 Veracruz de Ignacio de la Llave,196,196 Yanga,Mujeres,126,121,5,698
30 Veracruz de Ignacio de la Llave,196,196 Yanga,Mujeres,242,232,10,529
30 Veracruz de Ignacio de la Llave,196,196 Yanga,Mujeres,243,231,12,417
30 Veracruz de Ignacio de la Llave,196,196 Yanga,Mujeres,212,210,2,443
30 Veracruz de Ignacio de la Llave,196,196 Yanga,Mujeres,219,215,4,469
30 Veracruz de Ignacio de la Llave,196,196 Yanga,Mujeres,195,194,1,434
30 Veracruz de Ignacio de la Llave,196,196 Yanga,Mujeres,155,155,0,406
30 Veracruz de Ignacio de la Llave,196,196 Yanga,Mujeres,121,121,0,328
30 Veracruz de Ignacio de la Llave,196,196 Yanga,Mujeres,94,94,0,341
30 Veracruz de Ignacio de la Llave,196,196 Yanga,Mujeres,47,47,0,285
30 Veracruz de Ignacio de la Llave,196,196 Yanga,Mujeres,21,21,0,246
30 Veracruz de Ignacio de la Llave,196,196 Yanga,Mujeres,16,15,1,183
30 Veracruz de Ignacio de la Llave,196,196 Yanga,Mujeres,4,4,0,173
30 Veracruz de Ignacio de la Llave,196,196 Yanga,Mujeres,3,3,0,107
30 Veracruz de Ignacio de la Llave,196,196 Yanga,Mujeres,0,0,0,96
30 Veracruz de Ignacio de la Llave,197,197 Yecuatla,Total,3887,3721,166,4922
30 Veracruz de Ignacio de la Llave,197,197 Yecuatla,Total,85,83,2,740
30 Veracruz de Ignacio de la Llave,197,197 Yecuatla,Total,415,394,21,849
30 Veracruz de Ignacio de la Llave,197,197 Yecuatla,Total,416,394,22,408
30 Veracruz de Ignacio de la Llave,197,197 Yecuatla,Total,321,295,26,286
30 Veracruz de Ignacio de la Llave,197,197 Yecuatla,Total,351,338,13,308
30 Veracruz de Ignacio de la Llave,197,197 Yecuatla,Total,373,361,12,317
30 Veracruz de Ignacio de la Llave,197,197 Yecuatla,Total,378,361,17,284
30 Veracruz de Ignacio de la Llave,197,197 Yecuatla,Total,314,301,13,278
30 Veracruz de Ignacio de la Llave,197,197 Yecuatla,Total,333,319,14,267
30 Veracruz de Ignacio de la Llave,197,197 Yecuatla,Total,237,231,6,281
30 Veracruz de Ignacio de la Llave,197,197 Yecuatla,Total,212,202,10,203
30 Veracruz de Ignacio de la Llave,197,197 Yecuatla,Total,182,175,7,215
30 Veracruz de Ignacio de la Llave,197,197 Yecuatla,Total,140,137,3,180
30 Veracruz de Ignacio de la Llave,197,197 Yecuatla,Total,78,78,0,143
30 Veracruz de Ignacio de la Llave,197,197 Yecuatla,Total,37,37,0,71
30 Veracruz de Ignacio de la Llave,197,197 Yecuatla,Total,15,15,0,92
30 Veracruz de Ignacio de la Llave,197,197 Yecuatla,Hombres,3185,3037,148,1090
30 Veracruz de Ignacio de la Llave,197,197 Yecuatla,Hombres,69,67,2,337
30 Veracruz de Ignacio de la Llave,197,197 Yecuatla,Hombres,336,320,16,324
30 Veracruz de Ignacio de la Llave,197,197 Yecuatla,Hombres,310,291,19,67
30 Veracruz de Ignacio de la Llave,197,197 Yecuatla,Hombres,245,224,21,27
30 Veracruz de Ignacio de la Llave,197,197 Yecuatla,Hombres,275,266,9,21
30 Veracruz de Ignacio de la Llave,197,197 Yecuatla,Hombres,291,279,12,26
30 Veracruz de Ignacio de la Llave,197,197 Yecuatla,Hombres,307,290,17,26
30 Veracruz de Ignacio de la Llave,197,197 Yecuatla,Hombres,251,239,12,27
30 Veracruz de Ignacio de la Llave,197,197 Yecuatla,Hombres,286,272,14,19
30 Veracruz de Ignacio de la Llave,197,197 Yecuatla,Hombres,208,202,6,30
30 Veracruz de Ignacio de la Llave,197,197 Yecuatla,Hombres,187,177,10,29
30 Veracruz de Ignacio de la Llave,197,197 Yecuatla,Hombres,165,158,7,26
30 Veracruz de Ignacio de la Llave,197,197 Yecuatla,Hombres,131,128,3,37
30 Veracruz de Ignacio de la Llave,197,197 Yecuatla,Hombres,75,75,0,31
30 Veracruz de Ignacio de la Llave,197,197 Yecuatla,Hombres,35,35,0,27
30 Veracruz de Ignacio de la Llave,197,197 Yecuatla,Hombres,14,14,0,36
30 Veracruz de Ignacio de la Llave,197,197 Yecuatla,Mujeres,702,684,18,3832
30 Veracruz de Ignacio de la Llave,197,197 Yecuatla,Mujeres,16,16,0,403
30 Veracruz de Ignacio de la Llave,197,197 Yecuatla,Mujeres,79,74,5,525
30 Veracruz de Ignacio de la Llave,197,197 Yecuatla,Mujeres,106,103,3,341
30 Veracruz de Ignacio de la Llave,197,197 Yecuatla,Mujeres,76,71,5,259
30 Veracruz de Ignacio de la Llave,197,197 Yecuatla,Mujeres,76,72,4,287
30 Veracruz de Ignacio de la Llave,197,197 Yecuatla,Mujeres,82,82,0,291
30 Veracruz de Ignacio de la Llave,197,197 Yecuatla,Mujeres,71,71,0,258
30 Veracruz de Ignacio de la Llave,197,197 Yecuatla,Mujeres,63,62,1,251
30 Veracruz de Ignacio de la Llave,197,197 Yecuatla,Mujeres,47,47,0,248
30 Veracruz de Ignacio de la Llave,197,197 Yecuatla,Mujeres,29,29,0,251
30 Veracruz de Ignacio de la Llave,197,197 Yecuatla,Mujeres,25,25,0,174
30 Veracruz de Ignacio de la Llave,197,197 Yecuatla,Mujeres,17,17,0,189
30 Veracruz de Ignacio de la Llave,197,197 Yecuatla,Mujeres,9,9,0,143
30 Veracruz de Ignacio de la Llave,197,197 Yecuatla,Mujeres,3,3,0,112
30 Veracruz de Ignacio de la Llave,197,197 Yecuatla,Mujeres,2,2,0,44
30 Veracruz de Ignacio de la Llave,197,197 Yecuatla,Mujeres,1,1,0,56
30 Veracruz de Ignacio de la Llave,198,198 Zacualpan,Total,2221,2209,12,2732
30 Veracruz de Ignacio de la Llave,198,198 Zacualpan,Total,30,30,0,445
30 Veracruz de Ignacio de la Llave,198,198 Zacualpan,Total,217,216,1,460
30 Veracruz de Ignacio de la Llave,198,198 Zacualpan,Total,231,229,2,225
30 Veracruz de Ignacio de la Llave,198,198 Zacualpan,Total,223,220,3,216
30 Veracruz de Ignacio de la Llave,198,198 Zacualpan,Total,236,234,2,205
30 Veracruz de Ignacio de la Llave,198,198 Zacualpan,Total,241,241,0,182
30 Veracruz de Ignacio de la Llave,198,198 Zacualpan,Total,188,188,0,148
30 Veracruz de Ignacio de la Llave,198,198 Zacualpan,Total,195,194,1,132
30 Veracruz de Ignacio de la Llave,198,198 Zacualpan,Total,165,163,2,115
30 Veracruz de Ignacio de la Llave,198,198 Zacualpan,Total,129,129,0,107
30 Veracruz de Ignacio de la Llave,198,198 Zacualpan,Total,123,123,0,100
30 Veracruz de Ignacio de la Llave,198,198 Zacualpan,Total,88,87,1,107
30 Veracruz de Ignacio de la Llave,198,198 Zacualpan,Total,75,75,0,93
30 Veracruz de Ignacio de la Llave,198,198 Zacualpan,Total,41,41,0,67
30 Veracruz de Ignacio de la Llave,198,198 Zacualpan,Total,21,21,0,50
30 Veracruz de Ignacio de la Llave,198,198 Zacualpan,Total,18,18,0,80
30 Veracruz de Ignacio de la Llave,198,198 Zacualpan,Hombres,1787,1779,8,567
30 Veracruz de Ignacio de la Llave,198,198 Zacualpan,Hombres,21,21,0,223
30 Veracruz de Ignacio de la Llave,198,198 Zacualpan,Hombres,178,177,1,151
30 Veracruz de Ignacio de la Llave,198,198 Zacualpan,Hombres,179,178,1,24
30 Veracruz de Ignacio de la Llave,198,198 Zacualpan,Hombres,177,175,2,15
30 Veracruz de Ignacio de la Llave,198,198 Zacualpan,Hombres,190,188,2,8
30 Veracruz de Ignacio de la Llave,198,198 Zacualpan,Hombres,191,191,0,11
30 Veracruz de Ignacio de la Llave,198,198 Zacualpan,Hombres,147,147,0,10
30 Veracruz de Ignacio de la Llave,198,198 Zacualpan,Hombres,153,152,1,10
30 Veracruz de Ignacio de la Llave,198,198 Zacualpan,Hombres,135,134,1,7
30 Veracruz de Ignacio de la Llave,198,198 Zacualpan,Hombres,110,110,0,6
30 Veracruz de Ignacio de la Llave,198,198 Zacualpan,Hombres,105,105,0,8
30 Veracruz de Ignacio de la Llave,198,198 Zacualpan,Hombres,72,72,0,11
30 Veracruz de Ignacio de la Llave,198,198 Zacualpan,Hombres,61,61,0,16
30 Veracruz de Ignacio de la Llave,198,198 Zacualpan,Hombres,34,34,0,17
30 Veracruz de Ignacio de la Llave,198,198 Zacualpan,Hombres,19,19,0,15
30 Veracruz de Ignacio de la Llave,198,198 Zacualpan,Hombres,15,15,0,35
30 Veracruz de Ignacio de la Llave,198,198 Zacualpan,Mujeres,434,430,4,2165
30 Veracruz de Ignacio de la Llave,198,198 Zacualpan,Mujeres,9,9,0,222
30 Veracruz de Ignacio de la Llave,198,198 Zacualpan,Mujeres,39,39,0,309
30 Veracruz de Ignacio de la Llave,198,198 Zacualpan,Mujeres,52,51,1,201
30 Veracruz de Ignacio de la Llave,198,198 Zacualpan,Mujeres,46,45,1,201
30 Veracruz de Ignacio de la Llave,198,198 Zacualpan,Mujeres,46,46,0,197
30 Veracruz de Ignacio de la Llave,198,198 Zacualpan,Mujeres,50,50,0,171
30 Veracruz de Ignacio de la Llave,198,198 Zacualpan,Mujeres,41,41,0,138
30 Veracruz de Ignacio de la Llave,198,198 Zacualpan,Mujeres,42,42,0,122
30 Veracruz de Ignacio de la Llave,198,198 Zacualpan,Mujeres,30,29,1,108
30 Veracruz de Ignacio de la Llave,198,198 Zacualpan,Mujeres,19,19,0,101
30 Veracruz de Ignacio de la Llave,198,198 Zacualpan,Mujeres,18,18,0,92
30 Veracruz de Ignacio de la Llave,198,198 Zacualpan,Mujeres,16,15,1,96
30 Veracruz de Ignacio de la Llave,198,198 Zacualpan,Mujeres,14,14,0,77
30 Veracruz de Ignacio de la Llave,198,198 Zacualpan,Mujeres,7,7,0,50
30 Veracruz de Ignacio de la Llave,198,198 Zacualpan,Mujeres,2,2,0,35
30 Veracruz de Ignacio de la Llave,198,198 Zacualpan,Mujeres,3,3,0,45
30 Veracruz de Ignacio de la Llave,199,199 Zaragoza,Total,3515,3299,216,4319
30 Veracruz de Ignacio de la Llave,199,199 Zaragoza,Total,35,34,1,756
30 Veracruz de Ignacio de la Llave,199,199 Zaragoza,Total,336,304,32,941
30 Veracruz de Ignacio de la Llave,199,199 Zaragoza,Total,566,528,38,477
30 Veracruz de Ignacio de la Llave,199,199 Zaragoza,Total,525,501,24,363
30 Veracruz de Ignacio de la Llave,199,199 Zaragoza,Total,475,451,24,343
30 Veracruz de Ignacio de la Llave,199,199 Zaragoza,Total,415,390,25,264
30 Veracruz de Ignacio de la Llave,199,199 Zaragoza,Total,324,311,13,242
30 Veracruz de Ignacio de la Llave,199,199 Zaragoza,Total,258,245,13,206
30 Veracruz de Ignacio de la Llave,199,199 Zaragoza,Total,177,165,12,148
30 Veracruz de Ignacio de la Llave,199,199 Zaragoza,Total,156,141,15,138
30 Veracruz de Ignacio de la Llave,199,199 Zaragoza,Total,98,90,8,121
30 Veracruz de Ignacio de la Llave,199,199 Zaragoza,Total,78,76,2,97
30 Veracruz de Ignacio de la Llave,199,199 Zaragoza,Total,46,39,7,87
30 Veracruz de Ignacio de la Llave,199,199 Zaragoza,Total,19,18,1,71
30 Veracruz de Ignacio de la Llave,199,199 Zaragoza,Total,5,4,1,42
30 Veracruz de Ignacio de la Llave,199,199 Zaragoza,Total,2,2,0,23
30 Veracruz de Ignacio de la Llave,199,199 Zaragoza,Hombres,2708,2502,206,1023
30 Veracruz de Ignacio de la Llave,199,199 Zaragoza,Hombres,27,26,1,366
30 Veracruz de Ignacio de la Llave,199,199 Zaragoza,Hombres,246,217,29,379
30 Veracruz de Ignacio de la Llave,199,199 Zaragoza,Hombres,414,380,34,81
30 Veracruz de Ignacio de la Llave,199,199 Zaragoza,Hombres,401,378,23,12
30 Veracruz de Ignacio de la Llave,199,199 Zaragoza,Hombres,358,334,24,10
30 Veracruz de Ignacio de la Llave,199,199 Zaragoza,Hombres,312,288,24,5
30 Veracruz de Ignacio de la Llave,199,199 Zaragoza,Hombres,251,239,12,10
30 Veracruz de Ignacio de la Llave,199,199 Zaragoza,Hombres,198,185,13,13
30 Veracruz de Ignacio de la Llave,199,199 Zaragoza,Hombres,147,135,12,6
30 Veracruz de Ignacio de la Llave,199,199 Zaragoza,Hombres,131,116,15,17
30 Veracruz de Ignacio de la Llave,199,199 Zaragoza,Hombres,87,79,8,15
30 Veracruz de Ignacio de la Llave,199,199 Zaragoza,Hombres,70,68,2,25
30 Veracruz de Ignacio de la Llave,199,199 Zaragoza,Hombres,42,35,7,23
30 Veracruz de Ignacio de la Llave,199,199 Zaragoza,Hombres,17,16,1,28
30 Veracruz de Ignacio de la Llave,199,199 Zaragoza,Hombres,5,4,1,25
30 Veracruz de Ignacio de la Llave,199,199 Zaragoza,Hombres,2,2,0,8
30 Veracruz de Ignacio de la Llave,199,199 Zaragoza,Mujeres,807,797,10,3296
30 Veracruz de Ignacio de la Llave,199,199 Zaragoza,Mujeres,8,8,0,390
30 Veracruz de Ignacio de la Llave,199,199 Zaragoza,Mujeres,90,87,3,562
30 Veracruz de Ignacio de la Llave,199,199 Zaragoza,Mujeres,152,148,4,396
30 Veracruz de Ignacio de la Llave,199,199 Zaragoza,Mujeres,124,123,1,351
30 Veracruz de Ignacio de la Llave,199,199 Zaragoza,Mujeres,117,117,0,333
30 Veracruz de Ignacio de la Llave,199,199 Zaragoza,Mujeres,103,102,1,259
30 Veracruz de Ignacio de la Llave,199,199 Zaragoza,Mujeres,73,72,1,232
30 Veracruz de Ignacio de la Llave,199,199 Zaragoza,Mujeres,60,60,0,193
30 Veracruz de Ignacio de la Llave,199,199 Zaragoza,Mujeres,30,30,0,142
30 Veracruz de Ignacio de la Llave,199,199 Zaragoza,Mujeres,25,25,0,121
30 Veracruz de Ignacio de la Llave,199,199 Zaragoza,Mujeres,11,11,0,106
30 Veracruz de Ignacio de la Llave,199,199 Zaragoza,Mujeres,8,8,0,72
30 Veracruz de Ignacio de la Llave,199,199 Zaragoza,Mujeres,4,4,0,64
30 Veracruz de Ignacio de la Llave,199,199 Zaragoza,Mujeres,2,2,0,43
30 Veracruz de Ignacio de la Llave,199,199 Zaragoza,Mujeres,0,0,0,17
30 Veracruz de Ignacio de la Llave,199,199 Zaragoza,Mujeres,0,0,0,15
30 Veracruz de Ignacio de la Llave,200,200 Zentla,Total,4647,4576,71,4955
30 Veracruz de Ignacio de la Llave,200,200 Zentla,Total,76,73,3,666
30 Veracruz de Ignacio de la Llave,200,200 Zentla,Total,451,445,6,725
30 Veracruz de Ignacio de la Llave,200,200 Zentla,Total,634,621,13,472
30 Veracruz de Ignacio de la Llave,200,200 Zentla,Total,531,521,10,423
30 Veracruz de Ignacio de la Llave,200,200 Zentla,Total,517,505,12,420
30 Veracruz de Ignacio de la Llave,200,200 Zentla,Total,505,502,3,390
30 Veracruz de Ignacio de la Llave,200,200 Zentla,Total,443,437,6,316
30 Veracruz de Ignacio de la Llave,200,200 Zentla,Total,355,352,3,297
30 Veracruz de Ignacio de la Llave,200,200 Zentla,Total,290,283,7,262
30 Veracruz de Ignacio de la Llave,200,200 Zentla,Total,263,261,2,220
30 Veracruz de Ignacio de la Llave,200,200 Zentla,Total,191,188,3,186
30 Veracruz de Ignacio de la Llave,200,200 Zentla,Total,155,154,1,168
30 Veracruz de Ignacio de la Llave,200,200 Zentla,Total,112,111,1,157
30 Veracruz de Ignacio de la Llave,200,200 Zentla,Total,67,66,1,114
30 Veracruz de Ignacio de la Llave,200,200 Zentla,Total,35,35,0,62
30 Veracruz de Ignacio de la Llave,200,200 Zentla,Total,22,22,0,77
30 Veracruz de Ignacio de la Llave,200,200 Zentla,Hombres,4014,3944,70,788
30 Veracruz de Ignacio de la Llave,200,200 Zentla,Hombres,62,59,3,301
30 Veracruz de Ignacio de la Llave,200,200 Zentla,Hombres,377,371,6,244
30 Veracruz de Ignacio de la Llave,200,200 Zentla,Hombres,526,513,13,48
30 Veracruz de Ignacio de la Llave,200,200 Zentla,Hombres,428,419,9,17
30 Veracruz de Ignacio de la Llave,200,200 Zentla,Hombres,444,432,12,13
30 Veracruz de Ignacio de la Llave,200,200 Zentla,Hombres,445,442,3,10
30 Veracruz de Ignacio de la Llave,200,200 Zentla,Hombres,385,379,6,7
30 Veracruz de Ignacio de la Llave,200,200 Zentla,Hombres,327,324,3,9
30 Veracruz de Ignacio de la Llave,200,200 Zentla,Hombres,254,247,7,13
30 Veracruz de Ignacio de la Llave,200,200 Zentla,Hombres,246,244,2,16
30 Veracruz de Ignacio de la Llave,200,200 Zentla,Hombres,163,160,3,11
30 Veracruz de Ignacio de la Llave,200,200 Zentla,Hombres,139,138,1,17
30 Veracruz de Ignacio de la Llave,200,200 Zentla,Hombres,105,104,1,28
30 Veracruz de Ignacio de la Llave,200,200 Zentla,Hombres,62,61,1,22
30 Veracruz de Ignacio de la Llave,200,200 Zentla,Hombres,31,31,0,15
30 Veracruz de Ignacio de la Llave,200,200 Zentla,Hombres,20,20,0,17
30 Veracruz de Ignacio de la Llave,200,200 Zentla,Mujeres,633,632,1,4167
30 Veracruz de Ignacio de la Llave,200,200 Zentla,Mujeres,14,14,0,365
30 Veracruz de Ignacio de la Llave,200,200 Zentla,Mujeres,74,74,0,481
30 Veracruz de Ignacio de la Llave,200,200 Zentla,Mujeres,108,108,0,424
30 Veracruz de Ignacio de la Llave,200,200 Zentla,Mujeres,103,102,1,406
30 Veracruz de Ignacio de la Llave,200,200 Zentla,Mujeres,73,73,0,407
30 Veracruz de Ignacio de la Llave,200,200 Zentla,Mujeres,60,60,0,380
30 Veracruz de Ignacio de la Llave,200,200 Zentla,Mujeres,58,58,0,309
30 Veracruz de Ignacio de la Llave,200,200 Zentla,Mujeres,28,28,0,288
30 Veracruz de Ignacio de la Llave,200,200 Zentla,Mujeres,36,36,0,249
30 Veracruz de Ignacio de la Llave,200,200 Zentla,Mujeres,17,17,0,204
30 Veracruz de Ignacio de la Llave,200,200 Zentla,Mujeres,28,28,0,175
30 Veracruz de Ignacio de la Llave,200,200 Zentla,Mujeres,16,16,0,151
30 Veracruz de Ignacio de la Llave,200,200 Zentla,Mujeres,7,7,0,129
30 Veracruz de Ignacio de la Llave,200,200 Zentla,Mujeres,5,5,0,92
30 Veracruz de Ignacio de la Llave,200,200 Zentla,Mujeres,4,4,0,47
30 Veracruz de Ignacio de la Llave,200,200 Zentla,Mujeres,2,2,0,60
30 Veracruz de Ignacio de la Llave,201,201 Zongolica,Total,14203,13984,219,16263
30 Veracruz de Ignacio de la Llave,201,201 Zongolica,Total,178,172,6,2829
30 Veracruz de Ignacio de la Llave,201,201 Zongolica,Total,1311,1271,40,3035
30 Veracruz de Ignacio de la Llave,201,201 Zongolica,Total,2037,1979,58,1755
30 Veracruz de Ignacio de la Llave,201,201 Zongolica,Total,1831,1794,37,1353
30 Veracruz de Ignacio de la Llave,201,201 Zongolica,Total,1669,1653,16,1224
30 Veracruz de Ignacio de la Llave,201,201 Zongolica,Total,1638,1623,15,1058
30 Veracruz de Ignacio de la Llave,201,201 Zongolica,Total,1255,1245,10,847
30 Veracruz de Ignacio de la Llave,201,201 Zongolica,Total,1149,1136,13,754
30 Veracruz de Ignacio de la Llave,201,201 Zongolica,Total,865,862,3,744
30 Veracruz de Ignacio de la Llave,201,201 Zongolica,Total,719,710,9,662
30 Veracruz de Ignacio de la Llave,201,201 Zongolica,Total,476,472,4,479
30 Veracruz de Ignacio de la Llave,201,201 Zongolica,Total,386,386,0,409
30 Veracruz de Ignacio de la Llave,201,201 Zongolica,Total,373,370,3,522
30 Veracruz de Ignacio de la Llave,201,201 Zongolica,Total,178,175,3,280
30 Veracruz de Ignacio de la Llave,201,201 Zongolica,Total,76,76,0,154
30 Veracruz de Ignacio de la Llave,201,201 Zongolica,Total,62,60,2,158
30 Veracruz de Ignacio de la Llave,201,201 Zongolica,Hombres,11665,11501,164,3178
30 Veracruz de Ignacio de la Llave,201,201 Zongolica,Hombres,154,149,5,1368
30 Veracruz de Ignacio de la Llave,201,201 Zongolica,Hombres,1102,1074,28,1055
30 Veracruz de Ignacio de la Llave,201,201 Zongolica,Hombres,1535,1501,34,206
30 Veracruz de Ignacio de la Llave,201,201 Zongolica,Hombres,1467,1437,30,51
30 Veracruz de Ignacio de la Llave,201,201 Zongolica,Hombres,1362,1348,14,43
30 Veracruz de Ignacio de la Llave,201,201 Zongolica,Hombres,1310,1296,14,26
30 Veracruz de Ignacio de la Llave,201,201 Zongolica,Hombres,1012,1004,8,28
30 Veracruz de Ignacio de la Llave,201,201 Zongolica,Hombres,957,947,10,24
30 Veracruz de Ignacio de la Llave,201,201 Zongolica,Hombres,734,731,3,54
30 Veracruz de Ignacio de la Llave,201,201 Zongolica,Hombres,630,623,7,66
30 Veracruz de Ignacio de la Llave,201,201 Zongolica,Hombres,429,426,3,41
30 Veracruz de Ignacio de la Llave,201,201 Zongolica,Hombres,353,353,0,44
30 Veracruz de Ignacio de la Llave,201,201 Zongolica,Hombres,336,333,3,68
30 Veracruz de Ignacio de la Llave,201,201 Zongolica,Hombres,164,161,3,44
30 Veracruz de Ignacio de la Llave,201,201 Zongolica,Hombres,65,65,0,24
30 Veracruz de Ignacio de la Llave,201,201 Zongolica,Hombres,55,53,2,36
30 Veracruz de Ignacio de la Llave,201,201 Zongolica,Mujeres,2538,2483,55,13085
30 Veracruz de Ignacio de la Llave,201,201 Zongolica,Mujeres,24,23,1,1461
30 Veracruz de Ignacio de la Llave,201,201 Zongolica,Mujeres,209,197,12,1980
30 Veracruz de Ignacio de la Llave,201,201 Zongolica,Mujeres,502,478,24,1549
30 Veracruz de Ignacio de la Llave,201,201 Zongolica,Mujeres,364,357,7,1302
30 Veracruz de Ignacio de la Llave,201,201 Zongolica,Mujeres,307,305,2,1181
30 Veracruz de Ignacio de la Llave,201,201 Zongolica,Mujeres,328,327,1,1032
30 Veracruz de Ignacio de la Llave,201,201 Zongolica,Mujeres,243,241,2,819
30 Veracruz de Ignacio de la Llave,201,201 Zongolica,Mujeres,192,189,3,730
30 Veracruz de Ignacio de la Llave,201,201 Zongolica,Mujeres,131,131,0,690
30 Veracruz de Ignacio de la Llave,201,201 Zongolica,Mujeres,89,87,2,596
30 Veracruz de Ignacio de la Llave,201,201 Zongolica,Mujeres,47,46,1,438
30 Veracruz de Ignacio de la Llave,201,201 Zongolica,Mujeres,33,33,0,365
30 Veracruz de Ignacio de la Llave,201,201 Zongolica,Mujeres,37,37,0,454
30 Veracruz de Ignacio de la Llave,201,201 Zongolica,Mujeres,14,14,0,236
30 Veracruz de Ignacio de la Llave,201,201 Zongolica,Mujeres,11,11,0,130
30 Veracruz de Ignacio de la Llave,201,201 Zongolica,Mujeres,7,7,0,122
30 Veracruz de Ignacio de la Llave,202,202 Zontecomatlán de López y Fuentes,Total,3706,3660,46,5701
30 Veracruz de Ignacio de la Llave,202,202 Zontecomatlán de López y Fuentes,Total,36,35,1,959
30 Veracruz de Ignacio de la Llave,202,202 Zontecomatlán de López y Fuentes,Total,448,432,16,1084
30 Veracruz de Ignacio de la Llave,202,202 Zontecomatlán de López y Fuentes,Total,491,483,8,556
30 Veracruz de Ignacio de la Llave,202,202 Zontecomatlán de López y Fuentes,Total,495,485,10,470
30 Veracruz de Ignacio de la Llave,202,202 Zontecomatlán de López y Fuentes,Total,358,357,1,421
30 Veracruz de Ignacio de la Llave,202,202 Zontecomatlán de López y Fuentes,Total,383,377,6,391
30 Veracruz de Ignacio de la Llave,202,202 Zontecomatlán de López y Fuentes,Total,333,332,1,323
30 Veracruz de Ignacio de la Llave,202,202 Zontecomatlán de López y Fuentes,Total,290,290,0,282
30 Veracruz de Ignacio de la Llave,202,202 Zontecomatlán de López y Fuentes,Total,242,239,3,233
30 Veracruz de Ignacio de la Llave,202,202 Zontecomatlán de López y Fuentes,Total,228,228,0,245
30 Veracruz de Ignacio de la Llave,202,202 Zontecomatlán de López y Fuentes,Total,155,155,0,191
30 Veracruz de Ignacio de la Llave,202,202 Zontecomatlán de López y Fuentes,Total,132,132,0,161
30 Veracruz de Ignacio de la Llave,202,202 Zontecomatlán de López y Fuentes,Total,68,68,0,172
30 Veracruz de Ignacio de la Llave,202,202 Zontecomatlán de López y Fuentes,Total,22,22,0,83
30 Veracruz de Ignacio de la Llave,202,202 Zontecomatlán de López y Fuentes,Total,14,14,0,66
30 Veracruz de Ignacio de la Llave,202,202 Zontecomatlán de López y Fuentes,Total,11,11,0,64
30 Veracruz de Ignacio de la Llave,202,202 Zontecomatlán de López y Fuentes,Hombres,3292,3252,40,1237
30 Veracruz de Ignacio de la Llave,202,202 Zontecomatlán de López y Fuentes,Hombres,31,30,1,454
30 Veracruz de Ignacio de la Llave,202,202 Zontecomatlán de López y Fuentes,Hombres,399,387,12,393
30 Veracruz de Ignacio de la Llave,202,202 Zontecomatlán de López y Fuentes,Hombres,434,427,7,69
30 Veracruz de Ignacio de la Llave,202,202 Zontecomatlán de López y Fuentes,Hombres,439,429,10,40
30 Veracruz de Ignacio de la Llave,202,202 Zontecomatlán de López y Fuentes,Hombres,316,315,1,28
30 Veracruz de Ignacio de la Llave,202,202 Zontecomatlán de López y Fuentes,Hombres,325,320,5,28
30 Veracruz de Ignacio de la Llave,202,202 Zontecomatlán de López y Fuentes,Hombres,288,287,1,25
30 Veracruz de Ignacio de la Llave,202,202 Zontecomatlán de López y Fuentes,Hombres,266,266,0,18
30 Veracruz de Ignacio de la Llave,202,202 Zontecomatlán de López y Fuentes,Hombres,218,215,3,15
30 Veracruz de Ignacio de la Llave,202,202 Zontecomatlán de López y Fuentes,Hombres,207,207,0,23
30 Veracruz de Ignacio de la Llave,202,202 Zontecomatlán de López y Fuentes,Hombres,142,142,0,24
30 Veracruz de Ignacio de la Llave,202,202 Zontecomatlán de López y Fuentes,Hombres,128,128,0,29
30 Veracruz de Ignacio de la Llave,202,202 Zontecomatlán de López y Fuentes,Hombres,57,57,0,34
30 Veracruz de Ignacio de la Llave,202,202 Zontecomatlán de López y Fuentes,Hombres,20,20,0,16
30 Veracruz de Ignacio de la Llave,202,202 Zontecomatlán de López y Fuentes,Hombres,11,11,0,15
30 Veracruz de Ignacio de la Llave,202,202 Zontecomatlán de López y Fuentes,Hombres,11,11,0,26
30 Veracruz de Ignacio de la Llave,202,202 Zontecomatlán de López y Fuentes,Mujeres,414,408,6,4464
30 Veracruz de Ignacio de la Llave,202,202 Zontecomatlán de López y Fuentes,Mujeres,5,5,0,505
30 Veracruz de Ignacio de la Llave,202,202 Zontecomatlán de López y Fuentes,Mujeres,49,45,4,691
30 Veracruz de Ignacio de la Llave,202,202 Zontecomatlán de López y Fuentes,Mujeres,57,56,1,487
30 Veracruz de Ignacio de la Llave,202,202 Zontecomatlán de López y Fuentes,Mujeres,56,56,0,430
30 Veracruz de Ignacio de la Llave,202,202 Zontecomatlán de López y Fuentes,Mujeres,42,42,0,393
30 Veracruz de Ignacio de la Llave,202,202 Zontecomatlán de López y Fuentes,Mujeres,58,57,1,363
30 Veracruz de Ignacio de la Llave,202,202 Zontecomatlán de López y Fuentes,Mujeres,45,45,0,298
30 Veracruz de Ignacio de la Llave,202,202 Zontecomatlán de López y Fuentes,Mujeres,24,24,0,264
30 Veracruz de Ignacio de la Llave,202,202 Zontecomatlán de López y Fuentes,Mujeres,24,24,0,218
30 Veracruz de Ignacio de la Llave,202,202 Zontecomatlán de López y Fuentes,Mujeres,21,21,0,222
30 Veracruz de Ignacio de la Llave,202,202 Zontecomatlán de López y Fuentes,Mujeres,13,13,0,167
30 Veracruz de Ignacio de la Llave,202,202 Zontecomatlán de López y Fuentes,Mujeres,4,4,0,132
30 Veracruz de Ignacio de la Llave,202,202 Zontecomatlán de López y Fuentes,Mujeres,11,11,0,138
30 Veracruz de Ignacio de la Llave,202,202 Zontecomatlán de López y Fuentes,Mujeres,2,2,0,67
30 Veracruz de Ignacio de la Llave,202,202 Zontecomatlán de López y Fuentes,Mujeres,3,3,0,51
30 Veracruz de Ignacio de la Llave,202,202 Zontecomatlán de López y Fuentes,Mujeres,0,0,0,38
30 Veracruz de Ignacio de la Llave,203,203 Zozocolco de Hidalgo,Total,4092,3973,119,5498
30 Veracruz de Ignacio de la Llave,203,203 Zozocolco de Hidalgo,Total,63,61,2,875
30 Veracruz de Ignacio de la Llave,203,203 Zozocolco de Hidalgo,Total,382,368,14,978
30 Veracruz de Ignacio de la Llave,203,203 Zozocolco de Hidalgo,Total,484,465,19,479
30 Veracruz de Ignacio de la Llave,203,203 Zozocolco de Hidalgo,Total,442,425,17,414
30 Veracruz de Ignacio de la Llave,203,203 Zozocolco de Hidalgo,Total,413,400,13,415
30 Veracruz de Ignacio de la Llave,203,203 Zozocolco de Hidalgo,Total,436,424,12,341
30 Veracruz de Ignacio de la Llave,203,203 Zozocolco de Hidalgo,Total,326,312,14,307
30 Veracruz de Ignacio de la Llave,203,203 Zozocolco de Hidalgo,Total,318,307,11,333
30 Veracruz de Ignacio de la Llave,203,203 Zozocolco de Hidalgo,Total,293,287,6,267
30 Veracruz de Ignacio de la Llave,203,203 Zozocolco de Hidalgo,Total,294,290,4,255
30 Veracruz de Ignacio de la Llave,203,203 Zozocolco de Hidalgo,Total,208,205,3,262
30 Veracruz de Ignacio de la Llave,203,203 Zozocolco de Hidalgo,Total,187,186,1,203
30 Veracruz de Ignacio de la Llave,203,203 Zozocolco de Hidalgo,Total,135,132,3,144
30 Veracruz de Ignacio de la Llave,203,203 Zozocolco de Hidalgo,Total,69,69,0,100
30 Veracruz de Ignacio de la Llave,203,203 Zozocolco de Hidalgo,Total,25,25,0,61
30 Veracruz de Ignacio de la Llave,203,203 Zozocolco de Hidalgo,Total,17,17,0,64
30 Veracruz de Ignacio de la Llave,203,203 Zozocolco de Hidalgo,Hombres,3541,3432,109,1121
30 Veracruz de Ignacio de la Llave,203,203 Zozocolco de Hidalgo,Hombres,55,53,2,433
30 Veracruz de Ignacio de la Llave,203,203 Zozocolco de Hidalgo,Hombres,318,306,12,344
30 Veracruz de Ignacio de la Llave,203,203 Zozocolco de Hidalgo,Hombres,390,376,14,64
30 Veracruz de Ignacio de la Llave,203,203 Zozocolco de Hidalgo,Hombres,371,356,15,20
30 Veracruz de Ignacio de la Llave,203,203 Zozocolco de Hidalgo,Hombres,342,329,13,20
30 Veracruz de Ignacio de la Llave,203,203 Zozocolco de Hidalgo,Hombres,375,363,12,20
30 Veracruz de Ignacio de la Llave,203,203 Zozocolco de Hidalgo,Hombres,272,259,13,16
30 Veracruz de Ignacio de la Llave,203,203 Zozocolco de Hidalgo,Hombres,270,259,11,17
30 Veracruz de Ignacio de la Llave,203,203 Zozocolco de Hidalgo,Hombres,279,273,6,23
30 Veracruz de Ignacio de la Llave,203,203 Zozocolco de Hidalgo,Hombres,271,267,4,21
30 Veracruz de Ignacio de la Llave,203,203 Zozocolco de Hidalgo,Hombres,187,184,3,23
30 Veracruz de Ignacio de la Llave,203,203 Zozocolco de Hidalgo,Hombres,172,171,1,22
30 Veracruz de Ignacio de la Llave,203,203 Zozocolco de Hidalgo,Hombres,130,127,3,31
30 Veracruz de Ignacio de la Llave,203,203 Zozocolco de Hidalgo,Hombres,67,67,0,25
30 Veracruz de Ignacio de la Llave,203,203 Zozocolco de Hidalgo,Hombres,25,25,0,20
30 Veracruz de Ignacio de la Llave,203,203 Zozocolco de Hidalgo,Hombres,17,17,0,22
30 Veracruz de Ignacio de la Llave,203,203 Zozocolco de Hidalgo,Mujeres,551,541,10,4377
30 Veracruz de Ignacio de la Llave,203,203 Zozocolco de Hidalgo,Mujeres,8,8,0,442
30 Veracruz de Ignacio de la Llave,203,203 Zozocolco de Hidalgo,Mujeres,64,62,2,634
30 Veracruz de Ignacio de la Llave,203,203 Zozocolco de Hidalgo,Mujeres,94,89,5,415
30 Veracruz de Ignacio de la Llave,203,203 Zozocolco de Hidalgo,Mujeres,71,69,2,394
30 Veracruz de Ignacio de la Llave,203,203 Zozocolco de Hidalgo,Mujeres,71,71,0,395
30 Veracruz de Ignacio de la Llave,203,203 Zozocolco de Hidalgo,Mujeres,61,61,0,321
30 Veracruz de Ignacio de la Llave,203,203 Zozocolco de Hidalgo,Mujeres,54,53,1,291
30 Veracruz de Ignacio de la Llave,203,203 Zozocolco de Hidalgo,Mujeres,48,48,0,316
30 Veracruz de Ignacio de la Llave,203,203 Zozocolco de Hidalgo,Mujeres,14,14,0,244
30 Veracruz de Ignacio de la Llave,203,203 Zozocolco de Hidalgo,Mujeres,23,23,0,234
30 Veracruz de Ignacio de la Llave,203,203 Zozocolco de Hidalgo,Mujeres,21,21,0,239
30 Veracruz de Ignacio de la Llave,203,203 Zozocolco de Hidalgo,Mujeres,15,15,0,181
30 Veracruz de Ignacio de la Llave,203,203 Zozocolco de Hidalgo,Mujeres,5,5,0,113
30 Veracruz de Ignacio de la Llave,203,203 Zozocolco de Hidalgo,Mujeres,2,2,0,75
30 Veracruz de Ignacio de la Llave,203,203 Zozocolco de Hidalgo,Mujeres,0,0,0,41
30 Veracruz de Ignacio de la Llave,203,203 Zozocolco de Hidalgo,Mujeres,0,0,0,42